UMLS_drugname,UMLS_pt,a,drug_total,b,pt_total,c,d,PRR
aliskiren,Abdomen distended,2,3174,3172,83,81,418580,3.2038772998678198
aliskiren,Abnormal urine odor,14,3174,3160,140,126,418535,13.344778481012659
aliskiren,Adjustment disorder with depressed mood,2,3174,3172,6,4,418657,44.32839428331231
aliskiren,Anaphylactic shock,2,3174,3172,79,77,418584,3.36613086021677
aliskiren,Aortic valve calcification,96,3174,3078,1735,1639,417022,7.551892860553561
aliskiren,Arterial hemorrhage,1,3174,3173,7,6,418655,18.99185088469677
aliskiren,Ataxia,1,3174,3173,40,39,418622,3.3233138985187525
aliskiren,Atrial dilatation,1,3174,3173,7,6,418655,18.99185088469677
aliskiren,Aura,2,3174,3172,18,16,418645,14.775711083088131
aliskiren,Bladder malposition acquired,1,3174,3173,29,28,418633,4.58400078246411
aliskiren,Bleeding from ear,102,3174,3072,4416,4314,414347,3.1384998266247734
aliskiren,Blindness,95,3174,3079,141,46,418615,92.27673625267484
aliskiren,Blood calcium increased,3,3174,3171,10,7,418654,39.907757805108794
aliskiren,Blood lactate dehydrogenase decreased,1,3174,3173,12,11,418650,11.078448366425043
aliskiren,Bone trimming,1,3174,3173,14,13,418648,9.495767862770698
aliskiren,Bronchospasm,2,3174,3172,13,11,418650,20.458919390823553
aliskiren,Cervico-occipital neuralgia,1,3174,3173,8,7,418654,16.617830129215253
aliskiren,Chronic cholecystitis,27,3174,3147,462,435,418226,7.825133398536639
aliskiren,Colour blindness (incl acquired),5,3174,3169,26,21,418640,25.597070175012746
aliskiren,Confusion,108,3174,3066,1333,1225,417436,11.111930624534802
aliskiren,Congenital stenosis of aortic valve,1,3174,3173,24,23,418638,5.5390666036348355
aliskiren,Critical Illness,1,3174,3173,9,8,418653,14.771369541618517
aliskiren,Crystal nephropathy,2,3174,3172,21,19,418642,12.664805140214975
aliskiren,Decrease in appetite,100,3174,3074,3118,3018,415643,4.368583284331789
aliskiren,Dilatation of aorta,17,3174,3157,308,291,418370,7.369686616835809
aliskiren,Dry tongue,3,3174,3171,27,24,418637,14.78005536283682
aliskiren,Dysarthria,95,3174,3079,181,86,418575,71.87726875519245
aliskiren,Dyspnea,5,3174,3169,191,186,418475,3.4830549217798734
aliskiren,Dysuria,94,3174,3080,771,677,417984,16.667515623157644
aliskiren,Electrolyte imbalance,1,3174,3173,19,18,418643,6.996798646474364
aliskiren,Enamel anomaly,1,3174,3173,20,19,418642,6.646942956192877
aliskiren,Eructation,14,3174,3160,478,464,418197,3.905379746835443
aliskiren,Erythematous rash,102,3174,3072,377,275,418386,37.11862773541114
aliskiren,Esophageal Varices,1,3174,3173,13,12,418649,10.226235787534245
aliskiren,Fibromuscular dysplasia of wall of renal artery,4,3174,3170,89,85,418576,5.97945627902031
aliskiren,Gastric ulcer,13,3174,3161,474,461,418200,3.6559045700700925
aliskiren,Granuloma,1,3174,3173,42,41,418620,3.165045848153317
aliskiren,Hemorrhagic diarrhea,1,3174,3173,41,40,418621,3.2422497751608463
aliskiren,"Hyperparathyroidism, Primary",30,3174,3144,440,410,418251,9.138510582928522
aliskiren,Hypothermia due to exposure,1,3174,3173,43,42,418619,3.09143280147172
aliskiren,INR Increased,2,3174,3172,57,55,418606,4.665582619853542
aliskiren,Idiosyncratic drug reaction,3,3174,3171,6,3,418658,66.51356039104384
aliskiren,Ileus,95,3174,3079,198,103,418558,65.70333900879533
aliskiren,Impaired exercise tolerance,2,3174,3172,84,82,418579,3.165728397285774
aliskiren,Injury of liver,4,3174,3170,105,101,418560,5.068108757698663
aliskiren,Intentional dose omission,9,3174,3165,211,202,418459,5.682136519844568
aliskiren,Intentional self-injury,95,3174,3079,136,41,418620,95.67039766539938
aliskiren,Intestinal hemorrhage NOS,4,3174,3170,24,20,418641,22.177234490010513
aliskiren,Intracranial tumour haemorrhage,95,3174,3079,145,50,418611,89.73031996505807
aliskiren,Large intestinal obstruction reduction,9,3174,3165,98,89,418572,12.23726666021859
aliskiren,Left-Sided Heart Failure,1,3174,3173,33,32,418629,4.02832612287387
aliskiren,"Leukemia, Myelocytic, Acute",7,3174,3167,48,41,418620,19.42235685717293
aliskiren,Ligament injury,5,3174,3169,104,99,418562,6.398084205160571
aliskiren,Loss of interest,25,3174,3149,879,854,417807,3.802026827593208
aliskiren,Low density lipoprotein increased,2,3174,3172,26,24,418637,10.229144436899798
aliskiren,Lymphocyte stimulation test positive,2,3174,3172,76,74,418587,3.4990293356341673
aliskiren,Maculopapular Lesion,95,3174,3079,98,3,418658,132.77904633759968
aliskiren,Malaise,98,3174,3076,396,298,418363,33.90621264662227
aliskiren,Melanosis,6,3174,3168,105,99,418562,7.606962481962482
aliskiren,Mental status changes,95,3174,3079,113,18,418643,115.14941352640065
aliskiren,Muscle tightness,95,3174,3079,289,194,418467,45.005029044841095
aliskiren,Myocardial Ischemia,5,3174,3169,208,203,418458,3.198253210185208
aliskiren,Nail Loss,95,3174,3079,299,204,418457,43.49881221479849
aliskiren,Nausea,9,3174,3165,287,278,418383,4.176706243704278
aliskiren,Normocytic normochromic anemia,2,3174,3172,11,9,418652,24.178837555886737
aliskiren,Occult blood positive,5,3174,3169,161,156,418505,4.132365363997891
aliskiren,Off label vaccine use,95,3174,3079,1184,1089,417572,10.961857186432942
aliskiren,Pain in esophagus (finding),18,3174,3156,595,577,418084,4.037831102022558
aliskiren,Pre-existing condition improved,2,3174,3172,12,10,418651,22.163881883144178
aliskiren,Pressure of speech,4,3174,3170,7,3,418658,76.0392969806219
aliskiren,Product physical issue,2,3174,3172,15,13,418648,17.73097940311055
aliskiren,Psychomotor skills impaired,1,3174,3173,11,10,418651,12.085608686932357
aliskiren,Pulmonary Fibrosis,1,3174,3173,24,23,418638,5.5390666036348355
aliskiren,Pulmonary artery stenosis,2,3174,3172,11,9,418652,24.178837555886737
aliskiren,Pyoderma Gangrenosum,2,3174,3172,13,11,418650,20.458919390823553
aliskiren,Reaction to colouring,4,3174,3170,7,3,418658,76.0392969806219
aliskiren,Reaction to drug excipients,4,3174,3170,36,32,418629,14.78440238345601
aliskiren,Rectal hemorrhage,5,3174,3169,43,38,418623,15.476674469974387
aliskiren,Secondary hypertension,95,3174,3079,131,36,418625,99.32311720123268
aliskiren,Shone complex,1,3174,3173,11,10,418651,12.085608686932357
aliskiren,Shunt stenosis,1,3174,3173,7,6,418655,18.99185088469677
aliskiren,Sleeplessness,30,3174,3144,120,90,418571,33.53331743002544
aliskiren,Subcutaneous Abscess,9,3174,3165,389,380,418281,3.0807831479428356
aliskiren,Superficial spreading malignant melanoma of skin,4,3174,3170,104,100,418561,5.116852705653968
aliskiren,Toothache,12,3174,3162,252,240,418421,6.348950332821301
aliskiren,Transaminases decreased,95,3174,3079,100,5,418656,130.12284832737902
aliskiren,Uterine hemorrhage,14,3174,3160,329,315,418346,5.676084029086991
aliskiren,Vaginal abscess,9,3174,3165,56,47,418614,21.417349356804333
aliskiren,Wound infection bacterial,3,3174,3171,44,41,418620,9.069213898684097
aliskiren,exposure to molds (history),95,3174,3079,98,3,418658,132.77904633759968
aliskiren,pathologic fistula,96,3174,3078,3682,3586,415075,3.542044803601738
atenolol,"Abdomen, Acute",3,12005,12002,23,20,409810,4.584149018641821
atenolol,Abnormal breathing,1,12005,12004,5,4,409826,7.028157280906365
atenolol,Abnormal coordination,9,12005,11996,102,93,409737,3.10201194515819
atenolol,Abnormal nail growth,1,12005,12004,11,10,409820,3.194571506467541
atenolol,Abscess of eye,1,12005,12004,7,6,409824,5.0200885419146
atenolol,Absence Epilepsy,1,12005,12004,6,5,409825,5.856783849827835
atenolol,Acarodermatitis,2,12005,12003,19,17,409813,3.699215546990445
atenolol,Acne,1,12005,12004,11,10,409820,3.194571506467541
atenolol,Acute osteomyelitis,2,12005,12003,8,6,409824,8.785866033491628
atenolol,Adenoid Cystic Carcinoma,1,12005,12004,6,5,409825,5.856783849827835
atenolol,Adenoidal disorder,2,12005,12003,15,13,409817,4.685717459524008
atenolol,Agnosia,1,12005,12004,11,10,409820,3.194571506467541
atenolol,Alcohol abuse,2,12005,12003,17,15,409815,4.134436978990546
atenolol,"Angioedemas, Hereditary",2,12005,12003,22,20,409810,3.194754341717601
atenolol,Anorectal swelling,1,12005,12004,5,4,409826,7.028157280906365
atenolol,Anosmia,3,12005,12002,13,10,409820,8.11060977016651
atenolol,Aortic occlusion,2,12005,12003,6,4,409826,11.71454358632564
atenolol,Aortic valve sclerosis,5,12005,12000,53,48,409782,3.3158962264150946
atenolol,Aplastic Anemia,17,12005,11988,178,161,409669,3.359243606902783
atenolol,Appendicitis purulent perforated,1,12005,12004,11,10,409820,3.194571506467541
atenolol,Application site blister,1,12005,12004,11,10,409820,3.194571506467541
atenolol,Application site infection,1,12005,12004,5,4,409826,7.028157280906365
atenolol,Application site papules,1,12005,12004,7,6,409824,5.0200885419146
atenolol,Arteriosclerosis,3,12005,12002,10,7,409823,10.543867688718548
atenolol,Arthroplasty,1,12005,12004,7,6,409824,5.0200885419146
atenolol,Atrial Fibrillation,3,12005,12002,18,15,409815,5.857593178914625
atenolol,Atrial Premature Complexes,1,12005,12004,5,4,409826,7.028157280906365
atenolol,Autoimmune necrotizing myopathy,2,12005,12003,12,10,409820,5.857188480657613
atenolol,Autoimmune thyroiditis,1,12005,12004,10,9,409821,3.5140369876707767
atenolol,Back disorder,1,12005,12004,6,5,409825,5.856783849827835
atenolol,Bacteremia,6,12005,11999,23,17,409813,9.17059030281509
atenolol,Bacterial Infections,2,12005,12003,5,3,409827,14.057485628592854
atenolol,Biopsy lymph gland abnormal,1,12005,12004,9,8,409822,3.904494798030286
atenolol,Bladder cyst,4,12005,12001,42,38,409792,3.3472845516841847
atenolol,Bleeding esophageal varices,1,12005,12004,8,7,409823,4.392567060979673
atenolol,Bleeding from anus,4,12005,12001,33,29,409801,4.260271240022927
atenolol,Blister rupture,1,12005,12004,8,7,409823,4.392567060979673
atenolol,Blood blister,1,12005,12004,6,5,409825,5.856783849827835
atenolol,Blood chloride decreased,1,12005,12004,11,10,409820,3.194571506467541
atenolol,Blood cholinesterase decreased,15,12005,11990,39,24,409806,13.530377879001732
atenolol,Blood lactic acid,1,12005,12004,8,7,409823,4.392567060979673
atenolol,Blood potassium increased,7,12005,11998,46,39,409791,5.349665161584903
atenolol,Blood triglycerides abnormal,12,12005,11993,88,76,409754,4.795376848616238
atenolol,Blood urea nitrogen measurement,1,12005,12004,9,8,409822,3.904494798030286
atenolol,Blood urine present,1,12005,12004,6,5,409825,5.856783849827835
atenolol,Bone marrow harvest failure,8,12005,11997,61,53,409777,4.610704588715485
atenolol,Brain stem herniation,1,12005,12004,11,10,409820,3.194571506467541
atenolol,Breast Cyst,7,12005,11998,68,61,409769,3.6187023817695105
atenolol,Breast hyperplasia,1,12005,12004,8,7,409823,4.392567060979673
atenolol,Bronchial Obstruction,12,12005,11993,137,125,409705,3.0798841903519145
atenolol,"Bronchitis, Chronic",6,12005,11999,56,50,409780,3.766197778386294
atenolol,Bullous Dermatitis,1,12005,12004,8,7,409823,4.392567060979673
atenolol,Bursa calcification,2,12005,12003,11,9,409821,6.389675308445616
atenolol,CSF white blood cell count increased,1,12005,12004,6,5,409825,5.856783849827835
atenolol,Calcification of breast,3,12005,12002,24,21,409809,4.3931323946009
atenolol,Calcification of pleura,2,12005,12003,5,3,409827,14.057485628592854
atenolol,Cancer of Ear,1,12005,12004,11,10,409820,3.194571506467541
atenolol,Cardiac Catheterization Procedures,1,12005,12004,11,10,409820,3.194571506467541
atenolol,Cardiac Death,1,12005,12004,5,4,409826,7.028157280906365
atenolol,Cardiac ventricular thrombosis,1,12005,12004,6,5,409825,5.856783849827835
atenolol,Cardiovascular Deconditioning,3,12005,12002,12,9,409821,8.786514747542077
atenolol,Carotid Body Paraganglioma,1,12005,12004,11,10,409820,3.194571506467541
atenolol,Cartilage atrophy,3,12005,12002,17,14,409816,6.202172186988443
atenolol,Celiac Disease,1,12005,12004,6,5,409825,5.856783849827835
atenolol,Central nervous system lesion,10,12005,11995,106,96,409734,3.316861585409015
atenolol,Cerebral arterial thrombosis,1,12005,12004,10,9,409821,3.5140369876707767
atenolol,Cerebrovascular Disorders,1,12005,12004,5,4,409826,7.028157280906365
atenolol,Cesarean section,2,12005,12003,13,11,409819,5.406622703298535
atenolol,Chemical burns of eye,2,12005,12003,10,8,409822,7.0286595017912195
atenolol,Cholecystitis,2,12005,12003,10,8,409822,7.0286595017912195
atenolol,Chondromalacia,1,12005,12004,5,4,409826,7.028157280906365
atenolol,Chronic Fatigue Syndrome,9,12005,11996,62,53,409777,5.103794006604352
atenolol,Collagen-vascular disease,2,12005,12003,7,5,409825,10.041013556134775
atenolol,Colonic Neoplasms,3,12005,12002,23,20,409810,4.584149018641821
atenolol,Colposcopy,1,12005,12004,5,4,409826,7.028157280906365
atenolol,Compression fracture of vertebral column,1,12005,12004,11,10,409820,3.194571506467541
atenolol,Congenital tricuspid valve incompetence,4,12005,12001,19,15,409815,7.3996640630824615
atenolol,Corneal Abrasions,1,12005,12004,5,4,409826,7.028157280906365
atenolol,Corneal Scar,1,12005,12004,10,9,409821,3.5140369876707767
atenolol,Coronary Arteriosclerosis,8,12005,11997,88,80,409750,3.195851993301356
atenolol,Coronary Artery Bypass Surgery,1,12005,12004,11,10,409820,3.194571506467541
atenolol,Coronary Occlusion,3,12005,12002,24,21,409809,4.3931323946009
atenolol,Counterfeit drug administered,1,12005,12004,9,8,409822,3.904494798030286
atenolol,Cyst of thyroid,1,12005,12004,8,7,409823,4.392567060979673
atenolol,Cyst of vulva,1,12005,12004,5,4,409826,7.028157280906365
atenolol,Cystatin C increased,8,12005,11997,29,21,409809,9.69911443378086
atenolol,Death (finding),8,12005,11997,69,61,409769,4.076052829632529
atenolol,Death of relative,2,12005,12003,17,15,409815,4.134436978990546
atenolol,Decreased body weight,2,12005,12003,16,14,409816,4.392849704240606
atenolol,Decreased therapeutic response,1,12005,12004,8,7,409823,4.392567060979673
atenolol,Decreased urine output,3,12005,12002,28,25,409805,3.7655063441807313
atenolol,Deformity of limb,2,12005,12003,21,19,409811,3.3468934353713156
atenolol,Delayed Hypersensitivity,1,12005,12004,10,9,409821,3.5140369876707767
atenolol,Dental alveolar anomaly,1,12005,12004,7,6,409824,5.0200885419146
atenolol,Depressed Level of Consciousness,5,12005,12000,52,47,409783,3.379671474358975
atenolol,Dermatitis Herpetiformis,1,12005,12004,9,8,409822,3.904494798030286
atenolol,Dermatitis acneiform,2,12005,12003,16,14,409816,4.392849704240606
atenolol,"Dermatitis, Atopic",3,12005,12002,10,7,409823,10.543867688718548
atenolol,Device defective,1,12005,12004,5,4,409826,7.028157280906365
atenolol,Device malfunction,39,12005,11966,428,389,409441,3.2090285794173834
atenolol,"Diabetes Mellitus, Non-Insulin-Dependent",3,12005,12002,8,5,409825,13.179897100483254
atenolol,Diabetic Foot,3,12005,12002,19,16,409814,5.549285645374893
atenolol,Differential white blood cell count abnormal,3,12005,12002,20,17,409813,5.271808865189135
atenolol,Difficulty standing,4,12005,12001,30,26,409804,4.686331694581007
atenolol,Dilatation of esophagus (disorder),1,12005,12004,8,7,409823,4.392567060979673
atenolol,Disorder of appendix,1,12005,12004,6,5,409825,5.856783849827835
atenolol,Disorder of bursa,1,12005,12004,5,4,409826,7.028157280906365
atenolol,Disorder of endocrine pancreas,3,12005,12002,10,7,409823,10.543867688718548
atenolol,Disorder of macula of retina,2,12005,12003,10,8,409822,7.0286595017912195
atenolol,Disseminated Histoplasmosis,3,12005,12002,15,12,409818,7.0291618063656065
atenolol,Drooling,3,12005,12002,34,31,409799,3.1009611143240834
atenolol,Drug resistance,1,12005,12004,11,10,409820,3.194571506467541
atenolol,Dwarfism,4,12005,12001,35,31,409799,4.016808123132596
atenolol,Dysgeusia,28,12005,11977,294,266,409564,3.351988135990808
atenolol,Dyslipidemias,1,12005,12004,11,10,409820,3.194571506467541
atenolol,Dyspnea on exertion,3,12005,12002,18,15,409815,5.857593178914625
atenolol,Dystonia,2,12005,12003,11,9,409821,6.389675308445616
atenolol,EKG: P wave abnormal,6,12005,11999,50,44,409786,4.218201516793066
atenolol,Ear discharge,2,12005,12003,16,14,409816,4.392849704240606
atenolol,Eating Disorders,6,12005,11999,54,48,409782,3.9057051050550506
atenolol,Ecchymosis,5,12005,12000,56,51,409779,3.1382366071428573
atenolol,Ectropion,1,12005,12004,9,8,409822,3.904494798030286
atenolol,Elbow deformity,1,12005,12004,7,6,409824,5.0200885419146
atenolol,Electrocardiogram QT borderline prolonged,1,12005,12004,7,6,409824,5.0200885419146
atenolol,Embolism,1,12005,12004,8,7,409823,4.392567060979673
atenolol,Enamel anomaly,2,12005,12003,20,18,409812,3.5142464383904026
atenolol,Enchondroma,1,12005,12004,6,5,409825,5.856783849827835
atenolol,Endodontic procedure,8,12005,11997,71,63,409767,3.961215656026683
atenolol,Eosinophilic granulomatosis with polyangiitis,1,12005,12004,9,8,409822,3.904494798030286
atenolol,Euphoric mood,12,12005,11993,131,119,409711,3.2209934166431693
atenolol,Exostoses,2,12005,12003,19,17,409813,3.699215546990445
atenolol,Extrapyramidal Disorders,2,12005,12003,13,11,409819,5.406622703298535
atenolol,Eye irritation,1,12005,12004,11,10,409820,3.194571506467541
atenolol,Eyelids pruritus,2,12005,12003,17,15,409815,4.134436978990546
atenolol,Faecal volume decreased,1,12005,12004,10,9,409821,3.5140369876707767
atenolol,Feeding tube complication,1,12005,12004,7,6,409824,5.0200885419146
atenolol,Felty Syndrome,2,12005,12003,13,11,409819,5.406622703298535
atenolol,Fever,3,12005,12002,32,29,409801,3.2947868063656056
atenolol,Fibrosis,2,12005,12003,19,17,409813,3.699215546990445
atenolol,First degree atrioventricular block,2,12005,12003,23,21,409809,3.0558447344685566
atenolol,Flail Chest,1,12005,12004,8,7,409823,4.392567060979673
atenolol,Fluid imbalance,4,12005,12001,41,37,409793,3.4289337677144793
atenolol,Folliculitis,2,12005,12003,11,9,409821,6.389675308445616
atenolol,Foot Deformities,15,12005,11990,148,133,409697,3.5645160381398915
atenolol,"Fracture Fixation, Internal",2,12005,12003,16,14,409816,4.392849704240606
atenolol,Fracture of acetabulum,1,12005,12004,8,7,409823,4.392567060979673
atenolol,Fracture of clavicle,1,12005,12004,9,8,409822,3.904494798030286
atenolol,Fracture of coccyx,2,12005,12003,23,21,409809,3.0558447344685566
atenolol,Fracture of forearm,9,12005,11996,53,44,409786,5.970603408683397
atenolol,Fracture of lumbar spine,2,12005,12003,18,16,409814,3.9047367787682705
atenolol,Fracture of patella,2,12005,12003,13,11,409819,5.406622703298535
atenolol,Fracture of sacrum,6,12005,11999,31,25,409805,6.803857310689869
atenolol,"Fractures, Ununited",34,12005,11971,317,283,409547,3.7766379159730654
atenolol,Friedreich Ataxia,1,12005,12004,11,10,409820,3.194571506467541
atenolol,Full blood count decreased,1,12005,12004,5,4,409826,7.028157280906365
atenolol,Galactosemias,2,12005,12003,23,21,409809,3.0558447344685566
atenolol,Gangrene,5,12005,12000,13,8,409822,13.519935897435898
atenolol,Gangrene due to diabetes mellitus,1,12005,12004,6,5,409825,5.856783849827835
atenolol,Gastric pH decreased,1,12005,12004,5,4,409826,7.028157280906365
atenolol,Gastric ulcer with perforation,1,12005,12004,5,4,409826,7.028157280906365
atenolol,Gastrointestinal infection,1,12005,12004,7,6,409824,5.0200885419146
atenolol,Gastrostomy,1,12005,12004,8,7,409823,4.392567060979673
atenolol,Genital pain,2,12005,12003,11,9,409821,6.389675308445616
atenolol,Genitourinary tract gonococcal infection,1,12005,12004,5,4,409826,7.028157280906365
atenolol,Gingival Recession,3,12005,12002,6,3,409827,17.57327945342443
atenolol,Growing pains,1,12005,12004,7,6,409824,5.0200885419146
atenolol,Haemorrhagic transformation stroke,1,12005,12004,8,7,409823,4.392567060979673
atenolol,Hamman-Rich syndrome,1,12005,12004,6,5,409825,5.856783849827835
atenolol,Hard stool,3,12005,12002,8,5,409825,13.179897100483254
atenolol,"Hearing Loss, Sudden",2,12005,12003,13,11,409819,5.406622703298535
atenolol,Hemangioma,2,12005,12003,8,6,409824,8.785866033491628
atenolol,Hematemesis,8,12005,11997,40,32,409798,7.031674585312995
atenolol,Hematoma of abdominal wall,2,12005,12003,22,20,409810,3.194754341717601
atenolol,"Hematoma, Subdural",6,12005,11999,58,52,409778,3.6363116466602103
atenolol,"Hemianopsia, Homonymous",1,12005,12004,8,7,409823,4.392567060979673
atenolol,Hemorrhage of penis,9,12005,11996,75,66,409764,4.219006335445148
atenolol,Hemorrhage of urethra,1,12005,12004,9,8,409822,3.904494798030286
atenolol,Hemorrhagic Stroke,6,12005,11999,68,62,409768,3.1014863983763354
atenolol,Hemospermia,2,12005,12003,7,5,409825,10.041013556134775
atenolol,Henoch-Schonlein purpura nephritis,1,12005,12004,8,7,409823,4.392567060979673
atenolol,Hepatic calcification,1,12005,12004,9,8,409822,3.904494798030286
atenolol,"Hepatitis, Chronic",1,12005,12004,8,7,409823,4.392567060979673
atenolol,Herpes zoster cutaneous disseminated,5,12005,12000,6,1,409829,29.293680555555557
atenolol,High density lipoprotein abnormal,10,12005,11995,61,51,409779,5.764341699751945
atenolol,High turnover osteopathy,1,12005,12004,5,4,409826,7.028157280906365
atenolol,Humeral Fractures,16,12005,11989,71,55,409775,7.92771777885597
atenolol,Hydrops Fetalis,1,12005,12004,6,5,409825,5.856783849827835
atenolol,Hyperphagia,1,12005,12004,11,10,409820,3.194571506467541
atenolol,Hypertensive cardiomyopathy,1,12005,12004,6,5,409825,5.856783849827835
atenolol,Hypertrophy of adenoids,1,12005,12004,11,10,409820,3.194571506467541
atenolol,Hypocupremia,1,12005,12004,9,8,409822,3.904494798030286
atenolol,Hyporeflexia,1,12005,12004,10,9,409821,3.5140369876707767
atenolol,Hysterectomy,5,12005,12000,17,12,409818,10.338676470588235
atenolol,Ileal Fistula,1,12005,12004,6,5,409825,5.856783849827835
atenolol,Iliotibial Band Syndrome,4,12005,12001,20,16,409814,7.029664194650446
atenolol,Impatience,2,12005,12003,13,11,409819,5.406622703298535
atenolol,Incision site infection,3,12005,12002,5,2,409828,21.087985335777372
atenolol,Incisional hernia,3,12005,12002,24,21,409809,4.3931323946009
atenolol,Infarction,13,12005,11992,54,41,409789,8.467300731351765
atenolol,Infarction of basal ganglia,1,12005,12004,7,6,409824,5.0200885419146
atenolol,Infectious Lung Disorder,4,12005,12001,16,12,409818,8.787163569702525
atenolol,Infectious pericarditis,1,12005,12004,11,10,409820,3.194571506467541
atenolol,Inflammation,1,12005,12004,7,6,409824,5.0200885419146
atenolol,Infusion site infection,1,12005,12004,7,6,409824,5.0200885419146
atenolol,Inguinal pain,2,12005,12003,19,17,409813,3.699215546990445
atenolol,Injection site haematoma,2,12005,12003,17,15,409815,4.134436978990546
atenolol,Injection site itching,7,12005,11998,82,75,409755,3.000775535760025
atenolol,Injection site nodule,6,12005,11999,70,64,409766,3.0128582143750076
atenolol,Injury of integument,1,12005,12004,5,4,409826,7.028157280906365
atenolol,Insulin-like growth factor increased,1,12005,12004,5,4,409826,7.028157280906365
atenolol,Intentional device misuse,5,12005,12000,14,9,409821,12.554196428571428
atenolol,International normalized ratio decreased,1,12005,12004,11,10,409820,3.194571506467541
atenolol,Intertrigo,2,12005,12003,6,4,409826,11.71454358632564
atenolol,Intervertebral disc compression,2,12005,12003,18,16,409814,3.9047367787682705
atenolol,Intra-abdominal hematoma,1,12005,12004,7,6,409824,5.0200885419146
atenolol,Invasive Lobular Breast Carcinoma,3,12005,12002,17,14,409816,6.202172186988443
atenolol,Iron deficiency,2,12005,12003,6,4,409826,11.71454358632564
atenolol,"Jaundice, Obstructive",2,12005,12003,7,5,409825,10.041013556134775
atenolol,Jealous delusion,1,12005,12004,8,7,409823,4.392567060979673
atenolol,Knee Replacement Arthroplasty,5,12005,12000,51,46,409784,3.4459477124183007
atenolol,Labyrinthitis,9,12005,11996,91,82,409748,3.4770711116159596
atenolol,Lacrimation decreased,2,12005,12003,12,10,409820,5.857188480657613
atenolol,Laminoplasty,1,12005,12004,5,4,409826,7.028157280906365
atenolol,Learning Disorders,6,12005,11999,52,46,409784,4.055943764544481
atenolol,"Leukemia, Myelocytic, Acute",5,12005,12000,48,43,409787,3.661345486111111
atenolol,Leukocytosis,1,12005,12004,6,5,409825,5.856783849827835
atenolol,"Leukoencephalopathy, Progressive Multifocal",22,12005,11983,219,197,409633,3.5345171260503365
atenolol,Lichen Planus,2,12005,12003,21,19,409811,3.3468934353713156
atenolol,Limb crushing injury,10,12005,11995,36,26,409804,9.76793571395489
atenolol,Limb prosthesis user,1,12005,12004,11,10,409820,3.194571506467541
atenolol,Liver carcinoma,6,12005,11999,68,62,409768,3.1014863983763354
atenolol,Liver enzymes abnormal,2,12005,12003,13,11,409819,5.406622703298535
atenolol,Low density lipoprotein increased,6,12005,11999,26,20,409810,8.112387570759102
atenolol,"Lupus Erythematosus, Systemic",1,12005,12004,6,5,409825,5.856783849827835
atenolol,Lymph node excision,4,12005,12001,33,29,409801,4.260271240022927
atenolol,Lymphedema,58,12005,11947,549,491,409339,3.725407739678419
atenolol,Lysis of adhesions of intestines,1,12005,12004,6,5,409825,5.856783849827835
atenolol,Macrocytosis (finding),2,12005,12003,22,20,409810,3.194754341717601
atenolol,Madarosis of eyelid,9,12005,11996,88,79,409751,3.5956332034920733
atenolol,Malignant mesothelioma,1,12005,12004,7,6,409824,5.0200885419146
atenolol,Malignant neoplasm of kidney,1,12005,12004,5,4,409826,7.028157280906365
atenolol,Malignant neoplasm of ovary,2,12005,12003,14,12,409818,5.020423465562181
atenolol,Malignant neoplasm of skin,2,12005,12003,19,17,409813,3.699215546990445
atenolol,Malignant neoplasm of tonsil,1,12005,12004,11,10,409820,3.194571506467541
atenolol,Mass of axilla,43,12005,11962,297,254,409576,5.1020526842295775
atenolol,Mass of lower limb,9,12005,11996,50,41,409789,6.328884628209403
atenolol,Mass of pancreas,4,12005,12001,44,40,409790,3.1951201036277284
atenolol,Mastocytosis,1,12005,12004,6,5,409825,5.856783849827835
atenolol,Melanocytic nevus,3,12005,12002,21,18,409812,5.020758445021067
atenolol,Menopausal syndrome,1,12005,12004,7,6,409824,5.0200885419146
atenolol,Menstruation Disturbances,1,12005,12004,10,9,409821,3.5140369876707767
atenolol,Mental Depression,78,12005,11927,585,507,409323,4.709203208406696
atenolol,Mental status changes postoperative,1,12005,12004,8,7,409823,4.392567060979673
atenolol,Mesenteric Vascular Occlusion,1,12005,12004,5,4,409826,7.028157280906365
atenolol,Mesenteritis,2,12005,12003,10,8,409822,7.0286595017912195
atenolol,Metabolic Syndrome X,5,12005,12000,31,26,409804,5.669408602150538
atenolol,Metastatic malignant neoplasm to liver,20,12005,11985,88,68,409762,7.997629612773542
atenolol,Metastatic malignant neoplasm to vertebral column,1,12005,12004,5,4,409826,7.028157280906365
atenolol,Metastatic non-small cell lung cancer,2,12005,12003,13,11,409819,5.406622703298535
atenolol,Metrorrhagia,2,12005,12003,20,18,409812,3.5142464383904026
atenolol,Migraine with Aura,1,12005,12004,9,8,409822,3.904494798030286
atenolol,Mitral Valve Insufficiency,9,12005,11996,84,75,409755,3.766889558424236
atenolol,Mitral Valve Prolapse Syndrome,16,12005,11989,78,62,409768,7.216136159000451
atenolol,Monocyte percentage decreased,3,12005,12002,17,14,409816,6.202172186988443
atenolol,Multiple sclerosis relapse,21,12005,11984,217,196,409634,3.4046847409449157
atenolol,Myoclonus,2,12005,12003,20,18,409812,3.5142464383904026
atenolol,"Myosclerosis, Autosomal Recessive",2,12005,12003,17,15,409815,4.134436978990546
atenolol,Nasopharyngitis,2,12005,12003,19,17,409813,3.699215546990445
atenolol,Neonatal Abstinence Syndrome,7,12005,11998,24,17,409813,10.254059704395177
atenolol,Neoplasm Metastasis,2,12005,12003,15,13,409817,4.685717459524008
atenolol,"Nephritis, Tubulointerstitial",2,12005,12003,9,7,409823,7.809640182546956
atenolol,Nephrosclerosis,8,12005,11997,41,33,409797,6.860154062905971
atenolol,Nephrotic Syndrome,1,12005,12004,5,4,409826,7.028157280906365
atenolol,Neurostimulator implantation,2,12005,12003,10,8,409822,7.0286595017912195
atenolol,Nightmares,1,12005,12004,6,5,409825,5.856783849827835
atenolol,Nocturia,2,12005,12003,23,21,409809,3.0558447344685566
atenolol,Non-Infectious Cystitis,1,12005,12004,11,10,409820,3.194571506467541
atenolol,Open reduction of fracture,2,12005,12003,16,14,409816,4.392849704240606
atenolol,Operation on neck,2,12005,12003,15,13,409817,4.685717459524008
atenolol,Operation on urinary bladder,1,12005,12004,5,4,409826,7.028157280906365
atenolol,Operative procedure on foot,2,12005,12003,18,16,409814,3.9047367787682705
atenolol,Operative procedure on spine,2,12005,12003,17,15,409815,4.134436978990546
atenolol,Optic Atrophy,10,12005,11995,94,84,409746,3.7403971512953094
atenolol,Oral Hemorrhage,1,12005,12004,7,6,409824,5.0200885419146
atenolol,Oral discharge,5,12005,12000,30,25,409805,5.858402777777777
atenolol,Oral herpes simplex infection,1,12005,12004,9,8,409822,3.904494798030286
atenolol,Orthostatic intolerance,4,12005,12001,17,13,409817,8.270251988804855
atenolol,Osteolysis,8,12005,11997,28,20,409810,10.04553519332214
atenolol,Osteoporosis,19,12005,11986,132,113,409717,5.06421443704524
atenolol,Overactive Bladder,2,12005,12003,13,11,409819,5.406622703298535
atenolol,Pain in coccyx,1,12005,12004,5,4,409826,7.028157280906365
atenolol,Palmar-plantar erythrodysesthesia syndrome,4,12005,12001,46,42,409788,3.056187346706615
atenolol,Pancreatic Insufficiency,3,12005,12002,32,29,409801,3.2947868063656056
atenolol,Pancreatic carcinoma,2,12005,12003,22,20,409810,3.194754341717601
atenolol,Panic Disorder,3,12005,12002,15,12,409818,7.0291618063656065
atenolol,Papule,1,12005,12004,10,9,409821,3.5140369876707767
atenolol,Parainfluenza Virus Infections,1,12005,12004,11,10,409820,3.194571506467541
atenolol,Paranoid Schizophrenia,2,12005,12003,16,14,409816,4.392849704240606
atenolol,Parasomnia,4,12005,12001,23,19,409811,6.1127079989711
atenolol,Paraspinal abscess,1,12005,12004,9,8,409822,3.904494798030286
atenolol,Paroxysmal nocturnal hemoglobinuria,1,12005,12004,5,4,409826,7.028157280906365
atenolol,Partial thromboplastin time increased (finding),2,12005,12003,15,13,409817,4.685717459524008
atenolol,Perinuclear antineutrophil cytoplasmic antibody increased,1,12005,12004,7,6,409824,5.0200885419146
atenolol,Periodontitis,5,12005,12000,52,47,409783,3.379671474358975
atenolol,Peripheral motor neuropathy,1,12005,12004,5,4,409826,7.028157280906365
atenolol,Peripheral nerve lesion,3,12005,12002,28,25,409805,3.7655063441807313
atenolol,Permanent cardiac pacemaker insertion,1,12005,12004,7,6,409824,5.0200885419146
atenolol,Phonophobia,1,12005,12004,6,5,409825,5.856783849827835
atenolol,Platelet aggregation inhibition,3,12005,12002,14,11,409819,7.531262646701739
atenolol,Polymyositis,1,12005,12004,7,6,409824,5.0200885419146
atenolol,Post procedural hematoma,2,12005,12003,15,13,409817,4.685717459524008
atenolol,Post-Concussion Syndrome,3,12005,12002,31,28,409802,3.401078314904505
atenolol,Post-Traumatic Stress Disorder,1,12005,12004,5,4,409826,7.028157280906365
atenolol,Pre-existing condition,2,12005,12003,18,16,409814,3.9047367787682705
atenolol,Prescribed overdose,39,12005,11966,253,214,409616,5.430966790623499
atenolol,Primary sequestrum,2,12005,12003,17,15,409815,4.134436978990546
atenolol,Procedural hypotension,5,12005,12000,47,42,409788,3.7392553191489366
atenolol,Projectile vomiting,2,12005,12003,23,21,409809,3.0558447344685566
atenolol,Prosthesis user,3,12005,12002,19,16,409814,5.549285645374893
atenolol,Proteinuria,1,12005,12004,6,5,409825,5.856783849827835
atenolol,Protrusion of tongue,1,12005,12004,5,4,409826,7.028157280906365
atenolol,Pruritus Ani,4,12005,12001,30,26,409804,4.686331694581007
atenolol,Pruritus allergic,1,12005,12004,6,5,409825,5.856783849827835
atenolol,Psoriasis,2,12005,12003,21,19,409811,3.3468934353713156
atenolol,Pulmonary Hypertension,13,12005,11992,44,31,409799,10.391933637576567
atenolol,Pulmonary vasculitis,1,12005,12004,5,4,409826,7.028157280906365
atenolol,Radius Fractures,3,12005,12002,31,28,409802,3.401078314904505
atenolol,Rectal Carcinoma,1,12005,12004,5,4,409826,7.028157280906365
atenolol,Recurrent Unspecified Lung Carcinoma,4,12005,12001,26,22,409808,5.407357079217758
atenolol,Refusal of Treatment,1,12005,12004,10,9,409821,3.5140369876707767
atenolol,Removal of catheter,1,12005,12004,11,10,409820,3.194571506467541
atenolol,Renal cancer metastatic,4,12005,12001,29,25,409805,4.847940832516831
atenolol,Renal fibrosis,1,12005,12004,11,10,409820,3.194571506467541
atenolol,Repair of eyelid,1,12005,12004,10,9,409821,3.5140369876707767
atenolol,Retinal Diseases,2,12005,12003,13,11,409819,5.406622703298535
atenolol,Retinal Dystrophies,1,12005,12004,5,4,409826,7.028157280906365
atenolol,Retinal vascular thrombosis,1,12005,12004,8,7,409823,4.392567060979673
atenolol,Rheumatoid Factor Measurement,1,12005,12004,6,5,409825,5.856783849827835
atenolol,Rhonchi,1,12005,12004,10,9,409821,3.5140369876707767
atenolol,Ruptured cerebral aneurysm,4,12005,12001,17,13,409817,8.270251988804855
atenolol,Scarred macula,2,12005,12003,13,11,409819,5.406622703298535
atenolol,Scleroderma,1,12005,12004,9,8,409822,3.904494798030286
atenolol,Sensory disorder of eyelid,1,12005,12004,8,7,409823,4.392567060979673
atenolol,Sigmoiditis,2,12005,12003,8,6,409824,8.785866033491628
atenolol,Sinoatrial Block,2,12005,12003,19,17,409813,3.699215546990445
atenolol,Skin Wrinkling,8,12005,11997,81,73,409757,3.4720943610388195
atenolol,Skin neoplasm excision,2,12005,12003,10,8,409822,7.0286595017912195
atenolol,Sore to touch,2,12005,12003,12,10,409820,5.857188480657613
atenolol,Spider Veins,3,12005,12002,5,2,409828,21.087985335777372
atenolol,Spinal stenosis in cervical region,3,12005,12002,11,8,409822,9.585311538985925
atenolol,Spinal stenosis of lumbar region,1,12005,12004,9,8,409822,3.904494798030286
atenolol,Sputum retention,1,12005,12004,8,7,409823,4.392567060979673
atenolol,Steatohepatitis,9,12005,11996,79,70,409760,4.005347774152566
atenolol,Stenosis of intestine,1,12005,12004,6,5,409825,5.856783849827835
atenolol,Stomach Neoplasms,1,12005,12004,11,10,409820,3.194571506467541
atenolol,Streptococcal pneumonia,3,12005,12002,23,20,409810,4.584149018641821
atenolol,Subclavian Steal Syndrome,2,12005,12003,7,5,409825,10.041013556134775
atenolol,Superficial phlebitis,9,12005,11996,92,83,409747,3.439268705510533
atenolol,Swelling,19,12005,11986,185,166,409664,3.612931302736075
atenolol,Swollen nasal mucosa (finding),4,12005,12001,40,36,409794,3.5146654445462877
atenolol,T-Cell Lymphoma,1,12005,12004,5,4,409826,7.028157280906365
atenolol,"Tachycardia, Ventricular",3,12005,12002,33,30,409800,3.1949372074351245
atenolol,Talipes,1,12005,12004,8,7,409823,4.392567060979673
atenolol,Tenalgia,2,12005,12003,19,17,409813,3.699215546990445
atenolol,Therapy change,4,12005,12001,28,24,409806,5.021093480305213
atenolol,Thrombocytosis,1,12005,12004,5,4,409826,7.028157280906365
atenolol,Thrombus of cardiac chamber,10,12005,11995,101,91,409739,3.4811039253154163
atenolol,Tibial Fractures,4,12005,12001,22,18,409812,6.390573512813327
atenolol,Tooth Infection,9,12005,11996,76,67,409763,4.163483222477668
atenolol,Tooth Injuries,8,12005,11997,25,17,409813,11.2510794365258
atenolol,Total protein measurement,1,12005,12004,8,7,409823,4.392567060979673
atenolol,Traffic accident on public road,4,12005,12001,31,27,409803,4.535148952641043
atenolol,Troponin I increased,3,12005,12002,35,32,409798,3.01235508367653
atenolol,Ulcer of pharynx,1,12005,12004,11,10,409820,3.194571506467541
atenolol,Ulcerative esophagitis,2,12005,12003,6,4,409826,11.71454358632564
atenolol,Ulcerative gingivitis,2,12005,12003,5,3,409827,14.057485628592854
atenolol,Unilateral deafness,4,12005,12001,23,19,409811,6.1127079989711
atenolol,Upper gastrointestinal hemorrhage,3,12005,12002,5,2,409828,21.087985335777372
atenolol,Urine output increased,2,12005,12003,13,11,409819,5.406622703298535
atenolol,Vaccination site erythema,1,12005,12004,7,6,409824,5.0200885419146
atenolol,Vaccination site pain,1,12005,12004,6,5,409825,5.856783849827835
atenolol,Vaginal Diseases,2,12005,12003,20,18,409812,3.5142464383904026
atenolol,Vaginal Prolapse,1,12005,12004,10,9,409821,3.5140369876707767
atenolol,Vascular pain,1,12005,12004,11,10,409820,3.194571506467541
atenolol,Ventricular Fibrillation,4,12005,12001,6,2,409828,23.432991695136515
atenolol,Vulvovaginal pruritus,2,12005,12003,22,20,409810,3.194754341717601
atenolol,Wheezing,18,12005,11987,160,142,409688,3.9574904062734633
atenolol,Wound discharge finding,1,12005,12004,11,10,409820,3.194571506467541
atenolol,Wound hematoma,1,12005,12004,9,8,409822,3.904494798030286
atenolol,Wrong technique in drug usage process,8,12005,11997,48,40,409790,5.859617682198327
atenolol,c-ANCA positive,8,12005,11997,29,21,409809,9.69911443378086
atenolol,hypoglycemic encephalopathy,2,12005,12003,14,12,409818,5.020423465562181
atenolol,pseudomembranous colitis,3,12005,12002,13,10,409820,8.11060977016651
atenolol,treatment failure,8,12005,11997,63,55,409775,4.464311845157057
benazepril,APACHE II score increased,1,7188,7187,18,17,414630,3.2606480837314287
benazepril,Abdominal Neoplasms,2,7188,7186,21,19,414628,5.590420526685485
benazepril,Abdominal symptom,1,7188,7187,9,8,414639,6.521435307576952
benazepril,Abnormal breath sounds,1,7188,7187,12,11,414636,4.89104169565419
benazepril,Abnormal urine,1,7188,7187,11,10,414637,5.335694498905853
benazepril,Abnormal weight loss (finding),9,7188,7179,172,163,414484,3.0733753486428443
benazepril,Accessory cardiac pathway,1,7188,7187,8,7,414640,7.336632113538333
benazepril,Acquired hemophilia,1,7188,7187,8,7,414640,7.336632113538333
benazepril,Acquired oesophageal web,1,7188,7187,6,5,414642,9.782222531422475
benazepril,Acral overgrowth,3,7188,7185,24,21,414626,7.338395963813501
benazepril,Acrochordon excision,3,7188,7185,47,44,414603,3.7470616976857816
benazepril,Adrenal atrophy,1,7188,7187,6,5,414642,9.782222531422475
benazepril,Alcohol Problem,2,7188,7186,19,17,414630,6.178915142015908
benazepril,Alcohol abuse,2,7188,7186,17,15,414632,6.905879078600547
benazepril,Amebiasis,1,7188,7187,11,10,414637,5.335694498905853
benazepril,Anal abscess,2,7188,7186,37,35,414612,3.1728210258686182
benazepril,Anal inflammation,1,7188,7187,5,4,414643,11.73869486572979
benazepril,Ankle Fracture,7,7188,7181,73,66,414581,5.6319358733949745
benazepril,Anuria,9,7188,7179,93,84,414563,5.685156976665812
benazepril,Aortitis,2,7188,7186,29,27,414620,4.048158776164381
benazepril,Apnea,1,7188,7187,14,13,414634,4.192301576258721
benazepril,Appendicitis,7,7188,7181,104,97,414550,3.952895193512795
benazepril,Application site discolouration,1,7188,7187,7,6,414641,8.384742292631536
benazepril,Application site edema,1,7188,7187,11,10,414637,5.335694498905853
benazepril,Application site itching,1,7188,7187,9,8,414639,6.521435307576952
benazepril,Application site reaction,2,7188,7186,16,14,414633,7.337513915947675
benazepril,Application site urticaria,4,7188,7184,33,29,414618,7.11685901329554
benazepril,Arnold Chiari Malformation,1,7188,7187,17,16,414631,3.4524590968988123
benazepril,Arthroplasty,1,7188,7187,7,6,414641,8.384742292631536
benazepril,Ascorbic Acid Deficiency,1,7188,7187,8,7,414640,7.336632113538333
benazepril,Atrioventricular Block,3,7188,7185,27,24,414623,6.522972241552617
benazepril,Autoimmune myocarditis,1,7188,7187,12,11,414636,4.89104169565419
benazepril,Bacterial sepsis,1,7188,7187,15,14,414633,3.912805528500533
benazepril,Basophil count outside reference range,2,7188,7186,6,4,414643,19.567167640783005
benazepril,Benign bone neoplasm,3,7188,7185,8,5,414642,22.016022964509396
benazepril,Bicuspid aortic valve,4,7188,7184,19,15,414632,12.36127065994608
benazepril,Bladder malposition acquired,2,7188,7186,29,27,414620,4.048158776164381
benazepril,Bleeding gastric ulcer,3,7188,7185,51,48,414599,3.4531417577469403
benazepril,Blister at injection site,2,7188,7186,14,12,414635,8.38576994950499
benazepril,Blood albumin abnormal,1,7188,7187,15,14,414633,3.912805528500533
benazepril,Blood creatinine abnormal,3,7188,7185,17,14,414633,10.360260346309715
benazepril,Blood parathyroid hormone decreased,1,7188,7187,5,4,414643,11.73869486572979
benazepril,Blood pressure difference of extremities,2,7188,7186,11,9,414638,10.672874022720947
benazepril,Body height below normal,9,7188,7179,131,122,414525,4.035663815900703
benazepril,Bone scan abnormal,1,7188,7187,14,13,414634,4.192301576258721
benazepril,Bowel movement irregularity,3,7188,7185,48,45,414602,3.668989213639527
benazepril,Brachial Plexus Neuropathies,1,7188,7187,16,15,414632,3.668246486712119
benazepril,"Brain Diseases, Metabolic",1,7188,7187,7,6,414641,8.384742292631536
benazepril,Breakthrough Pain,5,7188,7183,82,77,414570,3.580209709238955
benazepril,Bromhidrosis,2,7188,7186,7,5,414642,16.7718182179635
benazepril,Bronchospasm,1,7188,7187,13,12,414635,4.514797015979708
benazepril,Bunion,1,7188,7187,19,18,414629,3.0890277035290326
benazepril,Bursal fluid accumulation,1,7188,7187,13,12,414635,4.514797015979708
benazepril,Calcium Metabolism Disorders,1,7188,7187,17,16,414631,3.4524590968988123
benazepril,Campylobacter infection,1,7188,7187,11,10,414637,5.335694498905853
benazepril,Carbohydrate antigen 125 normal,1,7188,7187,10,9,414638,5.869277862807848
benazepril,Carbohydrate antigen 15-3 increased,1,7188,7187,7,6,414641,8.384742292631536
benazepril,Cardiac discomfort,2,7188,7186,17,15,414632,6.905879078600547
benazepril,Cartilage Diseases,2,7188,7186,31,29,414618,3.7869692861567743
benazepril,Cataplexy,1,7188,7187,17,16,414631,3.4524590968988123
benazepril,Cavitation of lung,2,7188,7186,27,25,414622,4.348043005432373
benazepril,Cerebellar stroke,2,7188,7186,5,3,414644,23.48065683273031
benazepril,Cesarean section,1,7188,7187,13,12,414635,4.514797015979708
benazepril,Choking,9,7188,7179,142,133,414514,3.7229448567712162
benazepril,Chronic sinusitis,5,7188,7183,75,70,414577,3.914427583646573
benazepril,Clostridial gastroenteritis,1,7188,7187,7,6,414641,8.384742292631536
benazepril,Clostridium difficile sepsis,5,7188,7183,51,46,414601,5.756838723238146
benazepril,Colonic Pseudo-Obstruction,1,7188,7187,15,14,414633,3.912805528500533
benazepril,Colostomy Procedure,1,7188,7187,17,16,414631,3.4524590968988123
benazepril,Congenital anomaly of gastrointestinal tract,1,7188,7187,11,10,414637,5.335694498905853
benazepril,Congenital cystic kidney disease,3,7188,7185,55,52,414595,3.20197380907193
benazepril,Congenital umbilical hernia,1,7188,7187,11,10,414637,5.335694498905853
benazepril,Conn Syndrome,3,7188,7185,31,28,414619,5.68124452825106
benazepril,Corrective lens user,1,7188,7187,5,4,414643,11.73869486572979
benazepril,Creatinine clearance-glomerular filtration outside reference range,1,7188,7187,5,4,414643,11.73869486572979
benazepril,Culture urine positive,2,7188,7186,17,15,414632,6.905879078600547
benazepril,Cystic Fibrosis,1,7188,7187,11,10,414637,5.335694498905853
benazepril,Deep Vein Thrombosis,1,7188,7187,19,18,414629,3.0890277035290326
benazepril,Deglutition Disorders,8,7188,7180,144,136,414511,3.2628520581863194
benazepril,"Dementia, Vascular",1,7188,7187,9,8,414639,6.521435307576952
benazepril,Dermatologic disorders,2,7188,7186,34,32,414615,3.452800379823513
benazepril,Dermatomycoses,4,7188,7184,31,27,414620,7.576047129822545
benazepril,Device dislocation,4,7188,7184,57,53,414594,4.120052358066658
benazepril,Device fastener issue,2,7188,7186,31,29,414618,3.7869692861567743
benazepril,Difficulty standing,3,7188,7185,30,27,414620,5.870633263743911
benazepril,Dilatation of ureter,1,7188,7187,18,17,414630,3.2606480837314287
benazepril,Disability,6,7188,7182,40,34,414613,8.809419381787801
benazepril,Discomfort,3,7188,7185,53,50,414597,3.322818765509907
benazepril,Disorder of endocrine pancreas,1,7188,7187,10,9,414638,5.869277862807848
benazepril,Disorder of macula of retina,1,7188,7187,10,9,414638,5.869277862807848
benazepril,"Disruptive, Impulse Control, and Conduct Disorders",6,7188,7182,56,50,414597,6.292203723594701
benazepril,Drug administered at inappropriate site,2,7188,7186,32,30,414617,3.668617798497078
benazepril,Drug delivery system issue,1,7188,7187,6,5,414642,9.782222531422475
benazepril,Dysentery,2,7188,7186,28,26,414621,4.192745815275734
benazepril,Dysphemia,1,7188,7187,10,9,414638,5.869277862807848
benazepril,Eclampsia,1,7188,7187,8,7,414640,7.336632113538333
benazepril,"Edema, Cardiac",16,7188,7172,299,283,414364,3.1451631857073306
benazepril,Electrolyte imbalance,1,7188,7187,19,18,414629,3.0890277035290326
benazepril,Employment dissatisfaction,1,7188,7187,18,17,414630,3.2606480837314287
benazepril,Endodontic procedure,4,7188,7184,71,67,414580,3.3075378775996738
benazepril,Endometrial Carcinoma,5,7188,7183,23,18,414629,12.766011536901742
benazepril,Erythrocyte sedimentation rate outside reference range,1,7188,7187,11,10,414637,5.335694498905853
benazepril,Extra dose administered,1,7188,7187,6,5,414642,9.782222531422475
benazepril,Eye Injuries,4,7188,7184,60,56,414591,3.9140219005196735
benazepril,Eye operation complication,1,7188,7187,6,5,414642,9.782222531422475
benazepril,Eyelid exfoliation,8,7188,7180,107,99,414548,4.391513289771692
benazepril,Factor VIII Deficiency,9,7188,7179,144,135,414512,3.6712198774202536
benazepril,Faecal calprotectin increased,1,7188,7187,6,5,414642,9.782222531422475
benazepril,Familial Periodic Paralysis,3,7188,7185,14,11,414636,12.580405606919177
benazepril,Fat redistribution,1,7188,7187,5,4,414643,11.73869486572979
benazepril,Feels hot,2,7188,7186,39,37,414610,3.010097982544406
benazepril,Female genital infection,2,7188,7186,14,12,414635,8.38576994950499
benazepril,Flatulence,8,7188,7180,121,113,414534,3.883275397684109
benazepril,Folic Acid Deficiency,1,7188,7187,15,14,414633,3.912805528500533
benazepril,Gall Bladder Diseases,6,7188,7182,43,37,414610,8.194750441996465
benazepril,Gastric ulcer operation,1,7188,7187,19,18,414629,3.0890277035290326
benazepril,"Gastritis, Hypertrophic",1,7188,7187,5,4,414643,11.73869486572979
benazepril,Gastrointestinal disorder postoperative,1,7188,7187,19,18,414629,3.0890277035290326
benazepril,Gastrointestinal hypomotility,3,7188,7185,56,53,414594,3.1447882493289594
benazepril,Gastrooesophageal sphincter insufficiency,1,7188,7187,18,17,414630,3.2606480837314287
benazepril,General symptom,3,7188,7185,31,28,414619,5.68124452825106
benazepril,Glycogen Storage Disease Type V,1,7188,7187,19,18,414629,3.0890277035290326
benazepril,Gum Infection,2,7188,7186,37,35,414612,3.1728210258686182
benazepril,Haemorrhagic erosive gastritis,1,7188,7187,10,9,414638,5.869277862807848
benazepril,Heart valve stenosis,4,7188,7184,12,8,414639,19.57233667409057
benazepril,"Hemianopsia, Homonymous",1,7188,7187,8,7,414640,7.336632113538333
benazepril,Hemoperitoneum,1,7188,7187,14,13,414634,4.192301576258721
benazepril,Hemorrhage of urethra,1,7188,7187,9,8,414639,6.521435307576952
benazepril,"Hernia, Inguinal",1,7188,7187,17,16,414631,3.4524590968988123
benazepril,Hospitalization,3,7188,7185,55,52,414595,3.20197380907193
benazepril,Hyperlipasaemia,1,7188,7187,6,5,414642,9.782222531422475
benazepril,"Hypertonia, Neonatal",2,7188,7186,37,35,414612,3.1728210258686182
benazepril,Hyperuricemia,1,7188,7187,19,18,414629,3.0890277035290326
benazepril,Hypokalemic alkalosis,1,7188,7187,5,4,414643,11.73869486572979
benazepril,Hypophagia,2,7188,7186,29,27,414620,4.048158776164381
benazepril,Hypoxic ischaemic encephalopathy neonatal,3,7188,7185,17,14,414633,10.360260346309715
benazepril,Iatrogenic injury,1,7188,7187,10,9,414638,5.869277862807848
benazepril,Immune-mediated hepatitis,1,7188,7187,10,9,414638,5.869277862807848
benazepril,Impaired pupillary reflex,9,7188,7179,109,100,414547,4.850454498403217
benazepril,Incorrect product storage,1,7188,7187,18,17,414630,3.2606480837314287
benazepril,Increased Libido,1,7188,7187,17,16,414631,3.4524590968988123
benazepril,Increased RBC distribution width,2,7188,7186,25,23,414624,4.695908711383245
benazepril,Inflammation,1,7188,7187,7,6,414641,8.384742292631536
benazepril,Injection site atrophy,1,7188,7187,17,16,414631,3.4524590968988123
benazepril,Injection site haematoma,1,7188,7187,17,16,414631,3.4524590968988123
benazepril,Injection site injury,1,7188,7187,14,13,414634,4.192301576258721
benazepril,Instillation site pruritus,2,7188,7186,10,8,414639,11.740189256888396
benazepril,International normalized ratio outside reference range,2,7188,7186,36,34,414613,3.2609626743359
benazepril,Intramedullary rod insertion,1,7188,7187,13,12,414635,4.514797015979708
benazepril,Ischemic cardiomyopathy,1,7188,7187,14,13,414634,4.192301576258721
benazepril,Juvenile-Onset Still Disease,2,7188,7186,31,29,414618,3.7869692861567743
benazepril,Ketoacidosis,9,7188,7179,172,163,414484,3.0733753486428443
benazepril,Large prostate,12,7188,7176,172,160,414487,4.099546939410438
benazepril,Left atrial dilatation,3,7188,7185,45,42,414605,3.9136163303177915
benazepril,Left ventricle outflow tract obstruction,2,7188,7186,32,30,414617,3.668617798497078
benazepril,Leukopenia,2,7188,7186,24,22,414625,4.89158317098061
benazepril,Limb operation,8,7188,7180,138,130,414517,3.404763634895644
benazepril,Lipoid nephrosis,1,7188,7187,7,6,414641,8.384742292631536
benazepril,Lower respiratory tract infection,1,7188,7187,16,15,414632,3.668246486712119
benazepril,Lung mass,5,7188,7183,64,59,414588,4.587339464708339
benazepril,Lupus Nephritis,1,7188,7187,7,6,414641,8.384742292631536
benazepril,Malignant Bone Neoplasm,3,7188,7185,33,30,414617,5.336901372809515
benazepril,Malignant neoplasm of female breast,1,7188,7187,9,8,414639,6.521435307576952
benazepril,Malignant neoplasm of kidney,1,7188,7187,5,4,414643,11.73869486572979
benazepril,Malignant neoplasm of urinary bladder,3,7188,7185,27,24,414623,6.522972241552617
benazepril,Malignant tumor of nasal sinuses,1,7188,7187,14,13,414634,4.192301576258721
benazepril,Malignant tumor of peritoneum,1,7188,7187,5,4,414643,11.73869486572979
benazepril,Manipulation of joint - non-surgical,1,7188,7187,7,6,414641,8.384742292631536
benazepril,Mass of thyroid gland,1,7188,7187,19,18,414629,3.0890277035290326
benazepril,Mass of urinary bladder,4,7188,7184,31,27,414620,7.576047129822545
benazepril,Mastocytosis,2,7188,7186,6,4,414643,19.567167640783005
benazepril,Mean corpuscular volume above reference range,2,7188,7186,10,8,414639,11.740189256888396
benazepril,Melanocytic nevus,3,7188,7185,21,18,414629,8.386797892434634
benazepril,Membranous glomerulonephritis,2,7188,7186,15,13,414634,7.826700064941089
benazepril,"Meningitis, Bacterial",2,7188,7186,28,26,414621,4.192745815275734
benazepril,Menorrhagia,4,7188,7184,26,22,414625,9.033086345725545
benazepril,Mental status changes postoperative,1,7188,7187,8,7,414640,7.336632113538333
benazepril,Metastases to abdominal cavity,2,7188,7186,10,8,414639,11.740189256888396
benazepril,Mitochondrial myopathy acquired,1,7188,7187,13,12,414635,4.514797015979708
benazepril,Mitral Valve Insufficiency,5,7188,7183,84,79,414568,3.494950047400277
benazepril,Morning Sickness,7,7188,7181,70,63,414584,5.873346330594625
benazepril,Multi-organ disorder,2,7188,7186,19,17,414630,6.178915142015908
benazepril,"Multiple Sclerosis, Primary Progressive",1,7188,7187,19,18,414629,3.0890277035290326
benazepril,Multiple allergies,9,7188,7179,99,90,414557,5.340526029201333
benazepril,Muscle Rigidity,5,7188,7183,49,44,414603,5.991840144104419
benazepril,Myelitis,2,7188,7186,5,3,414644,23.48065683273031
benazepril,Nasal mucosa dry,1,7188,7187,8,7,414640,7.336632113538333
benazepril,Nasal polypectomy (procedure),1,7188,7187,12,11,414636,4.89104169565419
benazepril,Nasopharyngitis,2,7188,7186,19,17,414630,6.178915142015908
benazepril,Neonatal Abstinence Syndrome,2,7188,7186,24,22,414625,4.89158317098061
benazepril,Neonatal hypotension,1,7188,7187,9,8,414639,6.521435307576952
benazepril,Neoplasm Metastasis,1,7188,7187,15,14,414633,3.912805528500533
benazepril,Nephrolithiasis,2,7188,7186,13,11,414636,9.03085058554026
benazepril,Nerve Degeneration,1,7188,7187,9,8,414639,6.521435307576952
benazepril,Neuritis,10,7188,7178,114,104,414543,5.153673749712817
benazepril,Neuromuscular Diseases,1,7188,7187,9,8,414639,6.521435307576952
benazepril,Nummular eczema,12,7188,7176,235,223,414424,3.000071159183092
benazepril,Obstruction,1,7188,7187,10,9,414638,5.869277862807848
benazepril,Ocular Hypotension,6,7188,7182,75,69,414578,4.697967140072404
benazepril,Oestradiol increased,5,7188,7183,8,3,414644,36.703588333565364
benazepril,Operation on eyelid,1,7188,7187,7,6,414641,8.384742292631536
benazepril,Oral pain,2,7188,7186,39,37,414610,3.010097982544406
benazepril,Orchitis,2,7188,7186,10,8,414639,11.740189256888396
benazepril,Organ Transplantation,1,7188,7187,5,4,414643,11.73869486572979
benazepril,Orthopnea,2,7188,7186,32,30,414617,3.668617798497078
benazepril,Osteonecrosis of Jaw,8,7188,7180,143,135,414512,3.28567699709761
benazepril,Ototoxicity,1,7188,7187,9,8,414639,6.521435307576952
benazepril,"Pain, Procedural",3,7188,7185,42,39,414608,4.193190177950094
benazepril,Papilledema,2,7188,7186,12,10,414637,9.783444660914741
benazepril,Papule,1,7188,7187,10,9,414638,5.869277862807848
benazepril,Parainfluenza Virus Infections,1,7188,7187,11,10,414637,5.335694498905853
benazepril,Paralysed,4,7188,7184,35,31,414616,6.710149538657333
benazepril,Paranasal sinus hypersecretion,1,7188,7187,17,16,414631,3.4524590968988123
benazepril,Paratyphoid Fever,2,7188,7186,11,9,414638,10.672874022720947
benazepril,Parvovirus B19 test positive,2,7188,7186,33,31,414616,3.5574391282713016
benazepril,Pathological fracture,1,7188,7187,13,12,414635,4.514797015979708
benazepril,Patient-device incompatibility,2,7188,7186,10,8,414639,11.740189256888396
benazepril,Penetrating Atherosclerotic Ulcer,3,7188,7185,17,14,414633,10.360260346309715
benazepril,Perforation of ileum,1,7188,7187,14,13,414634,4.192301576258721
benazepril,Perforation of rectum,4,7188,7184,12,8,414639,19.57233667409057
benazepril,Peritoneal carcinoma metastatic,2,7188,7186,5,3,414644,23.48065683273031
benazepril,Pharyngeal swelling,1,7188,7187,14,13,414634,4.192301576258721
benazepril,Photopsia,1,7188,7187,9,8,414639,6.521435307576952
benazepril,Physical therapy,4,7188,7184,6,2,414645,39.14523014105419
benazepril,Placenta Previa,3,7188,7185,45,42,414605,3.9136163303177915
benazepril,Polycythemia,2,7188,7186,24,22,414625,4.89158317098061
benazepril,Polymenorrhea,4,7188,7184,51,47,414600,4.604829905236036
benazepril,Polyp of vagina,3,7188,7185,15,12,414635,11.74168406402227
benazepril,Postoperative confusion,1,7188,7187,14,13,414634,4.192301576258721
benazepril,Primary Myelofibrosis,1,7188,7187,7,6,414641,8.384742292631536
benazepril,Product monitoring error,2,7188,7186,9,7,414640,13.044685654204162
benazepril,Prolapse of urethra,4,7188,7184,27,23,414624,8.698506970221892
benazepril,Prolonged bleeding time,4,7188,7184,58,54,414593,4.0490073727056295
benazepril,Prolonged labor,2,7188,7186,27,25,414622,4.348043005432373
benazepril,Protein urine present,1,7188,7187,9,8,414639,6.521435307576952
benazepril,Psychomotor Agitation,1,7188,7187,9,8,414639,6.521435307576952
benazepril,Psychomotor skills impaired,1,7188,7187,11,10,414637,5.335694498905853
benazepril,Psychotic Disorders,1,7188,7187,19,18,414629,3.0890277035290326
benazepril,Ptosis of eyebrow,1,7188,7187,13,12,414635,4.514797015979708
benazepril,Pyometra,1,7188,7187,9,8,414639,6.521435307576952
benazepril,Reaction to drug excipients,2,7188,7186,36,34,414613,3.2609626743359
benazepril,Reaction to previous exposure to any vaccine,1,7188,7187,5,4,414643,11.73869486572979
benazepril,Rectal Prolapse,2,7188,7186,8,6,414641,14.675306150848872
benazepril,Rectal pain,1,7188,7187,13,12,414635,4.514797015979708
benazepril,Red blood cell morphology abnormal,2,7188,7186,32,30,414617,3.668617798497078
benazepril,Renal failure neonatal,4,7188,7184,12,8,414639,19.57233667409057
benazepril,Renal fibrosis,1,7188,7187,11,10,414637,5.335694498905853
benazepril,Renal tubular disorder,2,7188,7186,19,17,414630,6.178915142015908
benazepril,Renal vasculitis,5,7188,7183,45,40,414607,6.524510031401302
benazepril,Respiratory tract oedema,1,7188,7187,6,5,414642,9.782222531422475
benazepril,Retinal migraine,2,7188,7186,7,5,414642,16.7718182179635
benazepril,Retinal scar,1,7188,7187,8,7,414640,7.336632113538333
benazepril,Rhonchi,1,7188,7187,10,9,414638,5.869277862807848
benazepril,Rib Fractures,6,7188,7182,108,102,414545,3.262221912806708
benazepril,Ruptured cerebral aneurysm,1,7188,7187,17,16,414631,3.4524590968988123
benazepril,Seborrheic dermatitis of scalp,3,7188,7185,21,18,414629,8.386797892434634
benazepril,Segmental diverticular colitis,1,7188,7187,17,16,414631,3.4524590968988123
benazepril,Sensorimotor disorder,1,7188,7187,5,4,414643,11.73869486572979
benazepril,"Shock, Cardiogenic",5,7188,7183,96,91,414556,3.0579942804770526
benazepril,Shunt occlusion,4,7188,7184,63,59,414588,3.7276133913104954
benazepril,Speech Disorders,2,7188,7186,15,13,414634,7.826700064941089
benazepril,Spinal stenosis in cervical region,1,7188,7187,11,10,414637,5.335694498905853
benazepril,Splenic Diseases,1,7188,7187,5,4,414643,11.73869486572979
benazepril,Sprain of ligament,1,7188,7187,8,7,414640,7.336632113538333
benazepril,Stage I Renal Cell Carcinoma,2,7188,7186,19,17,414630,6.178915142015908
benazepril,Stress at work,2,7188,7186,9,7,414640,13.044685654204162
benazepril,Subarachnoid Hemorrhage,1,7188,7187,15,14,414633,3.912805528500533
benazepril,Substance Abuse Problems,7,7188,7181,123,116,414531,3.3421347888454513
benazepril,Substance-induced mood disorder,1,7188,7187,19,18,414629,3.0890277035290326
benazepril,Sudden onset of sleep,4,7188,7184,29,25,414622,8.09857153828431
benazepril,Superficial injury of eye,2,7188,7186,17,15,414632,6.905879078600547
benazepril,Superficial spreading malignant melanoma of skin,12,7188,7176,104,92,414555,6.781113326472859
benazepril,Systemic Scleroderma,1,7188,7187,16,15,414632,3.668246486712119
benazepril,Systemic candidiasis,4,7188,7184,64,60,414587,3.6693607321826285
benazepril,Teratoma,6,7188,7182,30,24,414623,11.746170983013089
benazepril,Terminal state,3,7188,7185,40,37,414610,4.4028705636743215
benazepril,Testicular Hematocele,1,7188,7187,15,14,414633,3.912805528500533
benazepril,Thyroid Neoplasm,4,7188,7184,77,73,414574,3.0497642669134875
benazepril,Thyroid function tests abnormal,8,7188,7180,124,116,414531,3.7892982298499414
benazepril,Tongue erythema,1,7188,7187,5,4,414643,11.73869486572979
benazepril,Tooth Discoloration,1,7188,7187,15,14,414633,3.912805528500533
benazepril,Toxic Epidermal Necrolysis,1,7188,7187,8,7,414640,7.336632113538333
benazepril,Toxic nodular goiter,2,7188,7186,28,26,414621,4.192745815275734
benazepril,Transcatheter mitral valve repair,1,7188,7187,9,8,414639,6.521435307576952
benazepril,Tri-iodothyronine uptake decreased,1,7188,7187,6,5,414642,9.782222531422475
benazepril,Trigeminal Neuralgia,2,7188,7186,24,22,414625,4.89158317098061
benazepril,Trismus,1,7188,7187,14,13,414634,4.192301576258721
benazepril,"Tuberculosis, Bovine",2,7188,7186,32,30,414617,3.668617798497078
benazepril,Typhlitis,4,7188,7184,78,74,414573,3.0106575866598138
benazepril,Ubiquinone decreased,1,7188,7187,10,9,414638,5.869277862807848
benazepril,Ulcer of esophagus,2,7188,7186,11,9,414638,10.672874022720947
benazepril,Ulcer of penis,3,7188,7185,6,3,414644,29.35483646485734
benazepril,Ulnar Nerve Palsy,1,7188,7187,5,4,414643,11.73869486572979
benazepril,Umbilical granuloma,1,7188,7187,6,5,414642,9.782222531422475
benazepril,Underdose (unintentional),5,7188,7183,89,84,414563,3.29856543305276
benazepril,Uremic encephalopathy,2,7188,7186,6,4,414643,19.567167640783005
benazepril,Ureteral obstruction,1,7188,7187,9,8,414639,6.521435307576952
benazepril,Urethral Obstruction,5,7188,7183,20,15,414632,14.681017680634833
benazepril,Urogenital Diseases,177,7188,7011,3361,3184,411463,3.143353809084216
benazepril,Vascular stenosis,4,7188,7184,18,14,414633,13.048038851769363
benazepril,Vascular wall hypertrophy,7,7188,7181,76,69,414578,5.409584136500561
benazepril,Vasospasm,2,7188,7186,5,3,414644,23.48065683273031
benazepril,Venous Insufficiency,1,7188,7187,17,16,414631,3.4524590968988123
benazepril,Very low density lipoprotein decreased,3,7188,7185,13,10,414637,13.548161233338687
benazepril,Very low density lipoprotein increased,1,7188,7187,10,9,414638,5.869277862807848
benazepril,Vesicular eczema of hands and/or feet,2,7188,7186,24,22,414625,4.89158317098061
benazepril,Vitamin B6 decreased,1,7188,7187,8,7,414640,7.336632113538333
benazepril,Vitamin D below reference range,3,7188,7185,57,54,414593,3.0896092004541624
benazepril,Vulvovaginal pain,2,7188,7186,23,21,414626,5.104272800977746
benazepril,Wound infection staphylococcal,6,7188,7182,61,55,414592,5.776380842817425
benazepril,bite injury,60,7188,7128,1079,1019,413628,3.282407017346776
benazepril,congenital renal arteriovenous malformation,2,7188,7186,39,37,414610,3.010097982544406
benazepril,von Willebrand Disease,1,7188,7187,18,17,414630,3.2606480837314287
bisoprolol,ADAMTS13 activity abnormal,15,33976,33961,57,42,387817,3.268284518309702
bisoprolol,Abdominal adhesions,9,33976,33967,18,9,387850,6.209217770188712
bisoprolol,Abdominal discomfort,6,33976,33970,13,7,387852,5.731147392495641
bisoprolol,Abnormal functional residual capacity,4,33976,33972,12,8,387851,4.138928136897053
bisoprolol,Abnormal hair growth,8,33976,33968,23,15,387844,4.319277478547584
bisoprolol,Abnormal weight gain,2,33976,33974,7,5,387854,3.547485892573312
bisoprolol,Abscess of peritoneum,5,33976,33971,12,7,387852,5.173812467496787
bisoprolol,Achromia of skin,6,33976,33970,23,17,387842,3.2392673842648882
bisoprolol,"Acidosis, Respiratory",9,33976,33967,22,13,387846,5.080220909599425
bisoprolol,Acne,3,33976,33973,11,8,387851,3.3863040971038494
bisoprolol,Adenocarcinoma Of Esophagus,6,33976,33970,24,18,387841,3.1042905504857226
bisoprolol,Adenocarcinoma of colon,3,33976,33973,6,3,387856,6.208297765872898
bisoprolol,Adenoidectomy,13,33976,33963,38,25,387834,4.2487110586288175
bisoprolol,Adjustment disorder with depressed mood,2,33976,33974,6,4,387855,4.1387433527599535
bisoprolol,Adjustment disorder with mixed anxiety and depressed mood,9,33976,33967,18,9,387850,6.209217770188712
bisoprolol,Administration of enema,5,33976,33971,10,5,387854,6.20860439786877
bisoprolol,Adnexa uteri mass,7,33976,33969,7,0,387859,12.418028202184345
bisoprolol,Adrenocortical carcinoma,10,33976,33966,10,0,387859,12.419036683742567
bisoprolol,Agitation,2,33976,33974,8,6,387853,3.1040427974333316
bisoprolol,Agranulocytosis,2,33976,33974,8,6,387853,3.1040427974333316
bisoprolol,Alcoholic Liver Diseases,5,33976,33971,5,0,387859,12.417355980100673
bisoprolol,Allergic oedema,3,33976,33973,7,4,387855,5.321385469974055
bisoprolol,Anal sphincter atony,2,33976,33974,5,3,387856,4.966503797021252
bisoprolol,Anastomotic ulcer,17,33976,33959,19,2,387857,11.113823015679898
bisoprolol,Anhedonia,140,33976,33836,522,382,387477,3.339514829022026
bisoprolol,Anosmia,4,33976,33972,13,9,387850,3.8205399922107803
bisoprolol,Anti-cyclic citrullinated peptide antibody negative,10,33976,33966,21,11,387848,5.913672776417874
bisoprolol,Antiphospholipid Syndrome,10,33976,33966,17,7,387852,7.305194467824226
bisoprolol,Antipsychotic drug level below therapeutic,2,33976,33974,7,5,387854,3.547485892573312
bisoprolol,Aortic surgery,4,33976,33972,10,6,387853,4.966737313081362
bisoprolol,Application site pain,11,33976,33965,36,25,387834,3.7945834764545205
bisoprolol,Apraxias,17,33976,33959,39,22,387837,5.414169877552191
bisoprolol,Arterial Injury,13,33976,33963,29,16,387843,5.567395350112242
bisoprolol,Arteriogram coronary abnormal,4,33976,33972,9,5,387854,5.518610097204233
bisoprolol,"Arthritis, Bacterial",2,33976,33974,6,4,387855,4.1387433527599535
bisoprolol,Asocial behavior,18,33976,33958,49,31,387828,4.562747980398356
bisoprolol,Auriculo-Ventricular Dissociation,7,33976,33969,24,17,387842,3.6217789258834037
bisoprolol,Autoimmune necrotizing myopathy,3,33976,33973,12,9,387850,3.104104730226945
bisoprolol,Autoinflammatory Syndrome,6,33976,33970,13,7,387852,5.731147392495641
bisoprolol,Autonomic neuropathy,4,33976,33972,15,11,387848,3.3111189607127436
bisoprolol,Aversion (finding),5,33976,33971,8,3,387856,7.7607922934267455
bisoprolol,B-cell lymphoma stage IV,3,33976,33973,5,2,387857,7.44997498013128
bisoprolol,BK virus infection,9,33976,33967,29,20,387839,3.853896733442094
bisoprolol,Bacterial conjunctivitis,8,33976,33968,29,21,387838,3.425585134893693
bisoprolol,Bacterial genital infection,8,33976,33968,21,13,387846,4.7306596684835025
bisoprolol,Bacterial peritonitis,3,33976,33973,12,9,387850,3.104104730226945
bisoprolol,Bacterial resistance,4,33976,33972,12,8,387851,4.138928136897053
bisoprolol,Balanitis,26,33976,33950,83,57,387802,3.891460510673031
bisoprolol,Benign enlargement of the subarachnoid spaces,5,33976,33971,5,0,387859,12.417355980100673
bisoprolol,Beta globulin above reference range,17,33976,33959,52,35,387824,4.060502257246861
bisoprolol,Bile Duct Stenosis,9,33976,33967,23,14,387845,4.859330219484129
bisoprolol,Biopsy breast abnormal,3,33976,33973,5,2,387857,7.44997498013128
bisoprolol,Bleeding of soft tissue,4,33976,33972,7,3,387856,7.09538948041244
bisoprolol,Blood chromium increased,5,33976,33971,18,13,387846,3.4491592502101467
bisoprolol,Blood cortisol increased,3,33976,33973,8,5,387854,4.656201248049922
bisoprolol,Blood creatinine abnormal,8,33976,33968,17,9,387850,5.843811476545399
bisoprolol,Blood ethanol increased,10,33976,33966,12,2,387857,10.34914816777562
bisoprolol,Blood glucose decreased,9,33976,33967,17,8,387851,6.574481460379364
bisoprolol,Blood magnesium outside reference range,9,33976,33967,18,9,387850,6.209217770188712
bisoprolol,Blood oestrogen increased,30,33976,33946,70,40,387819,5.324822617434412
bisoprolol,Blood potassium decreased,37,33976,33939,143,106,387753,3.2148595680815255
bisoprolol,Bone Cysts,8,33976,33968,24,16,387843,4.13929777045062
bisoprolol,Bone marrow transplant rejection,3,33976,33973,6,3,387856,6.208297765872898
bisoprolol,Bowel preparation,3,33976,33973,11,8,387851,3.3863040971038494
bisoprolol,Brachial radiculitis,5,33976,33971,8,3,387856,7.7607922934267455
bisoprolol,Brain Neoplasms,6,33976,33970,13,7,387852,5.731147392495641
bisoprolol,Brain natriuretic peptide decreased,6,33976,33970,22,16,387843,3.386514839296705
bisoprolol,Bursa calcification,6,33976,33970,11,5,387854,6.7732063050285
bisoprolol,CD30 expression,9,33976,33967,18,9,387850,6.209217770188712
bisoprolol,Cachexia,10,33976,33966,38,28,387831,3.2679506131518514
bisoprolol,Camptocormia,9,33976,33967,9,0,387859,12.4187005034298
bisoprolol,Carbohydrate antigen 125 normal,7,33976,33969,10,3,387856,8.692557920456887
bisoprolol,Carbohydrate intolerance,10,33976,33966,15,5,387854,8.27925965180867
bisoprolol,Carcinoembryonic antigen increased,14,33976,33962,24,10,387849,7.245050841136171
bisoprolol,Carcinoma in Situ,9,33976,33967,36,27,387832,3.104476403568169
bisoprolol,Cardiac Surgery procedures,3,33976,33973,10,7,387852,3.7249433373561356
bisoprolol,Cardiac Tamponade,4,33976,33972,5,1,387858,9.933592370187215
bisoprolol,Cardiac ablation,4,33976,33972,12,8,387851,4.138928136897053
bisoprolol,Cardiomyopathy acute,4,33976,33972,5,1,387858,9.933592370187215
bisoprolol,"Cardiomyopathy, Dilated",3,33976,33973,9,6,387853,4.138835742108929
bisoprolol,Catarrh,3,33976,33973,6,3,387856,6.208297765872898
bisoprolol,Cavitation of lung,8,33976,33968,27,19,387840,3.6793496275361557
bisoprolol,Cellulitis of male external genital organ,6,33976,33970,14,8,387851,5.32176710542916
bisoprolol,Cerebral haematoma,19,33976,33957,36,17,387842,6.555824686777068
bisoprolol,Cerebral ventricle dilatation,4,33976,33972,6,2,387857,8.277974017818595
bisoprolol,Chemical peritonitis,21,33976,33955,84,63,387796,3.105220144308644
bisoprolol,Chest pain on breathing,3,33976,33973,8,5,387854,4.656201248049922
bisoprolol,Cholangitis,6,33976,33970,17,11,387848,4.3826005645119395
bisoprolol,Cholecystitis infective,13,33976,33963,44,31,387828,3.66928917297701
bisoprolol,Choroid Hemorrhage,2,33976,33974,6,4,387855,4.1387433527599535
bisoprolol,Chronic Urticaria,9,33976,33967,24,15,387844,4.65684708687844
bisoprolol,Chronic graft-versus-host disease,3,33976,33973,12,9,387850,3.104104730226945
bisoprolol,Ciliary zonular dehiscence,7,33976,33969,11,4,387855,7.902306648575305
bisoprolol,Colon adenoma,21,33976,33955,84,63,387796,3.105220144308644
bisoprolol,Colonoscopy abnormal,4,33976,33972,8,4,387855,6.208451077357824
bisoprolol,Colour blindness (incl acquired),7,33976,33969,26,19,387840,3.343164695412333
bisoprolol,Compartment syndromes,2,33976,33974,6,4,387855,4.1387433527599535
bisoprolol,Complication of transplanted lung,18,33976,33958,48,30,387829,4.657816273043171
bisoprolol,Compulsive hoarding,9,33976,33967,26,17,387842,4.298607698422225
bisoprolol,Congenital Hypothyroidism,9,33976,33967,9,0,387859,12.4187005034298
bisoprolol,Congenital atresia of aorta,38,33976,33938,125,87,387772,3.7774718604514113
bisoprolol,Congenital choroid plexus cyst,12,33976,33964,15,3,387856,9.935696619950537
bisoprolol,Congenital heart valve incompetence,4,33976,33972,9,5,387854,5.518610097204233
bisoprolol,Congenital renal disorder,10,33976,33966,11,1,387858,11.290006584124232
bisoprolol,Congestion of nasal sinus (disorder),3,33976,33973,6,3,387856,6.208297765872898
bisoprolol,Conjunctival edema,3,33976,33973,5,2,387857,7.44997498013128
bisoprolol,Conjunctival laceration,4,33976,33972,13,9,387850,3.8205399922107803
bisoprolol,Conjunctivitis caused by adenovirus,4,33976,33972,14,10,387849,3.5476358681939746
bisoprolol,Contraindication to vaccination,6,33976,33970,10,4,387855,7.45054459817486
bisoprolol,Contusion of eye,7,33976,33969,11,4,387855,7.902306648575305
bisoprolol,Contusion of eyelid,7,33976,33969,15,8,387851,5.794969923557754
bisoprolol,Coronary bypass thrombosis,10,33976,33966,11,1,387858,11.290006584124232
bisoprolol,Costal chondritis,5,33976,33971,13,8,387851,4.77581557119987
bisoprolol,Cranial third nerve paresis,16,33976,33960,44,28,387831,4.516447157083199
bisoprolol,Craniectomy,19,33976,33957,61,42,387817,3.8687819745029515
bisoprolol,Crystal Arthropathies,3,33976,33973,9,6,387853,4.138835742108929
bisoprolol,Cyst of skin,2,33976,33974,5,3,387856,4.966503797021252
bisoprolol,Cytokine Storm,2,33976,33974,7,5,387854,3.547485892573312
bisoprolol,Cytomegalovirus Colitis,5,33976,33971,5,0,387859,12.417355980100673
bisoprolol,Cytomegalovirus chorioretinitis,4,33976,33972,10,6,387853,4.966737313081362
bisoprolol,Cytomegalovirus enterocolitis,2,33976,33974,7,5,387854,3.547485892573312
bisoprolol,Cytomegalovirus test positive,7,33976,33969,20,13,387846,4.346175925108186
bisoprolol,Decreased circulating IgE,7,33976,33969,7,0,387859,12.418028202184345
bisoprolol,Decreased mean platelet volume,13,33976,33963,16,3,387856,10.091215072284545
bisoprolol,Decreased peak expiratory flow rate,3,33976,33973,6,3,387856,6.208297765872898
bisoprolol,Decreased systolic arterial pressure,5,33976,33971,9,4,387855,6.898465684783426
bisoprolol,"Dementia, Vascular",3,33976,33973,9,6,387853,4.138835742108929
bisoprolol,Dental discomfort,2,33976,33974,7,5,387854,3.547485892573312
bisoprolol,Device extrusion,4,33976,33972,16,12,387847,3.104166666666667
bisoprolol,Device leakage,7,33976,33969,21,14,387845,4.139205353901105
bisoprolol,Device related infection,4,33976,33972,15,11,387848,3.3111189607127436
bisoprolol,Diabetic Ketoacidosis,6,33976,33970,19,13,387846,3.921255597043831
bisoprolol,Diabetic retinal oedema,5,33976,33971,8,3,387856,7.7607922934267455
bisoprolol,Diffuse alveolar damage,9,33976,33967,10,1,387858,11.176803956781582
bisoprolol,Digestive System Fistula,7,33976,33969,14,7,387852,6.2089110659719156
bisoprolol,Disease of mucous membrane,8,33976,33968,29,21,387838,3.425585134893693
bisoprolol,Diseases of inner ear,9,33976,33967,18,9,387850,6.209217770188712
bisoprolol,Dislocation of joint of spine,2,33976,33974,6,4,387855,4.1387433527599535
bisoprolol,Disseminated mycobacterium avium complex infection,7,33976,33969,11,4,387855,7.902306648575305
bisoprolol,Dissociative disorder,32,33976,33944,101,69,387790,3.9364451175261297
bisoprolol,Disturbance in sexual arousal,3,33976,33973,11,8,387851,3.3863040971038494
bisoprolol,Drowning,9,33976,33967,10,1,387858,11.176803956781582
bisoprolol,Drug label confusion,11,33976,33965,39,28,387831,3.5026675272811003
bisoprolol,Dysphemia,4,33976,33972,10,6,387853,4.966737313081362
bisoprolol,Dystrophia unguium,10,33976,33966,10,0,387859,12.419036683742567
bisoprolol,EKG: P wave abnormal,18,33976,33958,50,32,387827,4.471482419459332
bisoprolol,Ear Neoplasms,10,33976,33966,10,0,387859,12.419036683742567
bisoprolol,Ectopic atrial pacemaker,7,33976,33969,7,0,387859,12.418028202184345
bisoprolol,Ectopic pregnancy with contraceptive device,4,33976,33972,12,8,387851,4.138928136897053
bisoprolol,Electrocardiogram,5,33976,33971,5,0,387859,12.417355980100673
bisoprolol,Electrocardiogram repolarisation abnormality,9,33976,33967,35,26,387833,3.1931832997573273
bisoprolol,Electroencephalogram abnormal,3,33976,33973,6,3,387856,6.208297765872898
bisoprolol,Empyema,3,33976,33973,10,7,387852,3.7249433373561356
bisoprolol,Endotracheal intubation complication,15,33976,33961,47,32,387827,3.963758178185616
bisoprolol,Enterobacter sepsis,9,33976,33967,23,14,387845,4.859330219484129
bisoprolol,Enterococcal infection,8,33976,33968,31,23,387836,3.2045644477534836
bisoprolol,Enterocolitis,5,33976,33971,9,4,387855,6.898465684783426
bisoprolol,Enterocolitis bacterial,2,33976,33974,7,5,387854,3.547485892573312
bisoprolol,Eosinophil count (procedure),7,33976,33969,7,0,387859,12.418028202184345
bisoprolol,Eosinophilic pneumonia acute,23,33976,33953,65,42,387817,4.395537722960926
bisoprolol,Erosive Duodenitis,6,33976,33970,15,9,387850,4.966970856638211
bisoprolol,Escherichia bacteraemia,3,33976,33973,7,4,387855,5.321385469974055
bisoprolol,Esophageal motility disorders,28,33976,33948,28,0,387859,12.425091316130553
bisoprolol,Euglycaemic diabetic ketoacidosis,5,33976,33971,8,3,387856,7.7607922934267455
bisoprolol,Exostoses,10,33976,33966,19,9,387850,6.5361956383628215
bisoprolol,Extra dose administered,2,33976,33974,6,4,387855,4.1387433527599535
bisoprolol,Eye Burns,4,33976,33972,8,4,387855,6.208451077357824
bisoprolol,"Eye Infections, Bacterial",17,33976,33959,39,22,387837,5.414169877552191
bisoprolol,Eye inflammation,4,33976,33972,15,11,387848,3.3111189607127436
bisoprolol,Eyeball rupture,13,33976,33963,24,11,387848,6.7273491250282165
bisoprolol,Facial Pain,14,33976,33962,36,22,387837,4.829896485614641
bisoprolol,Facial Paresis,3,33976,33973,12,9,387850,3.104104730226945
bisoprolol,Fear of death,10,33976,33966,26,16,387843,4.776371394018453
bisoprolol,Feeling intoxicated,28,33976,33948,101,73,387786,3.4439836348428057
bisoprolol,Feeling of body temperature change,2,33976,33974,8,6,387853,3.1040427974333316
bisoprolol,Femoral artery embolus,5,33976,33971,20,15,387844,3.1042286067528186
bisoprolol,Fibroid Tumor,5,33976,33971,17,12,387847,3.6520596287144573
bisoprolol,Fibrosis,14,33976,33962,19,5,387854,9.151751648126853
bisoprolol,Fracture of ilium,2,33976,33974,8,6,387853,3.1040427974333316
bisoprolol,Fracture of pelvis,6,33976,33970,19,13,387846,3.921255597043831
bisoprolol,Free thyroxine concentration decreased below normal,3,33976,33973,11,8,387851,3.3863040971038494
bisoprolol,Gastrointestinal angiodysplasia,28,33976,33948,83,55,387804,4.1910505223438825
bisoprolol,Gastrointestinal disorder postoperative,5,33976,33971,19,14,387845,3.2676168062852367
bisoprolol,Gastrointestinal hypomotility,17,33976,33959,56,39,387820,3.7704306243242898
bisoprolol,Gastrointestinal infection,2,33976,33974,7,5,387854,3.547485892573312
bisoprolol,Gastrointestinal inflammation,27,33976,33949,89,62,387797,3.768753593046543
bisoprolol,Gastrointestinal obstruction,7,33976,33969,26,19,387840,3.343164695412333
bisoprolol,Genital swelling,5,33976,33971,17,12,387847,3.6520596287144573
bisoprolol,Gliosis,5,33976,33971,11,6,387853,5.644172435847688
bisoprolol,Granulocytopenic disorder,3,33976,33973,5,2,387857,7.44997498013128
bisoprolol,Granulomatous Cheilitis,6,33976,33970,12,6,387853,6.208757727406535
bisoprolol,Groin infection,8,33976,33968,18,10,387849,5.519142199194013
bisoprolol,Haemorrhagic transformation stroke,4,33976,33972,8,4,387855,6.208451077357824
bisoprolol,"Hallucinations, Olfactory",5,33976,33971,10,5,387854,6.20860439786877
bisoprolol,Heart Diseases,4,33976,33972,15,11,387848,3.3111189607127436
bisoprolol,Helicobacter Infections,15,33976,33961,59,44,387815,3.1574802402955733
bisoprolol,"Hematoma, Subdural, Spinal",6,33976,33970,12,6,387853,6.208757727406535
bisoprolol,Hemoptysis,92,33976,33884,378,286,387573,3.0272941795194184
bisoprolol,Hemorrhagic cerebral infarction,6,33976,33970,14,8,387851,5.32176710542916
bisoprolol,Hepatectomy,2,33976,33974,7,5,387854,3.547485892573312
bisoprolol,Hepatitis C,3,33976,33973,12,9,387850,3.104104730226945
bisoprolol,Hoigne's syndrome,6,33976,33970,18,12,387847,4.13911294279266
bisoprolol,Hyperacusis,2,33976,33974,7,5,387854,3.547485892573312
bisoprolol,Hyperesthesia,13,33976,33963,42,29,387830,3.8440354559513645
bisoprolol,Hyperlipasaemia,2,33976,33974,6,4,387855,4.1387433527599535
bisoprolol,Hyperprolactinemia,3,33976,33973,10,7,387852,3.7249433373561356
bisoprolol,Hypogeusia,12,33976,33964,21,9,387850,7.096825209886097
bisoprolol,Hypoglycemic shock,4,33976,33972,11,7,387852,4.515205035162648
bisoprolol,Hypophosphatemia,8,33976,33968,20,12,387847,4.967204427696656
bisoprolol,Ichthyoses,7,33976,33969,16,9,387850,5.432771423945362
bisoprolol,Immunosuppressant drug level increased,5,33976,33971,16,11,387848,3.8803225545318067
bisoprolol,Inadequate food diet,3,33976,33973,7,4,387855,5.321385469974055
bisoprolol,Incision site erythema,10,33976,33966,35,25,387834,3.5480859010270773
bisoprolol,Incorrect route of product administration,3,33976,33973,5,2,387857,7.44997498013128
bisoprolol,Increased capillary permeability,5,33976,33971,8,3,387856,7.7607922934267455
bisoprolol,Increased susceptibility to infections,2,33976,33974,5,3,387856,4.966503797021252
bisoprolol,Infantile hemangioma,9,33976,33967,9,0,387859,12.4187005034298
bisoprolol,Infected dermatitis,2,33976,33974,6,4,387855,4.1387433527599535
bisoprolol,Infective Phlebitis,8,33976,33968,15,7,387852,6.623017742188726
bisoprolol,Infusion Site Extravasation,20,33976,33956,72,52,387807,3.4502411617648985
bisoprolol,Injected limb mobility decreased,7,33976,33969,27,20,387839,3.2193361485363017
bisoprolol,Injection related reaction,5,33976,33971,16,11,387848,3.8803225545318067
bisoprolol,Injection site dryness,8,33976,33968,28,20,387839,3.547935872417738
bisoprolol,Injury of anus,8,33976,33968,30,22,387837,3.311391113204585
bisoprolol,Injury of retina,45,33976,33931,110,65,387794,5.084549928866336
bisoprolol,Insertion of arterial stent,9,33976,33967,9,0,387859,12.4187005034298
bisoprolol,Insertion of pleural tube drain,6,33976,33970,6,0,387859,12.41769208124816
bisoprolol,Instillation site discomfort,13,33976,33963,40,27,387832,4.036256367223155
bisoprolol,Instillation site lacrimation,5,33976,33971,5,0,387859,12.417355980100673
bisoprolol,Intestinal gangrene,2,33976,33974,8,6,387853,3.1040427974333316
bisoprolol,Intestinal mucosal hypertrophy,15,33976,33961,23,8,387851,8.100314555186705
bisoprolol,Intestinal resection,2,33976,33974,8,6,387853,3.1040427974333316
bisoprolol,Intraocular pressure test,4,33976,33972,10,6,387853,4.966737313081362
bisoprolol,Ischemic maculopathy,8,33976,33968,8,0,387859,12.418364342910975
bisoprolol,Isosthenuria,8,33976,33968,14,6,387853,7.096107260615032
bisoprolol,Labelled drug-drug interaction medication error,6,33976,33970,20,14,387845,3.725183985869885
bisoprolol,Lack of injection site rotation,10,33976,33966,20,10,387849,6.209371135841724
bisoprolol,Lacrimal haemorrhage,18,33976,33958,43,25,387834,5.199484452065959
bisoprolol,Language Disorders,2,33976,33974,6,4,387855,4.1387433527599535
bisoprolol,Large intestine erosion,6,33976,33970,22,16,387843,3.386514839296705
bisoprolol,Laryngeal cleft,6,33976,33970,8,2,387857,9.313224904327347
bisoprolol,Laryngospasm,11,33976,33965,29,18,387841,4.710595592826287
bisoprolol,Leiomyosarcoma of uterus,20,33976,33956,73,53,387806,3.4029695157472117
bisoprolol,Lichen Sclerosus et Atrophicus,4,33976,33972,6,2,387857,8.277974017818595
bisoprolol,Lip haemorrhage,2,33976,33974,7,5,387854,3.547485892573312
bisoprolol,Lipiduria,4,33976,33972,7,3,387856,7.09538948041244
bisoprolol,Liver carcinoma,17,33976,33959,68,51,387808,3.104972172325451
bisoprolol,Liver palpable,3,33976,33973,8,5,387854,4.656201248049922
bisoprolol,Lower respiratory tract infection,7,33976,33969,16,9,387850,5.432771423945362
bisoprolol,Lung consolidation,18,33976,33958,51,33,387826,4.383795900125762
bisoprolol,Lymphangiosis carcinomatosa,7,33976,33969,9,2,387857,9.658420586089932
bisoprolol,Lymphoma transformation,2,33976,33974,6,4,387855,4.1387433527599535
bisoprolol,Lysis of adhesions of tendon,69,33976,33907,257,188,387671,3.338139949982207
bisoprolol,Malignant neoplasm of breast,7,33976,33969,24,17,387842,3.6217789258834037
bisoprolol,Malignant neoplasm of ovary,4,33976,33972,14,10,387849,3.5476358681939746
bisoprolol,Malignant tumor of parathyroid gland,2,33976,33974,7,5,387854,3.547485892573312
bisoprolol,Manufacturing materials contamination,2,33976,33974,5,3,387856,4.966503797021252
bisoprolol,Marasmus,4,33976,33972,7,3,387856,7.09538948041244
bisoprolol,Mass in breast,4,33976,33972,16,12,387847,3.104166666666667
bisoprolol,Mass of pancreas,12,33976,33964,44,32,387827,3.3869364353700706
bisoprolol,"Mastocytosis, Systemic",4,33976,33972,6,2,387857,8.277974017818595
bisoprolol,Mean corpuscular volume above reference range,5,33976,33971,10,5,387854,6.20860439786877
bisoprolol,Mediastinal Emphysema,6,33976,33970,21,15,387844,3.54778586147441
bisoprolol,Meibomianitis,5,33976,33971,10,5,387854,6.20860439786877
bisoprolol,Melanocytic hyperplasia,6,33976,33970,16,10,387849,4.656524138946129
bisoprolol,Meningitis,11,33976,33965,34,23,387836,4.0178133199400765
bisoprolol,Meningitis herpes,30,33976,33946,53,23,387836,7.033068058147846
bisoprolol,Meniscus operation,4,33976,33972,15,11,387848,3.3111189607127436
bisoprolol,Merycism,8,33976,33968,14,6,387853,7.096107260615032
bisoprolol,Mesenteric Venous Thrombosis,4,33976,33972,12,8,387851,4.138928136897053
bisoprolol,Metastatic malignant neoplasm to adrenal gland,4,33976,33972,10,6,387853,4.966737313081362
bisoprolol,Metastatic malignant neoplasm to kidney,7,33976,33969,15,8,387851,5.794969923557754
bisoprolol,Metastatic malignant neoplasm to mediastinum,4,33976,33972,9,5,387854,5.518610097204233
bisoprolol,Mitral valve sclerosis,2,33976,33974,8,6,387853,3.1040427974333316
bisoprolol,Mononucleosis syndrome,4,33976,33972,7,3,387856,7.09538948041244
bisoprolol,Motion Sickness,6,33976,33970,20,14,387845,3.725183985869885
bisoprolol,Mucinous adenocarcinoma of appendix,6,33976,33970,7,1,387858,10.64371083729341
bisoprolol,Mucosal ulcer,77,33976,33899,206,129,387730,4.649080778795491
bisoprolol,Multiple use of single-use product,4,33976,33972,5,1,387858,9.933592370187215
bisoprolol,"Myasthenia Gravis, Ocular",5,33976,33971,6,1,387858,10.347772119356707
bisoprolol,Myocardial rupture,3,33976,33973,11,8,387851,3.3863040971038494
bisoprolol,Near Drowning,11,33976,33965,26,15,387844,5.254163222321621
bisoprolol,Necrosis of gastrointestinal tract,98,33976,33878,398,300,387559,3.0630769112105187
bisoprolol,Neoplasm of chest wall,12,33976,33964,14,2,387857,10.645414472466646
bisoprolol,Nerve Root Compression,5,33976,33971,14,9,387850,4.434675374373941
bisoprolol,Neutropenic infection,15,33976,33961,18,3,387856,10.350524621379426
bisoprolol,Nightmares,4,33976,33972,6,2,387857,8.277974017818595
bisoprolol,Nikolsky sign,4,33976,33972,14,10,387849,3.5476358681939746
bisoprolol,Non-Infectious Cystitis,3,33976,33973,11,8,387851,3.3863040971038494
bisoprolol,Normocytic normochromic anemia,5,33976,33971,11,6,387853,5.644172435847688
bisoprolol,Occult blood screen,9,33976,33967,17,8,387851,6.574481460379364
bisoprolol,Occupational exposure to product,4,33976,33972,8,4,387855,6.208451077357824
bisoprolol,Ocular icterus,6,33976,33970,15,9,387850,4.966970856638211
bisoprolol,Onychoclasis,8,33976,33968,14,6,387853,7.096107260615032
bisoprolol,Operation on neck,4,33976,33972,15,11,387848,3.3111189607127436
bisoprolol,Ophthalmoplegia,9,33976,33967,17,8,387851,6.574481460379364
bisoprolol,Optic Nerve Glioma,3,33976,33973,8,5,387854,4.656201248049922
bisoprolol,Oral discharge,8,33976,33968,30,22,387837,3.311391113204585
bisoprolol,Oropharyngeal swelling,4,33976,33972,5,1,387858,9.933592370187215
bisoprolol,Orthosis user,3,33976,33973,5,2,387857,7.44997498013128
bisoprolol,"Osteoporosis, Postmenopausal",2,33976,33974,8,6,387853,3.1040427974333316
bisoprolol,PCO2 increased,6,33976,33970,9,3,387856,8.27840251202041
bisoprolol,Pain in testicle,17,33976,33959,56,39,387820,3.7704306243242898
bisoprolol,Pain of lymph node,2,33976,33974,7,5,387854,3.547485892573312
bisoprolol,Pancreatic carcinoma stage III,3,33976,33973,6,3,387856,6.208297765872898
bisoprolol,Paranoid Schizophrenia,8,33976,33968,16,8,387851,6.209064413565709
bisoprolol,Paronychia (disorder),7,33976,33969,12,5,387854,7.243763922007321
bisoprolol,Pelvic abscess,2,33976,33974,6,4,387855,4.1387433527599535
bisoprolol,Pelvic haemorrhage,32,33976,33944,93,61,387798,4.275145147352123
bisoprolol,Percutaneous Coronary Intervention,2,33976,33974,6,4,387855,4.1387433527599535
bisoprolol,Pericardial effusion,14,33976,33962,55,41,387818,3.1612443854361287
bisoprolol,Perinatal intraventricular hemorrhage,8,33976,33968,30,22,387837,3.311391113204585
bisoprolol,Peripheral demyelinating neuropathy,5,33976,33971,11,6,387853,5.644172435847688
bisoprolol,Peripheral motor neuropathy,2,33976,33974,5,3,387856,4.966503797021252
bisoprolol,Phagophobia,3,33976,33973,5,2,387857,7.44997498013128
bisoprolol,Photopsia,4,33976,33972,9,5,387854,5.518610097204233
bisoprolol,Pica (disorder),5,33976,33971,5,0,387859,12.417355980100673
bisoprolol,Pigmentation of eyelids,34,33976,33942,127,93,387766,3.3262095552533575
bisoprolol,Plasmablastic lymphoma,6,33976,33970,8,2,387857,9.313224904327347
bisoprolol,Plasmacytoma,12,33976,33964,41,29,387830,3.634786904929466
bisoprolol,Pneumocephalus,12,33976,33964,23,11,387848,6.479679251176437
bisoprolol,Poisoning by parasympathomimetic drug,55,33976,33921,184,129,387730,3.715603422530355
bisoprolol,Polymyositis,2,33976,33974,7,5,387854,3.547485892573312
bisoprolol,Polyomavirus-associated nephropathy,7,33976,33969,11,4,387855,7.902306648575305
bisoprolol,Poor weight gain neonatal,9,33976,33967,33,24,387835,3.386725618715491
bisoprolol,Positron emission tomogram abnormal,7,33976,33969,9,2,387857,9.658420586089932
bisoprolol,Post procedural inflammation,4,33976,33972,7,3,387856,7.09538948041244
bisoprolol,Postoperative confusion,4,33976,33972,14,10,387849,3.5476358681939746
bisoprolol,Postpartum Hemorrhage,9,33976,33967,36,27,387832,3.104476403568169
bisoprolol,Precancerous skin lesion,2,33976,33974,6,4,387855,4.1387433527599535
bisoprolol,Pregnancy,13,33976,33963,53,40,387819,3.0461373336911035
bisoprolol,Pregnancy associated hypertension,16,33976,33960,52,36,387823,3.8215366494518443
bisoprolol,Pregnancy on oral contraceptive,2,33976,33974,6,4,387855,4.1387433527599535
bisoprolol,Product closure issue,2,33976,33974,7,5,387854,3.547485892573312
bisoprolol,Product dispensing error,3,33976,33973,6,3,387856,6.208297765872898
bisoprolol,Prophylactic treatment,7,33976,33969,9,2,387857,9.658420586089932
bisoprolol,Prostatectomy,2,33976,33974,6,4,387855,4.1387433527599535
bisoprolol,Prothrombin consumption time shortened,25,33976,33951,56,31,387828,5.546057448339414
bisoprolol,Prothrombin time ratio decreased,5,33976,33971,14,9,387850,4.434675374373941
bisoprolol,Psoriasiform eczema,9,33976,33967,12,3,387856,9.313959136809256
bisoprolol,Pulmonary Infarction,24,33976,33952,99,75,387784,3.0112815240053696
bisoprolol,Pyeloplasty,2,33976,33974,7,5,387854,3.547485892573312
bisoprolol,Pyoderma Gangrenosum,9,33976,33967,13,4,387855,8.597480359896823
bisoprolol,Quadriplegia,4,33976,33972,5,1,387858,9.933592370187215
bisoprolol,Rapid correction of hyponatraemia,12,33976,33964,19,7,387852,7.843896633587265
bisoprolol,Reactive hypoglycemia,6,33976,33970,6,0,387859,12.41769208124816
bisoprolol,Recurrent Unspecified Lung Carcinoma,9,33976,33967,26,17,387842,4.298607698422225
bisoprolol,Reduced mobility,17,33976,33959,70,53,387806,3.016244378725606
bisoprolol,"Reflex, Abnormal",19,33976,33957,29,10,387849,8.13840018766127
bisoprolol,Reflux nephropathy (disorder),4,33976,33972,9,5,387854,5.518610097204233
bisoprolol,Refusal of Treatment,3,33976,33973,10,7,387852,3.7249433373561356
bisoprolol,Renal cancer recurrent,3,33976,33973,10,7,387852,3.7249433373561356
bisoprolol,Renal glomerular disease,2,33976,33974,7,5,387854,3.547485892573312
bisoprolol,Retinal depigmentation,9,33976,33967,17,8,387851,6.574481460379364
bisoprolol,Retinal exudates,3,33976,33973,10,7,387852,3.7249433373561356
bisoprolol,Rhinorrhea,221,33976,33755,903,682,387177,3.051956602795238
bisoprolol,Right Ventricular Hypertrophy,8,33976,33968,19,11,387848,5.228648635248035
bisoprolol,Ruptured cyst of kidney,2,33976,33974,5,3,387856,4.966503797021252
bisoprolol,Sacral radiculopathy,4,33976,33972,7,3,387856,7.09538948041244
bisoprolol,Salivary gland cancer stage IV,12,33976,33964,12,0,387859,12.419709103756919
bisoprolol,Salivary gland operation,9,33976,33967,16,7,387852,6.985403111843849
bisoprolol,Salmonella food poisoning,14,33976,33962,36,22,387837,4.829896485614641
bisoprolol,Scarred macula,4,33976,33972,13,9,387850,3.8205399922107803
bisoprolol,Schnitzler Syndrome,2,33976,33974,6,4,387855,4.1387433527599535
bisoprolol,Sciatic Neuropathy,4,33976,33972,14,10,387849,3.5476358681939746
bisoprolol,Secondary hypoparathyroidism,3,33976,33973,8,5,387854,4.656201248049922
bisoprolol,Seizure like phenomena,3,33976,33973,7,4,387855,5.321385469974055
bisoprolol,Selenium deficiency,8,33976,33968,27,19,387840,3.6793496275361557
bisoprolol,Septic embolus,3,33976,33973,7,4,387855,5.321385469974055
bisoprolol,Short Bowel Syndrome,13,33976,33963,23,10,387849,7.019859207398332
bisoprolol,Single umbilical artery,9,33976,33967,9,0,387859,12.4187005034298
bisoprolol,Sirenomelia,6,33976,33970,14,8,387851,5.32176710542916
bisoprolol,Skin Erosion,7,33976,33969,16,9,387850,5.432771423945362
bisoprolol,Skin necrosis,9,33976,33967,18,9,387850,6.209217770188712
bisoprolol,Soliloquy,6,33976,33970,12,6,387853,6.208757727406535
bisoprolol,Spinal Cord Ischemia,4,33976,33972,14,10,387849,3.5476358681939746
bisoprolol,Spinal Stenosis,13,33976,33963,13,0,387859,12.420045343462004
bisoprolol,Spinal cord infection,24,33976,33952,25,1,387858,11.926767200754007
bisoprolol,Splenic cyst,7,33976,33969,20,13,387846,4.346175925108186
bisoprolol,Spondylarthropathies,2,33976,33974,5,3,387856,4.966503797021252
bisoprolol,Squamous cell carcinoma of pharynx,4,33976,33972,14,10,387849,3.5476358681939746
bisoprolol,Stenotrophomonas test positive,2,33976,33974,6,4,387855,4.1387433527599535
bisoprolol,Stoma site haemorrhage,6,33976,33970,14,8,387851,5.32176710542916
bisoprolol,Stomatitis,55,33976,33921,175,120,387739,3.9067749855757286
bisoprolol,Strangulated hernia,7,33976,33969,7,0,387859,12.418028202184345
bisoprolol,Substance-induced psychotic disorder,3,33976,33973,12,9,387850,3.104104730226945
bisoprolol,Suspected COVID-19,8,33976,33968,8,0,387859,12.418364342910975
bisoprolol,Suspected drug-induced liver injury,6,33976,33970,21,15,387844,3.54778586147441
bisoprolol,Suture insertion,4,33976,33972,8,4,387855,6.208451077357824
bisoprolol,Swelling of scrotum,12,33976,33964,25,13,387846,5.961276645860322
bisoprolol,Swelling of skeletal muscle,7,33976,33969,27,20,387839,3.2193361485363017
bisoprolol,Syringomyelia,14,33976,33962,31,17,387842,5.608978535782877
bisoprolol,Systolic blood pressure measurement,7,33976,33969,8,1,387858,10.865748918131237
bisoprolol,Temperature regulation disorder,8,33976,33968,21,13,387846,4.7306596684835025
bisoprolol,Termination of pregnancy (procedure),11,33976,33965,39,28,387831,3.5026675272811003
bisoprolol,Therapy cessation,39,33976,33937,125,86,387773,3.8769932522026105
bisoprolol,Tobacco Use Disorder,8,33976,33968,30,22,387837,3.311391113204585
bisoprolol,Tonsillitis,4,33976,33972,7,3,387856,7.09538948041244
bisoprolol,Tooth Discoloration,5,33976,33971,15,10,387849,4.139020537124803
bisoprolol,Total protein measurement,5,33976,33971,8,3,387856,7.7607922934267455
bisoprolol,Toxoplasma myocarditis,5,33976,33971,10,5,387854,6.20860439786877
bisoprolol,Transcatheter mitral valve repair,3,33976,33973,9,6,387853,4.138835742108929
bisoprolol,Traumatic fracture,16,33976,33960,58,42,387817,3.4261565330409
bisoprolol,Traumatic injury,17,33976,33959,26,9,387850,8.121505118162853
bisoprolol,Traumatic injury of visual pathways,2,33976,33974,6,4,387855,4.1387433527599535
bisoprolol,Tumour lysis syndrome (SMQ),80,33976,33896,176,96,387763,5.65444836612526
bisoprolol,Ulcer,68,33976,33908,170,102,387757,4.974224371829657
bisoprolol,Ulcer on tongue,2,33976,33974,5,3,387856,4.966503797021252
bisoprolol,Ulceration of breast,4,33976,33972,6,2,387857,8.277974017818595
bisoprolol,Ulceration of gingivae,275,33976,33701,1062,787,387072,3.2330561980451664
bisoprolol,Umbilical erythema,6,33976,33970,8,2,387857,9.313224904327347
bisoprolol,Urine ketone body present,2,33976,33974,5,3,387856,4.966503797021252
bisoprolol,Urine potassium abnormal,3,33976,33973,6,3,387856,6.208297765872898
bisoprolol,Urine screening abnormal,16,33976,33960,52,36,387823,3.8215366494518443
bisoprolol,Vaccination site swelling,21,33976,33955,76,55,387804,3.432150524300739
bisoprolol,Vascular graft complication,4,33976,33972,9,5,387854,5.518610097204233
bisoprolol,"Ventricular Dysfunction, Left",8,33976,33968,23,15,387844,4.319277478547584
bisoprolol,Vessel puncture site haematoma,11,33976,33965,17,6,387853,8.035950502680095
bisoprolol,Viral bronchitis,11,33976,33965,11,0,387859,12.419372883851022
bisoprolol,Visual acuity reduced transiently,10,33976,33966,30,20,387839,4.1394826198747765
bisoprolol,Visual field defects,7,33976,33969,28,21,387838,3.1043524978657007
bisoprolol,Vitrectomy,10,33976,33966,29,19,387840,4.282233552010428
bisoprolol,"Waterhouse-Friderichsen Syndrome, Meningococcal",3,33976,33973,5,2,387857,7.44997498013128
bisoprolol,Withdrawal of life support,4,33976,33972,16,12,387847,3.104166666666667
bisoprolol,Wolff-Parkinson-White Syndrome,6,33976,33970,10,4,387855,7.45054459817486
bisoprolol,Wound healing normal,9,33976,33967,36,27,387832,3.104476403568169
bisoprolol,Wound infection bacterial,13,33976,33963,44,31,387828,3.66928917297701
bisoprolol,Wound inflammation,10,33976,33966,13,3,387856,9.553037200096023
bisoprolol,anaphylaxis,51,33976,33925,168,117,387742,3.7732071797031264
bisoprolol,effusion,2,33976,33974,5,3,387856,4.966503797021252
bisoprolol,von Willebrand Disease,13,33976,33963,18,5,387854,8.969926423199103
candesartan,"Abdomen, Acute",1,3951,3950,23,22,417862,4.64294991744634
candesartan,Abnormal glomerular filtration rate,1,3951,3950,30,29,417855,3.559535864978903
candesartan,Abnormal nail growth,1,3951,3950,11,10,417874,9.70826237054085
candesartan,Abnormal systolic arterial pressure,1,3951,3950,16,15,417869,6.674351265822785
candesartan,Abscess of limb,1,3951,3950,24,23,417861,4.449483122362869
candesartan,Abscess of pharynx,1,3951,3950,20,19,417865,5.339430379746836
candesartan,Abscess of tongue,2,3951,3949,69,67,417817,3.0957461254179193
candesartan,Achromia of skin,1,3951,3950,23,22,417862,4.64294991744634
candesartan,"Acidosis, Respiratory",1,3951,3950,22,21,417863,4.854004602991945
candesartan,Acute Cholecystitis,9,3951,3942,31,22,417862,31.065252614523494
candesartan,Acute tonsillitis,5,3951,3946,117,112,417772,4.567191270181641
candesartan,Adams-Stokes Syndrome,1,3951,3950,25,24,417860,4.271493670886076
candesartan,Addisonian crisis,4,3951,3947,37,33,417851,11.553023507419251
candesartan,Adenoidectomy,2,3951,3949,38,36,417848,5.621636390292013
candesartan,Adrenal Cortical Adenoma,1,3951,3950,35,34,417850,3.050994575045208
candesartan,Allergy to dust,1,3951,3950,6,5,417879,17.79869198312236
candesartan,Altered visual depth perception,4,3951,3947,91,87,417797,4.696781809525666
candesartan,Amenorrhea,3,3951,3948,25,22,417862,12.8209726443769
candesartan,Ammonia increased,1,3951,3950,10,9,417875,10.679113924050634
candesartan,"Anemia, Hemolytic",2,3951,3949,25,23,417861,8.545150671055962
candesartan,Angina Pectoris,3,3951,3948,98,95,417789,3.2700902549469633
candesartan,Anorectal cellulitis,2,3951,3949,32,30,417854,6.6757881742213225
candesartan,Antisocial behavior,1,3951,3950,8,7,417877,13.348955696202532
candesartan,Aortic valve sclerosis,2,3951,3949,53,51,417833,4.030463886247772
candesartan,Application site bruise,3,3951,3948,44,41,417843,7.284315418623929
candesartan,Application site papules,1,3951,3950,7,6,417878,15.255985533453888
candesartan,Arnold Chiari Malformation,1,3951,3950,17,16,417868,6.281727475800446
candesartan,Arrested labor,2,3951,3949,23,21,417863,9.288251290915698
candesartan,Arterial Injury,1,3951,3950,29,28,417856,3.6822872108249673
candesartan,Arteriovenous fistula,5,3951,3946,58,53,417831,9.214416170019401
candesartan,Arthropod bite,2,3951,3949,48,46,417838,4.450356630370558
candesartan,Ascites,3,3951,3948,101,98,417786,3.172936290589545
candesartan,Atrial Flutter,3,3951,3948,34,31,417853,9.42698462363669
candesartan,Atrophic endometrium,2,3951,3949,32,30,417854,6.6757881742213225
candesartan,Atrophy of pancreas,2,3951,3949,54,52,417832,3.95581628729261
candesartan,Aura,3,3951,3948,18,15,417869,17.8072019587977
candesartan,Auriculo-Ventricular Dissociation,1,3951,3950,24,23,417861,4.449483122362869
candesartan,BK virus infection,3,3951,3948,29,26,417858,11.052457813646368
candesartan,Back disorder,1,3951,3950,6,5,417879,17.79869198312236
candesartan,Bacterial sepsis,9,3951,3942,15,6,417878,64.20395738203956
candesartan,Band sensation,3,3951,3948,27,24,417860,11.871214679725316
candesartan,Bilateral Deafness,1,3951,3950,13,12,417872,8.21464459591042
candesartan,Biliary Colic,2,3951,3949,59,57,417827,3.620534698765188
candesartan,Bleeding esophageal varices,1,3951,3950,8,7,417877,13.348955696202532
candesartan,Blepharitis,2,3951,3949,58,56,417828,3.6829664428358115
candesartan,Blepharoptosis,6,3951,3945,199,193,417691,3.2224697632649937
candesartan,Blood chloride decreased,2,3951,3949,11,9,417875,19.421441561730244
candesartan,Blood cholesterol abnormal,3,3951,3948,37,34,417850,8.66257290725376
candesartan,Blood chromium increased,2,3951,3949,18,16,417868,11.868461776539771
candesartan,Blood glucose decreased,1,3951,3950,17,16,417868,6.281727475800446
candesartan,Blood glucose fluctuation,1,3951,3950,16,15,417869,6.674351265822785
candesartan,Blood oestrogen increased,8,3951,3943,70,62,417822,12.224629542407882
candesartan,Blood parathyroid hormone increased,3,3951,3948,57,54,417830,5.622807017543859
candesartan,Blood triglycerides abnormal,7,3951,3944,88,81,417803,8.506099598930481
candesartan,Body Dysmorphic Disorders,2,3951,3949,70,68,417816,3.0515139456643636
candesartan,Bone Cysts,4,3951,3947,24,20,417864,17.811460180727977
candesartan,Bone marrow oedema syndrome,1,3951,3950,16,15,417869,6.674351265822785
candesartan,Bowel preparation,2,3951,3949,11,9,417875,19.421441561730244
candesartan,Brain Concussion,8,3951,3943,163,155,417729,5.248683307686682
candesartan,Brain natriuretic peptide decreased,1,3951,3950,22,21,417863,4.854004602991945
candesartan,Breakthrough Pain,5,3951,3946,82,77,417807,6.517143016082974
candesartan,Breast Diseases,3,3951,3948,97,94,417790,3.303810359414659
candesartan,Brugada Syndrome (disorder),3,3951,3948,25,22,417862,12.8209726443769
candesartan,Buccal mucosal roughening,3,3951,3948,24,21,417863,13.355211499493414
candesartan,Bundle-Branch Block,1,3951,3950,23,22,417862,4.64294991744634
candesartan,Burning Mouth Syndrome,1,3951,3950,25,24,417860,4.271493670886076
candesartan,Bursectomy,1,3951,3950,5,4,417880,21.35848101265823
candesartan,Cancer antigen 125 above reference range,1,3951,3950,19,18,417866,5.620466355762825
candesartan,Carcinoma in situ of rectum,3,3951,3948,95,92,417792,3.3733802591585342
candesartan,Cardiac Death,1,3951,3950,5,4,417880,21.35848101265823
candesartan,Cardiac ventricular thrombosis,2,3951,3949,6,4,417880,35.60639824428125
candesartan,"Cardiomyopathy, Dilated",1,3951,3950,9,8,417876,11.865710267229254
candesartan,Cataract operation complication,1,3951,3950,12,11,417873,8.8992194092827
candesartan,Catatonia,4,3951,3947,100,96,417788,4.273980238155561
candesartan,Catheter site infection,5,3951,3946,131,126,417758,4.0789590773147415
candesartan,Central cyanosis,7,3951,3944,17,10,417874,44.03898699439207
candesartan,Cerebral Hemorrhage,2,3951,3949,63,61,417823,3.390627323774956
candesartan,Cerebral circulatory failure,2,3951,3949,22,20,417864,9.710467552199637
candesartan,Cerebral disorder,1,3951,3950,9,8,417876,11.865710267229254
candesartan,Cervico-occipital neuralgia,1,3951,3950,8,7,417877,13.348955696202532
candesartan,Chest pain on breathing,2,3951,3949,8,6,417878,26.7046720688782
candesartan,"Cholangitis, Sclerosing",1,3951,3950,8,7,417877,13.348955696202532
candesartan,Chronic rejection of renal transplant,2,3951,3949,53,51,417833,4.030463886247772
candesartan,Clostridium difficile sepsis,3,3951,3948,51,48,417836,6.284403122951308
candesartan,Coagulation factor V level abnormal,7,3951,3944,13,6,417878,57.58999063816508
candesartan,Cognitive function: distractibility,3,3951,3948,46,43,417841,6.9675730144046515
candesartan,Cold sweat,9,3951,3942,305,296,417588,3.1554008533572877
candesartan,Collagen-vascular disease,1,3951,3950,7,6,417878,15.255985533453888
candesartan,Colon cancer recurrent,1,3951,3950,25,24,417860,4.271493670886076
candesartan,Colonic Pseudo-Obstruction,1,3951,3950,15,14,417870,7.119324894514768
candesartan,Comatose,1,3951,3950,5,4,417880,21.35848101265823
candesartan,Complete atrioventricular block,6,3951,3945,18,12,417872,35.641487114490914
candesartan,Complication of transplanted lung,3,3951,3948,48,45,417839,6.677225810536981
candesartan,Compression fracture,1,3951,3950,17,16,417868,6.281727475800446
candesartan,Compression of brain,1,3951,3950,13,12,417872,8.21464459591042
candesartan,Computerised tomogram thorax abnormal,3,3951,3948,22,19,417865,14.56939071566731
candesartan,Congenital atresia of aorta,4,3951,3947,125,121,417763,3.418981504940461
candesartan,Congenital renal disorder,1,3951,3950,11,10,417874,9.70826237054085
candesartan,Congenital tricuspid valve incompetence,2,3951,3949,19,17,417867,11.243779237914994
candesartan,Continuous hemodiafiltration,1,3951,3950,7,6,417878,15.255985533453888
candesartan,Contraindicated drug administered,1,3951,3950,5,4,417880,21.35848101265823
candesartan,Contusion of eye,1,3951,3950,11,10,417874,9.70826237054085
candesartan,Corneal Abrasions,1,3951,3950,5,4,417880,21.35848101265823
candesartan,Coronary Stenosis,5,3951,3946,161,156,417728,3.318668484163537
candesartan,Cortical cataract,5,3951,3946,108,103,417781,4.947896134857615
candesartan,Creation of ileostomy,5,3951,3946,174,169,417715,3.0706273193864297
candesartan,Crushing injury of face,1,3951,3950,21,20,417864,5.085159734779988
candesartan,Decreased CD4:CD8 ratio,1,3951,3950,8,7,417877,13.348955696202532
candesartan,Decreased peak expiratory flow rate,1,3951,3950,6,5,417879,17.79869198312236
candesartan,Depressed Level of Consciousness,2,3951,3949,52,50,417834,4.107982546701209
candesartan,Dermabrasion,1,3951,3950,34,33,417851,3.1407371556217423
candesartan,Device battery issue,1,3951,3950,8,7,417877,13.348955696202532
candesartan,Device component issue,1,3951,3950,23,22,417862,4.64294991744634
candesartan,Diabetic ketoacidotic hyperglycaemic coma,1,3951,3950,14,13,417871,7.627866184448462
candesartan,Diabetic retinal oedema,1,3951,3950,8,7,417877,13.348955696202532
candesartan,Diffuse Large B-Cell Lymphoma,2,3951,3949,58,56,417828,3.6829664428358115
candesartan,Discharge from eye,1,3951,3950,24,23,417861,4.449483122362869
candesartan,Discomfort in mouth,1,3951,3950,25,24,417860,4.271493670886076
candesartan,Disorder of ligament,3,3951,3948,93,90,417794,3.4459424126548357
candesartan,Disorientation,13,3951,3938,306,293,417591,4.547510099350388
candesartan,Dissociative disorder,3,3951,3948,101,98,417786,3.172936290589545
candesartan,Double stranded DNA antibody positive,1,3951,3950,5,4,417880,21.35848101265823
candesartan,Drooling,1,3951,3950,34,33,417851,3.1407371556217423
candesartan,Drug Overdose,6,3951,3945,72,66,417818,8.909231094212082
candesartan,Drug administered at inappropriate site,1,3951,3950,32,31,417853,3.337049050632911
candesartan,Drug effect incomplete,1,3951,3950,34,33,417851,3.1407371556217423
candesartan,Dry tongue,3,3951,3948,27,24,417860,11.871214679725316
candesartan,Dysbacteriosis,1,3951,3950,18,17,417867,5.932728551336146
candesartan,Dyschezia,1,3951,3950,13,12,417872,8.21464459591042
candesartan,Ear discharge,1,3951,3950,16,15,417869,6.674351265822785
candesartan,Edema of mouth,1,3951,3950,15,14,417870,7.119324894514768
candesartan,Edema of scrotum,12,3951,3939,268,256,417628,4.79211331006809
candesartan,Elective Surgical Procedures,8,3951,3943,65,57,417827,13.165141731208179
candesartan,Electric Countershock,5,3951,3946,124,119,417765,4.309294426368883
candesartan,Electromechanical dissociation,4,3951,3947,117,113,417771,3.6528273123155315
candesartan,Employment dissatisfaction,1,3951,3950,18,17,417867,5.932728551336146
candesartan,Empyema,1,3951,3950,10,9,417875,10.679113924050634
candesartan,Encephalomyelitis,2,3951,3949,8,6,417878,26.7046720688782
candesartan,Endometrial Carcinoma,1,3951,3950,23,22,417862,4.64294991744634
candesartan,Endometriosis,2,3951,3949,67,65,417819,3.188171575649229
candesartan,Enophthalmos,2,3951,3949,6,4,417880,35.60639824428125
candesartan,Enteritis,1,3951,3950,8,7,417877,13.348955696202532
candesartan,Enterocolitis bacterial,3,3951,3948,7,4,417880,45.79114198871037
candesartan,Eosinophilic gastroenteritis,1,3951,3950,33,32,417852,3.2359186804756424
candesartan,Epididymitis,1,3951,3950,19,18,417866,5.620466355762825
candesartan,Epstein-Barr virus associated lymphoma,1,3951,3950,30,29,417855,3.559535864978903
candesartan,Essential Tremor,1,3951,3950,13,12,417872,8.21464459591042
candesartan,Evaluation procedure,1,3951,3950,19,18,417866,5.620466355762825
candesartan,Excision of benign neoplasm,1,3951,3950,25,24,417860,4.271493670886076
candesartan,Eye Burns,1,3951,3950,8,7,417877,13.348955696202532
candesartan,Eye Hemorrhage,3,3951,3948,89,86,417798,3.6008503807930055
candesartan,Eye inflammation,1,3951,3950,15,14,417870,7.119324894514768
candesartan,Faeces discoloured,3,3951,3948,55,52,417832,5.827300359215252
candesartan,Familial Tremor,1,3951,3950,11,10,417874,9.70826237054085
candesartan,Fat redistribution,1,3951,3950,5,4,417880,21.35848101265823
candesartan,Febrile Neutropenia,3,3951,3948,96,93,417791,3.3382329660587637
candesartan,Feeling intoxicated,3,3951,3948,101,98,417786,3.172936290589545
candesartan,Feeling of body temperature change,1,3951,3950,8,7,417877,13.348955696202532
candesartan,Female genital infection,2,3951,3949,14,12,417872,15.259595557645696
candesartan,Flat affect,1,3951,3950,21,20,417864,5.085159734779988
candesartan,Foaming at mouth,2,3951,3949,30,28,417856,7.120874482991475
candesartan,Fracture of patella,1,3951,3950,13,12,417872,8.21464459591042
candesartan,Gallstone ileus,3,3951,3948,88,85,417799,3.641777770102238
candesartan,Gastrointestinal bacterial infection,2,3951,3949,27,25,417859,7.9121390319161895
candesartan,Gastrointestinal oedema,1,3951,3950,15,14,417870,7.119324894514768
candesartan,Gastrostomy,1,3951,3950,8,7,417877,13.348955696202532
candesartan,Genitourinary tract hemorrhage,1,3951,3950,28,27,417857,3.8138065099457505
candesartan,Gunshot wound,6,3951,3945,85,79,417805,7.546410199060612
candesartan,Hair color change (finding),6,3951,3945,166,160,417724,3.8633835723120615
candesartan,"Hallucinations, Visual",1,3951,3950,20,19,417865,5.339430379746836
candesartan,Hemorrhage of tongue,1,3951,3950,17,16,417868,6.281727475800446
candesartan,Henoch-Schonlein purpura nephritis,2,3951,3949,8,6,417878,26.7046720688782
candesartan,Hepatectomy,1,3951,3950,7,6,417878,15.255985533453888
candesartan,"Hepatitis C, Chronic",1,3951,3950,16,15,417869,6.674351265822785
candesartan,"Hepatitis, Chronic",1,3951,3950,8,7,417877,13.348955696202532
candesartan,Hepatotoxicity,10,3951,3941,186,176,417708,5.75216977296849
candesartan,"Hernia, Inguinal",2,3951,3949,17,15,417869,12.566636378532168
candesartan,Hot flushes,8,3951,3943,243,235,417649,3.5200537703426087
candesartan,Hyperamylasemia,8,3951,3943,16,8,417876,53.4896018260208
candesartan,Hyperesthesia,3,3951,3948,42,39,417845,7.631223766102185
candesartan,Hyperglycemia,4,3951,3947,115,111,417773,3.7163723686674524
candesartan,Hyperlactatemia,2,3951,3949,25,23,417861,8.545150671055962
candesartan,Hyperparathyroidism,1,3951,3950,29,28,417856,3.6822872108249673
candesartan,Hypertriglyceridemia,1,3951,3950,18,17,417867,5.932728551336146
candesartan,Hypofibrinogenemia,2,3951,3949,5,3,417881,42.727779184603705
candesartan,Hypogeusia,2,3951,3949,21,19,417865,10.172894885986807
candesartan,Hypoparathyroidism,10,3951,3941,262,252,417632,4.08286539433747
candesartan,Hypoperfusion,1,3951,3950,7,6,417878,15.255985533453888
candesartan,Hypothermia due to exposure,2,3951,3949,43,41,417843,4.9678988498707355
candesartan,Immunologic Deficiency Syndromes,1,3951,3950,9,8,417876,11.865710267229254
candesartan,Incisional hernia,2,3951,3949,24,22,417862,8.901219718072086
candesartan,Increased bilirubin level (finding),5,3951,3946,173,168,417716,3.0883839345616693
candesartan,Increased systolic arterial pressure,1,3951,3950,11,10,417874,9.70826237054085
candesartan,Infantile apnoeic attack,2,3951,3949,30,28,417856,7.120874482991475
candesartan,"Infarction, Lacunar",1,3951,3950,18,17,417867,5.932728551336146
candesartan,Infected dermal cyst,5,3951,3946,167,162,417722,3.1993893611661623
candesartan,Infected ulcer of skin,3,3951,3948,83,80,417804,3.8612077489288454
candesartan,Infectious pericarditis,7,3951,3944,11,4,417880,68.06122072653513
candesartan,Influenza,1,3951,3950,33,32,417852,3.2359186804756424
candesartan,Influenza A virus test,1,3951,3950,19,18,417866,5.620466355762825
candesartan,Infusion Site Extravasation,8,3951,3943,72,64,417820,11.885000140896667
candesartan,Infusion site thrombosis,1,3951,3950,6,5,417879,17.79869198312236
candesartan,Injection site atrophy,1,3951,3950,17,16,417868,6.281727475800446
candesartan,Injection site discolouration,1,3951,3950,35,34,417850,3.050994575045208
candesartan,Injection site injury,9,3951,3942,14,5,417879,68.79011741682974
candesartan,Injection site macule,1,3951,3950,31,30,417854,3.4447039608003265
candesartan,Injection site nodule,2,3951,3949,70,68,417816,3.0515139456643636
candesartan,Injury of retina,4,3951,3947,110,106,417778,3.8853444503305155
candesartan,Intentional drug misuse,1,3951,3950,26,25,417859,4.1071957156767285
candesartan,Intentional overdose,2,3951,3949,36,34,417850,5.9339776596044
candesartan,Interstitial granulomatous dermatitis,7,3951,3944,40,33,417851,18.715548935091277
candesartan,Intervertebral Disk Displacement,2,3951,3949,18,16,417868,11.868461776539771
candesartan,Intestinal Volvulus,2,3951,3949,24,22,417862,8.901219718072086
candesartan,Intraocular pressure test abnormal,1,3951,3950,24,23,417861,4.449483122362869
candesartan,Irregular heart beat,1,3951,3950,17,16,417868,6.281727475800446
candesartan,Joint Range of Motion Decreased,5,3951,3946,104,99,417785,5.138248567195602
candesartan,Klebsiella test positive,1,3951,3950,32,31,417853,3.337049050632911
candesartan,Kyphosis deformity of spine,2,3951,3949,42,40,417844,5.086194214327919
candesartan,Left atrial dilatation,2,3951,3949,45,43,417841,4.747080836217327
candesartan,Left-Sided Heart Failure,1,3951,3950,33,32,417852,3.2359186804756424
candesartan,Legionnaires' Disease,2,3951,3949,7,5,417879,30.51969757262236
candesartan,Leukocytes in urine (finding),3,3951,3948,96,93,417791,3.3382329660587637
candesartan,Leukoencephalopathy,1,3951,3950,7,6,417878,15.255985533453888
candesartan,Lip haemorrhage,1,3951,3950,7,6,417878,15.255985533453888
candesartan,Lipoatrophy,1,3951,3950,8,7,417877,13.348955696202532
candesartan,Liver cyst,2,3951,3949,21,19,417865,10.172894885986807
candesartan,Localised intraabdominal fluid collection,3,3951,3948,48,45,417839,6.677225810536981
candesartan,Locked-In Syndrome,1,3951,3950,14,13,417871,7.627866184448462
candesartan,Low density lipoprotein abnormal,7,3951,3944,249,242,417642,3.0050241534087667
candesartan,Low density lipoprotein increased,1,3951,3950,26,25,417859,4.1071957156767285
candesartan,Lymph nodes scan abnormal,1,3951,3950,27,26,417858,3.9550679793717767
candesartan,Lymphoproliferative Disorders,6,3951,3945,23,17,417867,27.893007108612995
candesartan,Macrocytosis (finding),1,3951,3950,22,21,417863,4.854004602991945
candesartan,Macular fibrosis,1,3951,3950,9,8,417876,11.865710267229254
candesartan,Malignant melanoma in situ,2,3951,3949,53,51,417833,4.030463886247772
candesartan,Malignant neoplasm of breast,6,3951,3945,24,18,417866,26.730735107731306
candesartan,Malignant neoplasm of ureter,5,3951,3946,132,127,417757,4.048048272896221
candesartan,Malignant tumor of nasal sinuses,1,3951,3950,14,13,417871,7.627866184448462
candesartan,Malnutrition,3,3951,3948,104,101,417783,3.0813873626373627
candesartan,Mammaplasty,1,3951,3950,9,8,417876,11.865710267229254
candesartan,Marasmus,1,3951,3950,7,6,417878,15.255985533453888
candesartan,Mass of thyroid gland,1,3951,3950,19,18,417866,5.620466355762825
candesartan,Mastitis,2,3951,3949,53,51,417833,4.030463886247772
candesartan,Maternal hypertension affecting foetus,5,3951,3946,159,154,417730,3.360428680265343
candesartan,Mechanical ventilation,1,3951,3950,14,13,417871,7.627866184448462
candesartan,Mediastinal Diseases,10,3951,3941,278,268,417616,3.847734296703718
candesartan,Meningococcal bacteraemia,4,3951,3947,8,4,417880,53.43640739802382
candesartan,Meniscus removal,1,3951,3950,8,7,417877,13.348955696202532
candesartan,Menopausal symptom,2,3951,3949,68,66,417818,3.1412792516348143
candesartan,Mesenteric artery embolism,1,3951,3950,21,20,417864,5.085159734779988
candesartan,Metabolic acidosis,1,3951,3950,25,24,417860,4.271493670886076
candesartan,Metastatic Renal Cell Carcinoma,2,3951,3949,62,60,417824,3.4453230299218256
candesartan,Metastatic non-small cell lung cancer,1,3951,3950,13,12,417872,8.21464459591042
candesartan,Middle insomnia,9,3951,3942,156,147,417737,6.171393864887016
candesartan,Milk-Alkali Syndrome,1,3951,3950,29,28,417856,3.6822872108249673
candesartan,Morton Neuroma,1,3951,3950,9,8,417876,11.865710267229254
candesartan,Muscle tone disorder,1,3951,3950,16,15,417869,6.674351265822785
candesartan,Musculoskeletal Deformity,3,3951,3948,45,42,417842,7.12242485646741
candesartan,Myelofibrosis,8,3951,3943,57,49,417835,15.013165681131563
candesartan,Myeloproliferative disease,2,3951,3949,58,56,417828,3.6829664428358115
candesartan,Myocardial calcification,2,3951,3949,17,15,417869,12.566636378532168
candesartan,Myocarditis,1,3951,3950,20,19,417865,5.339430379746836
candesartan,Necrosis,5,3951,3946,52,47,417837,10.277764240321261
candesartan,Necrosis of gastrointestinal tract,14,3951,3937,398,384,417500,3.7654094705174335
candesartan,Neglected appearance,1,3951,3950,7,6,417878,15.255985533453888
candesartan,Neonatal hypoglycemia,1,3951,3950,25,24,417860,4.271493670886076
candesartan,Neonatal hypotension,2,3951,3949,9,7,417877,23.73743001041051
candesartan,Neuroma,2,3951,3949,62,60,417824,3.4453230299218256
candesartan,Neutropenia,2,3951,3949,21,19,417865,10.172894885986807
candesartan,Neutrophil count decreased,17,3951,3934,567,550,417334,3.2106279179656574
candesartan,Neutrophil percentage decreased,1,3951,3950,5,4,417880,21.35848101265823
candesartan,Neutrophilia (disorder),1,3951,3950,8,7,417877,13.348955696202532
candesartan,Nikolsky sign,1,3951,3950,14,13,417871,7.627866184448462
candesartan,Nodular regenerative hyperplasia,2,3951,3949,36,34,417850,5.9339776596044
candesartan,Nonalcoholic Steatohepatitis,1,3951,3950,26,25,417859,4.1071957156767285
candesartan,Obsessive-Compulsive Disorder,3,3951,3948,86,83,417801,3.7264879479748356
candesartan,Oestradiol decreased,2,3951,3949,36,34,417850,5.9339776596044
candesartan,Optic Neuropathy,1,3951,3950,16,15,417869,6.674351265822785
candesartan,Oral fibroma,3,3951,3948,23,20,417864,13.935905907228756
candesartan,Oral mucosal blisters,1,3951,3950,15,14,417870,7.119324894514768
candesartan,Oral mucosal erythema,2,3951,3949,24,22,417862,8.901219718072086
candesartan,Orbital Diseases,4,3951,3947,12,8,417876,35.6239337893759
candesartan,Organizing Pneumonia,2,3951,3949,5,3,417881,42.727779184603705
candesartan,Orgasmic Disorder,1,3951,3950,7,6,417878,15.255985533453888
candesartan,Oropharyngeal discomfort,2,3951,3949,48,46,417838,4.450356630370558
candesartan,Osteochondrosis,1,3951,3950,10,9,417875,10.679113924050634
candesartan,Palmar-plantar erythrodysesthesia syndrome,2,3951,3949,46,44,417840,4.643872416792363
candesartan,Pancreaticoduodenectomy,1,3951,3950,5,4,417880,21.35848101265823
candesartan,Parasite infestation,2,3951,3949,8,6,417878,26.7046720688782
candesartan,Parvovirus B19 test positive,1,3951,3950,33,32,417852,3.2359186804756424
candesartan,Pelvic abscess,1,3951,3950,6,5,417879,17.79869198312236
candesartan,Perianal erythema,3,3951,3948,14,11,417873,22.895191055145464
candesartan,Pericardial effusion,2,3951,3949,55,53,417831,3.883883146481272
candesartan,Perinatal intraventricular hemorrhage,1,3951,3950,30,29,417855,3.559535864978903
candesartan,Phlebitis,2,3951,3949,27,25,417859,7.9121390319161895
candesartan,Plasmablastic lymphoma,1,3951,3950,8,7,417877,13.348955696202532
candesartan,Pneumothorax,1,3951,3950,31,30,417854,3.4447039608003265
candesartan,Portal Hypertension,10,3951,3941,274,264,417620,3.9039426430358737
candesartan,Premature Birth,8,3951,3943,61,53,417831,14.028562756992056
candesartan,Product barcode issue,2,3951,3949,21,19,417865,10.172894885986807
candesartan,Product label issue,3,3951,3948,58,55,417829,5.525848967613458
candesartan,Projectile vomiting,1,3951,3950,23,22,417862,4.64294991744634
candesartan,Prosthesis user,2,3951,3949,19,17,417867,11.243779237914994
candesartan,Protein total increased,4,3951,3947,102,98,417786,4.190156832938395
candesartan,Proteus Infections,1,3951,3950,23,22,417862,4.64294991744634
candesartan,Prothrombin time ratio decreased,1,3951,3950,14,13,417871,7.627866184448462
candesartan,Pruritus,3,3951,3948,99,96,417788,3.2370513647109393
candesartan,Pulmonary Embolism,4,3951,3947,113,109,417775,3.7821668075451056
candesartan,"Purpura, Thrombotic Thrombocytopenic",9,3951,3942,110,101,417783,8.753113325031133
candesartan,Rectal hemorrhage,2,3951,3949,43,41,417843,4.9678988498707355
candesartan,Removal of ovarian cyst,9,3951,3942,241,232,417652,3.993955929441634
candesartan,Renal mass,1,3951,3950,29,28,417856,3.6822872108249673
candesartan,Renal tubular acidosis,2,3951,3949,23,21,417863,9.288251290915698
candesartan,Renal tubular disorder,2,3951,3949,19,17,417867,11.243779237914994
candesartan,"Respiratory Distress Syndrome, Adult",2,3951,3949,25,23,417861,8.545150671055962
candesartan,Respiratory tract infection bacterial,1,3951,3950,14,13,417871,7.627866184448462
candesartan,Retinal Perforations,1,3951,3950,14,13,417871,7.627866184448462
candesartan,Retinal artery embolism,1,3951,3950,21,20,417864,5.085159734779988
candesartan,Retrognathia,1,3951,3950,14,13,417871,7.627866184448462
candesartan,Ruptured cerebral aneurysm,1,3951,3950,17,16,417868,6.281727475800446
candesartan,Sciatica,3,3951,3948,69,66,417818,4.644795383463284
candesartan,Seizure like phenomena,1,3951,3950,7,6,417878,15.255985533453888
candesartan,Sensory neuropathy,1,3951,3950,35,34,417850,3.050994575045208
candesartan,Shortened PR interval,1,3951,3950,26,25,417859,4.1071957156767285
candesartan,Skin Papilloma,1,3951,3950,23,22,417862,4.64294991744634
candesartan,Skin Wrinkling,4,3951,3947,81,77,417807,5.276756530197963
candesartan,Skin hemorrhages,10,3951,3941,106,96,417788,10.09534501826469
candesartan,Sleep Talking,1,3951,3950,9,8,417876,11.865710267229254
candesartan,Small bowel angioedema,2,3951,3949,21,19,417865,10.172894885986807
candesartan,Small intestinal ulcer haemorrhage,3,3951,3948,66,63,417821,4.855956986276135
candesartan,Somnambulism,1,3951,3950,16,15,417869,6.674351265822785
candesartan,Spinal Cord Ischemia,1,3951,3950,14,13,417871,7.627866184448462
candesartan,Spinal Fractures,3,3951,3948,104,101,417783,3.0813873626373627
candesartan,Splenic vein thrombosis,1,3951,3950,6,5,417879,17.79869198312236
candesartan,Splenomegaly,3,3951,3948,90,87,417797,3.5608324890239786
candesartan,Stage III Colon Cancer,1,3951,3950,9,8,417876,11.865710267229254
candesartan,Stoma site erythema,1,3951,3950,5,4,417880,21.35848101265823
candesartan,Subacute thyroiditis,2,3951,3949,13,11,417873,16.43344955879775
candesartan,Subarachnoid Hemorrhage,1,3951,3950,15,14,417870,7.119324894514768
candesartan,Subcutaneous Abscess,12,3951,3939,389,377,417507,3.3005597573797325
candesartan,Substance-induced psychotic disorder,1,3951,3950,12,11,417873,8.8992194092827
candesartan,Suicide attempt,5,3951,3946,101,96,417788,5.290907448575572
candesartan,Swelling of scrotum,2,3951,3949,25,23,417861,8.545150671055962
candesartan,"Tachycardia, Ventricular",1,3951,3950,33,32,417852,3.2359186804756424
candesartan,Temperature intolerance,4,3951,3947,40,36,417848,10.686470737268813
candesartan,Tenotomy (procedure),1,3951,3950,5,4,417880,21.35848101265823
candesartan,Therapeutic response unexpected with drug substitution,1,3951,3950,14,13,417871,7.627866184448462
candesartan,Thirst,1,3951,3950,15,14,417870,7.119324894514768
candesartan,Thrombocytosis,1,3951,3950,5,4,417880,21.35848101265823
candesartan,Tinnitus,6,3951,3945,184,178,417706,3.485295090097537
candesartan,Tobacco Use Disorder,3,3951,3948,30,27,417857,10.68401722391084
candesartan,Tobacco user,1,3951,3950,24,23,417861,4.449483122362869
candesartan,Toxic Epidermal Necrolysis,1,3951,3950,8,7,417877,13.348955696202532
candesartan,Troponin I increased,1,3951,3950,35,34,417850,3.050994575045208
candesartan,Trypanophobia,3,3951,3948,39,36,417848,8.21829943106539
candesartan,Tumor necrosis,1,3951,3950,6,5,417879,17.79869198312236
candesartan,Tumor pain,1,3951,3950,13,12,417872,8.21464459591042
candesartan,Tumour lysis syndrome (SMQ),5,3951,3946,176,171,417713,3.0357194281896507
candesartan,Typhlitis,4,3951,3947,78,74,417810,5.479747682433267
candesartan,Uhthoff's phenomenon,1,3951,3950,24,23,417861,4.449483122362869
candesartan,Ulceration of gingivae,36,3951,3915,1062,1026,416858,3.6432928545143626
candesartan,Ulna Fractures,2,3951,3949,42,40,417844,5.086194214327919
candesartan,Umbilical erythema,1,3951,3950,8,7,417877,13.348955696202532
candesartan,Umbilical hemorrhage,6,3951,3945,91,85,417799,7.048744411482054
candesartan,Urethral Obstruction,2,3951,3949,20,18,417866,10.681564953152698
candesartan,Urgent desire for stool,1,3951,3950,14,13,417871,7.627866184448462
candesartan,Urinary Bladder Fistula,6,3951,3945,139,133,417751,4.6141204146948605
candesartan,Urinary hesitation,1,3951,3950,8,7,417877,13.348955696202532
candesartan,Urinary tract obstruction,1,3951,3950,24,23,417861,4.449483122362869
candesartan,Uterine Polyp,1,3951,3950,6,5,417879,17.79869198312236
candesartan,Uveomeningoencephalitic Syndrome,1,3951,3950,11,10,417874,9.70826237054085
candesartan,Vaccination site swelling,8,3951,3943,76,68,417816,11.259367032849685
candesartan,Vaginal Diseases,1,3951,3950,20,19,417865,5.339430379746836
candesartan,Vaginal lesion,3,3951,3948,26,23,417861,12.327829085807808
candesartan,Vascular pain,1,3951,3950,11,10,417874,9.70826237054085
candesartan,Vascular rupture,1,3951,3950,31,30,417854,3.4447039608003265
candesartan,Venous valve ruptured,2,3951,3949,16,14,417870,13.352082805773614
candesartan,Vertebral Artery Stenosis,1,3951,3950,5,4,417880,21.35848101265823
candesartan,Vessel puncture site haematoma,1,3951,3950,17,16,417868,6.281727475800446
candesartan,Visual acuity reduced transiently,1,3951,3950,30,29,417855,3.559535864978903
candesartan,Vitamin B12 deficiency anemia,5,3951,3946,105,100,417784,5.089300798880119
candesartan,Vocal Cord Paralysis,1,3951,3950,8,7,417877,13.348955696202532
candesartan,Vomiting fecal matter,1,3951,3950,6,5,417879,17.79869198312236
candesartan,Vulvovaginal dryness,2,3951,3949,39,37,417847,5.477478881378603
candesartan,Vulvovaginal pain,2,3951,3949,23,21,417863,9.288251290915698
candesartan,Waist circumference increased,1,3951,3950,16,15,417869,6.674351265822785
candesartan,Withdrawal hypertension,1,3951,3950,18,17,417867,5.932728551336146
candesartan,Withdrawal of life support,1,3951,3950,16,15,417869,6.674351265822785
candesartan,Wound infection bacterial,6,3951,3945,44,38,417846,14.579709643968197
candesartan,Wrist deformity,1,3951,3950,23,22,417862,4.64294991744634
candesartan,Wrong drug administered,1,3951,3950,25,24,417860,4.271493670886076
candesartan,trauma to the abdomen,3,3951,3948,37,34,417850,8.66257290725376
candesartan,treatment failure,4,3951,3947,63,59,417825,6.784690803945934
captopril,5q-syndrome,1,983,982,7,6,420846,61.365725923770725
captopril,Abnormal coordination,1,983,982,102,101,420751,4.2104249031588195
captopril,Adenomatous Polyposis Coli,1,983,982,33,32,420820,13.016169845090415
captopril,Adverse reactions,2,983,981,284,282,420570,3.026166171339966
captopril,Amputation,1,983,982,24,23,420829,17.897615410726406
captopril,Anemia of renal disease,1,983,982,55,54,420798,7.809294575078689
captopril,Animal bite,1,983,982,83,82,420770,5.174490221578779
captopril,Antiphospholipid antibodies positive,1,983,982,5,4,420848,85.91242362525459
captopril,Aphagia,3,983,980,430,427,420425,3.000035595633602
captopril,Aplastic Anemia,2,983,981,178,176,420676,4.829479206038323
captopril,Apparent death,1,983,982,53,52,420800,8.104023363947277
captopril,Application site rash,1,983,982,28,27,420825,15.340667733488507
captopril,Arteriopathic disease,1,983,982,50,49,420803,8.590325865580448
captopril,Aseptic Meningitis,2,983,981,94,92,420760,9.147005877632465
captopril,Aspergillosis,1,983,982,50,49,420803,8.590325865580448
captopril,Asthenia,14,983,969,1845,1831,419021,3.288870989845089
captopril,Atelectasis,3,983,980,423,420,420432,3.049732233318859
captopril,Baresthesia,4,983,979,288,284,420568,5.980408012711384
captopril,Bladder pain,1,983,982,112,111,420741,3.8344031859179513
captopril,Blood chloride decreased,1,983,982,11,10,420842,39.05054619514905
captopril,Blood creatinine abnormal,1,983,982,17,16,420836,25.267641068647418
captopril,Blood testosterone decreased,7,983,976,991,984,419868,3.0457602024780397
captopril,Bone Diseases,1,983,982,36,35,420817,11.931404163837973
captopril,Bone necrosis,1,983,982,56,55,420797,7.669824701774803
captopril,Breast Diseases,1,983,982,97,96,420756,4.427509605895815
captopril,Bronchiectasis,1,983,982,5,4,420848,85.91242362525459
captopril,Bronchopneumonia,1,983,982,57,56,420796,7.5352485082359655
captopril,Bursitis,2,983,981,121,119,420733,7.105483525833818
captopril,C-reactive protein outside reference range,1,983,982,5,4,420848,85.91242362525459
captopril,Carcinoma in situ of rectum,1,983,982,95,94,420758,4.52074177296602
captopril,Cardiac Flutter,1,983,982,54,53,420799,7.953929999245681
captopril,Cardiac Tamponade,1,983,982,5,4,420848,85.91242362525459
captopril,Cardiac neoplasm unspecified,1,983,982,15,14,420838,28.636795655125592
captopril,Cardiomyopathies,1,983,982,32,31,420821,13.42295697556008
captopril,Cerebral cyst,1,983,982,52,51,420801,8.259889550368165
captopril,Cerebrovascular accident,1,983,982,23,22,420830,18.675816877711856
captopril,Cervical spinal cord injury,1,983,982,17,16,420836,25.267641068647418
captopril,Choking sensation,1,983,982,14,13,420839,30.682353796915915
captopril,Chronic Obstructive Airway Disease,4,983,979,492,488,420364,3.499032528629679
captopril,Cognitive function: distractibility,1,983,982,46,45,420807,9.337399273886478
captopril,Cold Sensation,1,983,982,92,91,420761,4.668190471973789
captopril,Contusion of eye,1,983,982,11,10,420842,39.05054619514905
captopril,Corneal dystrophy,1,983,982,50,49,420803,8.590325865580448
captopril,Coronary Arteriosclerosis,3,983,980,88,85,420767,14.671161873840443
captopril,Coronary revascularisation,1,983,982,68,67,420785,6.316146519707679
captopril,Deformity of knee joint,1,983,982,41,40,420812,10.476230688987135
captopril,Device malfunction,6,983,977,428,422,420430,6.046647662594821
captopril,Diabetic ketoacidotic hyperglycaemic coma,1,983,982,14,13,420839,30.682353796915915
captopril,Diastolic dysfunction,1,983,982,109,108,420744,3.9399652459874064
captopril,Difficulty driving a car,2,983,981,51,49,420803,16.86090623813236
captopril,Diffuse Large B-Cell Lymphoma,1,983,982,58,57,420795,7.405312873095021
captopril,Dilatation of esophagus (disorder),1,983,982,8,7,420845,53.69488289205703
captopril,Discoloration of skin,2,983,981,86,84,420768,9.998079795178151
captopril,Disorder of tendon,1,983,982,25,24,420828,17.181670061099794
captopril,Disorder of vein,3,983,980,99,96,420756,13.04069264069264
captopril,"Disruptive, Impulse Control, and Conduct Disorders",1,983,982,56,55,420797,7.669824701774803
captopril,Dream disorder,1,983,982,56,55,420797,7.669824701774803
captopril,Dysgraphia,3,983,980,248,245,420607,5.203921165240289
captopril,Dyskinetic syndrome,3,983,980,218,215,420637,5.920478374836173
captopril,Earache,5,983,978,471,466,420386,4.573699955279416
captopril,Ecchymosis,1,983,982,56,55,420797,7.669824701774803
captopril,Ectropion,1,983,982,9,8,420844,47.72867164516858
captopril,Endodontic procedure,1,983,982,71,70,420782,6.049224061271908
captopril,Enteric campylobacteriosis,1,983,982,109,108,420744,3.9399652459874064
captopril,Epiglottitis,1,983,982,27,26,420826,15.908878328430264
captopril,Erythema at injection site,1,983,982,67,66,420786,6.410432562239718
captopril,Estimated glomerular filtration rate decreased,2,983,981,24,22,420830,35.83171933401291
captopril,Euphoric mood,1,983,982,131,130,420722,3.278120675984515
captopril,Excessive periungual granulation tissue,1,983,982,51,50,420802,8.421868136256538
captopril,Eye allergy,1,983,982,11,10,420842,39.05054619514905
captopril,Eyelid pain,1,983,982,76,75,420777,5.6511817986922495
captopril,Febrile Neutropenia,1,983,982,96,95,420757,4.473640105227427
captopril,Fecaloma,1,983,982,20,19,420833,21.47734215885947
captopril,Feeling jittery,1,983,982,87,86,420766,4.936535805417047
captopril,Fibrosis of the skin,3,983,980,190,187,420665,6.7934210526315795
captopril,Foaming at mouth,1,983,982,30,29,420823,14.317888662593345
captopril,Formication,1,983,982,34,33,420819,12.633311369354258
captopril,Fracture of wrist,1,983,982,96,95,420757,4.473640105227427
captopril,Fungemia,1,983,982,38,37,420815,11.3033819273234
captopril,Furred tongue,1,983,982,49,48,420804,8.765659420591046
captopril,Gastric pH decreased,1,983,982,5,4,420848,85.91242362525459
captopril,Gastroenteritis,2,983,981,245,243,420609,3.508206952505773
captopril,Gastrointestinal obstruction,1,983,982,26,25,420827,16.52079743067523
captopril,Gastrointestinal ulcer,1,983,982,120,119,420733,3.5787084181941617
captopril,Genital hemorrhage,1,983,982,65,64,420788,6.607707974306753
captopril,Good neonatal condition at birth,1,983,982,21,20,420832,20.454563087964306
captopril,Growing pains,1,983,982,7,6,420846,61.365725923770725
captopril,Gum Infection,1,983,982,37,36,420816,11.60890625860076
captopril,Hemoptysis,3,983,980,378,375,420477,3.413160025915128
captopril,Hemorrhage,3,983,980,304,301,420551,4.244740198711063
captopril,Hemorrhage of penis,2,983,981,75,73,420779,11.464763846415224
captopril,Hemorrhagic Stroke,1,983,982,68,67,420785,6.316146519707679
captopril,Hernia of abdominal cavity,1,983,982,26,25,420827,16.52079743067523
captopril,Hernia pain,1,983,982,13,12,420840,33.04261319128937
captopril,High density lipoprotein abnormal,1,983,982,61,60,420792,7.0410670762245005
captopril,Histrionic Personality Disorder,1,983,982,21,20,420832,20.454563087964306
captopril,Hydrops of gallbladder,1,983,982,15,14,420838,28.636795655125592
captopril,Hyperkeratosis,1,983,982,16,15,420837,26.84693228105906
captopril,Hyperplasia,1,983,982,87,86,420766,4.936535805417047
captopril,Hypertensive heart disease,2,983,981,122,120,420732,7.047225146638592
captopril,Hypertrophy,1,983,982,122,121,420731,3.5200243731427996
captopril,Hypervolemia (finding),1,983,982,117,116,420736,3.670496283530907
captopril,Hypovolemic Shock,1,983,982,78,77,420775,5.50625359026581
captopril,Impaired exercise tolerance,1,983,982,84,83,420769,5.112877024536902
captopril,Impaired pupillary reflex,1,983,982,109,108,420744,3.9399652459874064
captopril,Inappropriate schedule of drug administration,1,983,982,139,138,420714,3.0893932511831674
captopril,Incorrect drug administration duration,3,983,980,236,233,420619,5.468682981667244
captopril,Incorrect drug administration rate,1,983,982,95,94,420758,4.52074177296602
captopril,Increased anteroposterior chest diameter,1,983,982,45,44,420808,9.544919665082599
captopril,Increased upper airway secretion,4,983,979,352,348,420504,4.892318228247748
captopril,Infarction,2,983,981,54,52,420800,15.924075961792576
captopril,Infected dermal cyst,3,983,980,167,164,420688,7.72946352193572
captopril,Infective glossitis,1,983,982,11,10,420842,39.05054619514905
captopril,Infective vaginitis,1,983,982,115,114,420738,3.7343487115912515
captopril,Inflammatory corneal ulcer,1,983,982,59,58,420794,7.279781835755463
captopril,Injection site edema,1,983,982,37,36,420816,11.60890625860076
captopril,Injection site induration,4,983,979,394,390,420462,4.3703665296091
captopril,Injection site inflammation,4,983,979,466,462,420390,3.694485482690141
captopril,Injection site mass,3,983,980,222,219,420633,5.813747931605074
captopril,Injection site papule,1,983,982,122,121,420731,3.5200243731427996
captopril,International normalized ratio outside reference range,1,983,982,36,35,420817,11.931404163837973
captopril,Interstitial granulomatous dermatitis,1,983,982,40,39,420813,10.738161914460285
captopril,Intestinal Volvulus,1,983,982,24,23,420829,17.897615410726406
captopril,Intraocular pressure test abnormal,1,983,982,24,23,420829,17.897615410726406
captopril,Itching of eye,1,983,982,73,72,420780,5.883463995759283
captopril,Jaw pain,1,983,982,80,79,420773,5.368571792260693
captopril,"Kidney Failure, Acute",2,983,981,173,171,420681,4.969118452917573
captopril,Laziness,1,983,982,34,33,420819,12.633311369354258
captopril,Lesion of genitalia,1,983,982,46,45,420807,9.337399273886478
captopril,"Leukemia, Myelocytic, Acute",1,983,982,48,47,420805,8.948298540393754
captopril,Limb injury,2,983,981,80,78,420774,10.74808868501529
captopril,Limb operation,1,983,982,138,137,420715,3.1117875380028925
captopril,Liver enzymes abnormal,1,983,982,13,12,420840,33.04261319128937
captopril,Localised intraabdominal fluid collection,1,983,982,48,47,420805,8.948298540393754
captopril,Long QT Syndrome,1,983,982,10,9,420843,42.955702647657844
captopril,Low birth weight baby,1,983,982,118,117,420735,3.6393817529082813
captopril,Lung diseases,1,983,982,36,35,420817,11.931404163837973
captopril,Lymphedema,4,983,979,549,545,420307,3.1353207894007302
captopril,Lymphocyte stimulation test positive,1,983,982,76,75,420777,5.6511817986922495
captopril,Lysis of adhesions of tendon,2,983,981,257,255,420597,3.3443044300860314
captopril,Macular Holes,3,983,980,267,264,420588,4.8333868378812195
captopril,Malignant neoplasm of ureter,1,983,982,132,131,420721,3.2532787138184287
captopril,Mammary Neoplasms,1,983,982,20,19,420833,21.47734215885947
captopril,Menopausal symptom,1,983,982,68,67,420785,6.316146519707679
captopril,Metastatic malignant neoplasm to brain,2,983,981,252,250,420602,3.4107001278255096
captopril,Metastatic malignant neoplasm to liver,1,983,982,88,87,420765,4.880427235697093
captopril,Mitral Valve Prolapse Syndrome,1,983,982,78,77,420775,5.50625359026581
captopril,Morbilliform rash,3,983,980,385,382,420470,3.351046912271402
captopril,Multiple allergies,2,983,981,99,97,420755,8.68493291734882
captopril,Mydriasis,1,983,982,95,94,420758,4.52074177296602
captopril,Nail discomfort,1,983,982,8,7,420845,53.69488289205703
captopril,Narrowing of intervertebral disc space,1,983,982,106,105,420747,4.051502517004188
captopril,Needle issue,1,983,982,59,58,420794,7.279781835755463
captopril,Nephrosclerosis,1,983,982,41,40,420812,10.476230688987135
captopril,Neurostimulator implantation,1,983,982,10,9,420843,42.955702647657844
captopril,Nocturnal dyspnea,1,983,982,7,6,420846,61.365725923770725
captopril,Normal menstruation (finding),2,983,981,93,91,420761,9.245382701434789
captopril,Ocular hyperemia,8,983,975,763,755,420097,4.528112376919717
captopril,Operation on bone,1,983,982,24,23,420829,17.897615410726406
captopril,Oral paresthesia,2,983,981,73,71,420781,11.778922821275465
captopril,Osteoporosis,1,983,982,132,131,420721,3.2532787138184287
captopril,Ovarian Diseases,3,983,980,227,224,420628,5.685624381911355
captopril,Pelvic mass,1,983,982,12,11,420841,35.79624915139171
captopril,Perforation of small intestine,2,983,981,127,125,420727,6.769695072519605
captopril,Peripheral nerve lesion,1,983,982,28,27,420825,15.340667733488507
captopril,Peritoneal adhesion,2,983,981,260,258,420594,3.3056927781698424
captopril,Pharyngitis,1,983,982,108,107,420745,3.9764558346533905
captopril,Polychondritis,1,983,982,56,55,420797,7.669824701774803
captopril,Polyp of vocal cord,1,983,982,15,14,420838,28.636795655125592
captopril,Poor quality drug administered,1,983,982,18,17,420835,23.863826657614844
captopril,Postoperative deep vein thrombosis,1,983,982,5,4,420848,85.91242362525459
captopril,Pre-Eclampsia,1,983,982,6,5,420847,71.59351663272233
captopril,Product deposit,1,983,982,87,86,420766,4.936535805417047
captopril,Product label issue,1,983,982,58,57,420795,7.405312873095021
captopril,Prostatic cyst,1,983,982,6,5,420847,71.59351663272233
captopril,Psychological Trauma,1,983,982,99,98,420754,4.338044395070872
captopril,Pulmonary Infarction,1,983,982,99,98,420754,4.338044395070872
captopril,Pus in stool,1,983,982,91,90,420762,4.719500458807995
captopril,Reading disorder,1,983,982,78,77,420775,5.50625359026581
captopril,Repair of hip,4,983,979,184,180,420672,9.362947994848335
captopril,Replacement of aortic valve (procedure),1,983,982,5,4,420848,85.91242362525459
captopril,Respiratory arrest,1,983,982,68,67,420785,6.316146519707679
captopril,Rosacea,1,983,982,107,106,420746,4.0136284903972435
captopril,Salpingitis,1,983,982,76,75,420777,5.6511817986922495
captopril,Salt craving,1,983,982,130,129,420723,3.303344822183926
captopril,Sarcopenia,1,983,982,16,15,420837,26.84693228105906
captopril,Seasonal rhinitis,1,983,982,136,135,420717,3.1575640948843895
captopril,Sialadenitis,1,983,982,70,69,420783,6.135656095432062
captopril,Skeletal injury,1,983,982,51,50,420802,8.421868136256538
captopril,Skin Basal Cell Carcinoma,1,983,982,107,106,420746,4.0136284903972435
captopril,Spinal Diseases,1,983,982,53,52,420800,8.104023363947277
captopril,Spinal column stenosis,6,983,977,381,375,420477,6.793317160841077
captopril,Spondylitis,1,983,982,72,71,420781,5.965192916949536
captopril,Squamous cell carcinoma,1,983,982,91,90,420762,4.719500458807995
captopril,Squamous cell carcinoma of lung,1,983,982,123,122,420730,3.491398009703112
captopril,Squamous cell carcinoma of tongue,4,983,979,407,403,420449,4.230642007965808
captopril,Stage III Colon Cancer,1,983,982,9,8,420844,47.72867164516858
captopril,Staphylococcal Skin Infections,1,983,982,79,78,420774,5.436541287478408
captopril,Staphylococcal sepsis,2,983,981,146,144,420708,5.888442042645888
captopril,Stomatitis,2,983,981,175,173,420679,4.912305227901558
captopril,Sudden death,1,983,982,60,59,420793,7.158435166327223
captopril,Swallowing painful,1,983,982,44,43,420809,9.761872801333087
captopril,Swollen nasal mucosa (finding),1,983,982,40,39,420813,10.738161914460285
captopril,Synovial Cyst,3,983,980,84,81,420771,15.36993440233236
captopril,Systemic candidiasis,1,983,982,64,63,420789,6.710969322810591
captopril,Temporomandibular Joint Dysfunction Syndrome,6,983,977,545,539,420313,4.747241602734452
captopril,Terminal state,1,983,982,40,39,420813,10.738161914460285
captopril,Termination of pregnancy (procedure),1,983,982,39,38,420814,11.01352551047052
captopril,Thoracic vertebral fracture,6,983,977,550,544,420308,4.704029031357588
captopril,Throat irritation,1,983,982,132,131,420721,3.2532787138184287
captopril,Thrombocytopenia,1,983,982,62,61,420791,6.927485053544445
captopril,Tooth Infection,2,983,981,76,74,420778,11.313884865067868
captopril,Toothache,2,983,981,252,250,420602,3.4107001278255096
captopril,Tracheal oedema,5,983,978,684,679,420173,3.1478416986570035
captopril,Tremor,1,983,982,81,80,420772,5.3022805561841535
captopril,Trichomonas Infections,2,983,981,160,158,420694,5.3730249745158005
captopril,Trichorrhexis,1,983,982,33,32,420820,13.016169845090415
captopril,Tuberculosis,1,983,982,37,36,420816,11.60890625860076
captopril,"Tuberculosis, Pulmonary",1,983,982,63,62,420790,6.8175088093621685
captopril,Typhlitis,1,983,982,78,77,420775,5.50625359026581
captopril,Ulna Fractures,2,983,981,42,40,420812,20.47439444687151
captopril,Underdose (unintentional),1,983,982,89,88,420764,4.825579532712419
captopril,Unilateral deafness,1,983,982,23,22,420830,18.675816877711856
captopril,Urinary Stress Incontinence,1,983,982,127,126,420726,3.3814006446750167
captopril,Urinary tract infection,1,983,982,132,131,420721,3.2532787138184287
captopril,Urine sodium abnormal,1,983,982,8,7,420845,53.69488289205703
captopril,Vaginal Discharge,1,983,982,38,37,420815,11.3033819273234
captopril,Vascular occlusion,1,983,982,76,75,420777,5.6511817986922495
captopril,Vasculitis,1,983,982,127,126,420726,3.3814006446750167
captopril,Ventricular Dysfunction,1,983,982,121,120,420732,3.5491238996145493
captopril,Viral test positive,1,983,982,65,64,420788,6.607707974306753
captopril,Vitamin B12 deficiency anemia,1,983,982,105,104,420748,4.090097953641743
captopril,Vitamin D below reference range,1,983,982,57,56,420796,7.5352485082359655
captopril,Vulval intraepithelial neoplasia,1,983,982,9,8,420844,47.72867164516858
captopril,Wound of skin,3,983,980,156,153,420699,8.274705651491367
captopril,Wrong technique in drug usage process,2,983,981,48,46,420806,17.91484029901461
captopril,treatment failure,1,983,982,63,62,420790,6.8175088093621685
carvedilol,"Abdomen, Acute",1,2401,2400,23,22,419412,7.641521739130434
carvedilol,Abnormal posture,1,2401,2400,49,48,419386,3.586615646258503
carvedilol,Abnormal ventricular axis,1,2401,2400,27,26,419408,6.509382716049383
carvedilol,Abscess of intestine,1,2401,2400,20,19,419415,8.787812500000001
carvedilol,"Acidosis, Lactic",4,2401,2397,165,161,419273,4.264623708929091
carvedilol,Acute pulmonary edema,2,2401,2399,12,10,419424,29.30547450326525
carvedilol,Adenoidectomy,1,2401,2400,38,37,419397,4.624967105263157
carvedilol,Adenomatous Polyposis Coli,2,2401,2399,33,31,419403,10.656005658923542
carvedilol,Alopecia Areata,1,2401,2400,6,5,419429,29.293680555555554
carvedilol,Altered bowel function,3,2401,2398,104,101,419333,5.073109803040996
carvedilol,"Amputation of finger, except thumb (procedure)",1,2401,2400,42,41,419393,4.184454365079365
carvedilol,Amputation of toe (procedure),1,2401,2400,54,53,419381,3.2544830246913574
carvedilol,Anaphylactoid Reaction,6,2401,2395,286,280,419154,3.6925617180314467
carvedilol,Anemia due to blood loss,2,2401,2399,12,10,419424,29.30547450326525
carvedilol,Anger,3,2401,2398,140,137,419297,3.768274157035625
carvedilol,"Angina, Unstable",1,2401,2400,46,45,419389,3.820552536231884
carvedilol,"Angioedemas, Hereditary",1,2401,2400,22,21,419413,7.988882575757576
carvedilol,Anosmia,1,2401,2400,13,12,419422,13.519935897435898
carvedilol,"Aortic Aneurysm, Ruptured",1,2401,2400,18,17,419417,9.764282407407407
carvedilol,Aphagia,8,2401,2393,430,422,419012,3.2762611881553756
carvedilol,Apparent death,1,2401,2400,53,52,419382,3.315896226415094
carvedilol,Application site haemorrhage,1,2401,2400,24,23,419411,7.323107638888888
carvedilol,Application site infection,1,2401,2400,5,4,419430,35.1525
carvedilol,Arnold Chiari Malformation,1,2401,2400,17,16,419418,10.338676470588235
carvedilol,"Arthritis, Psoriatic",1,2401,2400,7,6,419428,25.108809523809523
carvedilol,Arthropod sting,1,2401,2400,34,33,419401,5.169129901960784
carvedilol,Aspergillosis,1,2401,2400,50,49,419385,3.514875
carvedilol,Aspiration Pneumonia,1,2401,2400,29,28,419406,6.060431034482758
carvedilol,Asthenopia,1,2401,2400,34,33,419401,5.169129901960784
carvedilol,Athletic Injuries,1,2401,2400,8,7,419427,21.970156250000002
carvedilol,Atrial Flutter,1,2401,2400,34,33,419401,5.169129901960784
carvedilol,Avulsion fracture,5,2401,2396,107,102,419332,8.224923158535253
carvedilol,Bacterial gastroenteritis,2,2401,2399,58,56,419378,6.062540426327062
carvedilol,Basal Ganglia Hemorrhage,1,2401,2400,42,41,419393,4.184454365079365
carvedilol,Benign neoplasm of breast,2,2401,2399,6,4,419430,58.611782687230786
carvedilol,Blood cholesterol decreased,1,2401,2400,46,45,419389,3.820552536231884
carvedilol,Blood creatine phosphokinase MB increased,2,2401,2399,61,59,419375,5.764341699751946
carvedilol,Blood iron decreased,14,2401,2387,687,673,418761,3.595453051432767
carvedilol,Blood potassium abnormal,1,2401,2400,24,23,419411,7.323107638888888
carvedilol,Blood sodium increased,1,2401,2400,22,21,419413,7.988882575757576
carvedilol,Blood triglycerides,1,2401,2400,10,9,419425,17.57604166666667
carvedilol,Blood urine present,1,2401,2400,6,5,419429,29.293680555555554
carvedilol,Bone Transplantation,1,2401,2400,31,30,419404,5.669408602150537
carvedilol,Bowen's Disease,1,2401,2400,15,14,419420,11.717222222222222
carvedilol,"Brain Diseases, Metabolic",1,2401,2400,7,6,419428,25.108809523809523
carvedilol,Brain Edema,2,2401,2399,79,77,419357,4.450757435851436
carvedilol,Brain Stem Infarctions,2,2401,2399,5,3,419431,70.33430596081702
carvedilol,Brain natriuretic peptide increased,1,2401,2400,44,43,419391,3.994232954545455
carvedilol,Breast Diseases,2,2401,2399,97,95,419339,3.6246889812335894
carvedilol,Bronchial Obstruction,3,2401,2398,137,134,419300,3.850818504471488
carvedilol,Bullous Dermatitis,1,2401,2400,8,7,419427,21.970156250000002
carvedilol,Burning feet syndrome,3,2401,2398,12,9,419425,43.976542952460385
carvedilol,Bursal fluid accumulation,1,2401,2400,13,12,419422,13.519935897435898
carvedilol,Calcium pyrophosphate deposition disease,1,2401,2400,43,42,419392,4.087131782945736
carvedilol,Candiduria,2,2401,2399,80,78,419356,4.39511254689454
carvedilol,Capillary Leak Syndrome,1,2401,2400,47,46,419388,3.739255319148936
carvedilol,Cardiac Arrest,1,2401,2400,20,19,419415,8.787812500000001
carvedilol,Cardiac Flutter,1,2401,2400,54,53,419381,3.2544830246913574
carvedilol,Cardiovascular Deconditioning,1,2401,2400,12,11,419423,14.646631944444444
carvedilol,Cataract,12,2401,2389,618,606,418828,3.4235960124681486
carvedilol,Cavitation of lung,1,2401,2400,27,26,419408,6.509382716049383
carvedilol,Celiac Disease,2,2401,2399,6,4,419430,58.611782687230786
carvedilol,Cerebrovascular accident,1,2401,2400,23,22,419412,7.641521739130434
carvedilol,Colitis,4,2401,2397,175,171,419263,4.020835568269861
carvedilol,"Colitis, Ischemic",2,2401,2399,51,49,419385,6.89476824493866
carvedilol,Colour blindness (incl acquired),2,2401,2399,26,24,419410,13.52515471189919
carvedilol,Congenital cystic kidney disease,1,2401,2400,55,54,419380,3.19530303030303
carvedilol,Corneal Scar,2,2401,2399,10,8,419426,35.16673614005836
carvedilol,Corneal dystrophy,2,2401,2399,50,48,419386,7.032680283451438
carvedilol,Creatinine clearance-glomerular filtration outside reference range,1,2401,2400,5,4,419430,35.1525
carvedilol,Creatinine measurement,1,2401,2400,9,8,419426,19.52898148148148
carvedilol,Crushing injury,9,2401,2392,253,244,419190,6.269643872195857
carvedilol,Cutaneous plaque,1,2401,2400,13,12,419422,13.519935897435898
carvedilol,Cyst removal,1,2401,2400,25,24,419410,7.030166666666667
carvedilol,Cystopexy,1,2401,2400,6,5,419429,29.293680555555554
carvedilol,Cytomegalovirus Infections,1,2401,2400,48,47,419387,3.6613454861111108
carvedilol,Cytomegalovirus enterocolitis,1,2401,2400,7,6,419428,25.108809523809523
carvedilol,Cytomegalovirus viremia,3,2401,2398,82,79,419355,6.434523688439553
carvedilol,Decompression of median nerve,1,2401,2400,19,18,419416,9.250350877192982
carvedilol,Decreased body weight,1,2401,2400,16,15,419419,10.984869791666668
carvedilol,Decreased therapeutic response,1,2401,2400,8,7,419427,21.970156250000002
carvedilol,Decreased urine output,1,2401,2400,28,27,419407,6.276889880952381
carvedilol,Deep Vein Thrombosis,1,2401,2400,19,18,419416,9.250350877192982
carvedilol,Dentin Sensitivity,1,2401,2400,28,27,419407,6.276889880952381
carvedilol,Depressed Level of Consciousness,1,2401,2400,52,51,419383,3.3796714743589744
carvedilol,Dermabrasion,1,2401,2400,34,33,419401,5.169129901960784
carvedilol,Dermatologic disorders,1,2401,2400,34,33,419401,5.169129901960784
carvedilol,Device Failure,3,2401,2398,100,97,419337,5.276084236864053
carvedilol,Device related sepsis,1,2401,2400,31,30,419404,5.669408602150537
carvedilol,Diaphragmalgia,1,2401,2400,37,36,419398,4.7499774774774774
carvedilol,Difficulty standing,1,2401,2400,30,29,419405,5.858402777777777
carvedilol,Dilatation intrahepatic duct acquired,1,2401,2400,7,6,419428,25.108809523809523
carvedilol,Diplopia,2,2401,2399,7,5,419429,50.23855177752635
carvedilol,Disease of capillaries,2,2401,2399,42,40,419394,8.372397229004148
carvedilol,Disorder of tendon,1,2401,2400,25,24,419410,7.030166666666667
carvedilol,Disorder of vein,4,2401,2397,99,95,419339,7.108818683286769
carvedilol,Disseminated Intravascular Coagulation,1,2401,2400,42,41,419393,4.184454365079365
carvedilol,Documented hypersensitivity to administered drug,1,2401,2400,5,4,419430,35.1525
carvedilol,Drooling,1,2401,2400,34,33,419401,5.169129901960784
carvedilol,Drug action increased,1,2401,2400,52,51,419383,3.3796714743589744
carvedilol,Drug withdrawal syndrome,4,2401,2397,134,130,419304,5.251601815702464
carvedilol,Dry tongue,1,2401,2400,27,26,419408,6.509382716049383
carvedilol,Dysbacteriosis,1,2401,2400,18,17,419417,9.764282407407407
carvedilol,Dyspnea on exertion,1,2401,2400,18,17,419417,9.764282407407407
carvedilol,EKG: P wave abnormal,1,2401,2400,50,49,419385,3.514875
carvedilol,Edema,1,2401,2400,9,8,419426,19.52898148148148
carvedilol,Electrocardiogram QT borderline prolonged,1,2401,2400,7,6,419428,25.108809523809523
carvedilol,Electrocardiogram ST-T segment elevation,1,2401,2400,29,28,419406,6.060431034482758
carvedilol,Electrolyte imbalance,1,2401,2400,19,18,419416,9.250350877192982
carvedilol,Embolism,1,2401,2400,8,7,419427,21.970156250000002
carvedilol,Endodontic procedure,2,2401,2399,71,69,419365,4.952345167293885
carvedilol,Enterovesical Fistula,1,2401,2400,32,31,419403,5.4922265625
carvedilol,Eosinophilic gastroenteritis,1,2401,2400,33,32,419402,5.325782828282828
carvedilol,Epiglottitis,1,2401,2400,27,26,419408,6.509382716049383
carvedilol,Erythema Multiforme,1,2401,2400,25,24,419410,7.030166666666667
carvedilol,Eschar,1,2401,2400,25,24,419410,7.030166666666667
carvedilol,Essential Tremor,3,2401,2398,13,10,419424,40.59363572207609
carvedilol,Extrinsic allergic alveolitis,5,2401,2396,166,161,419273,5.300865398153549
carvedilol,Eyelid pain,2,2401,2399,76,74,419360,4.626478137820583
carvedilol,Facial Paresis,1,2401,2400,12,11,419423,14.646631944444444
carvedilol,Feeling of body temperature change,1,2401,2400,8,7,419427,21.970156250000002
carvedilol,Feels hot,1,2401,2400,39,38,419396,4.506367521367522
carvedilol,Female genital infection,1,2401,2400,14,13,419421,12.554196428571428
carvedilol,Fever,1,2401,2400,32,31,419403,5.4922265625
carvedilol,Fibrin D dimer increased,1,2401,2400,31,30,419404,5.669408602150537
carvedilol,Fibromuscular dysplasia of wall of renal artery,3,2401,2398,89,86,419348,5.928339159037026
carvedilol,First degree atrioventricular block,1,2401,2400,23,22,419412,7.641521739130434
carvedilol,Foaming at mouth,2,2401,2399,30,28,419406,11.721689592885925
carvedilol,"Fracture Fixation, Internal",1,2401,2400,16,15,419419,10.984869791666668
carvedilol,Fracture pain,1,2401,2400,44,43,419391,3.994232954545455
carvedilol,Functional Gastrointestinal Disorders,2,2401,2399,43,41,419393,8.177670928778463
carvedilol,Fungal pneumonia,1,2401,2400,8,7,419427,21.970156250000002
carvedilol,Gallstone ileus,2,2401,2399,88,86,419348,3.995481071658646
carvedilol,Gastric hemorrhage,1,2401,2400,42,41,419393,4.184454365079365
carvedilol,Gastric hypermotility,1,2401,2400,7,6,419428,25.108809523809523
carvedilol,Gastrointestinal erosion,1,2401,2400,38,37,419397,4.624967105263157
carvedilol,Gastrointestinal oedema,1,2401,2400,15,14,419420,11.717222222222222
carvedilol,Genital pain,1,2401,2400,11,10,419424,15.978181818181818
carvedilol,Genital rash,5,2401,2396,210,205,419229,4.18977064949519
carvedilol,Glycosuria,1,2401,2400,8,7,419427,21.970156250000002
carvedilol,Grandiose delusions,3,2401,2398,162,159,419275,3.256363327464245
carvedilol,Hay fever,3,2401,2398,22,19,419415,23.98663659109864
carvedilol,"Hearing Loss, Sudden",1,2401,2400,13,12,419422,13.519935897435898
carvedilol,"Heart Failure, Right-Sided",2,2401,2399,116,114,419320,3.030853372813385
carvedilol,Hematoma of kidney,1,2401,2400,17,16,419418,10.338676470588235
carvedilol,Hemodynamic instability,1,2401,2400,51,50,419384,3.4459477124183007
carvedilol,Hemorrhagic diarrhea,1,2401,2400,41,40,419394,4.286524390243902
carvedilol,Hernia of abdominal cavity,1,2401,2400,26,25,419409,6.759759615384616
carvedilol,Heterophoria,4,2401,2397,134,130,419304,5.251601815702464
carvedilol,Hodgkin Disease,2,2401,2399,62,60,419374,5.671355000067232
carvedilol,Hydrocele operation,1,2401,2400,44,43,419391,3.994232954545455
carvedilol,Hydrocephalus,1,2401,2400,8,7,419427,21.970156250000002
carvedilol,Hyperbilirubinemia,1,2401,2400,31,30,419404,5.669408602150537
carvedilol,Hyperglycaemic seizure,1,2401,2400,8,7,419427,21.970156250000002
carvedilol,Hyperkeratosis,1,2401,2400,16,15,419419,10.984869791666668
carvedilol,Hypermobility syndrome,1,2401,2400,7,6,419428,25.108809523809523
carvedilol,Hypersomnia,2,2401,2399,42,40,419394,8.372397229004148
carvedilol,Hypocalcemia,6,2401,2395,294,288,419146,3.592015678922926
carvedilol,Hypokalemia,17,2401,2384,982,965,418469,3.056058123402452
carvedilol,Hypoplasia of aorta,1,2401,2400,16,15,419419,10.984869791666668
carvedilol,"Hypotension, Orthostatic",2,2401,2399,38,36,419398,9.253789956341457
carvedilol,Hypothermia due to exposure,1,2401,2400,43,42,419392,4.087131782945736
carvedilol,Impaired exercise tolerance,3,2401,2398,84,81,419353,6.281290956749673
carvedilol,Impaired pupillary reflex,2,2401,2399,109,107,419327,3.225548871662887
carvedilol,Impetigo,2,2401,2399,51,49,419385,6.89476824493866
carvedilol,Implant site pain,1,2401,2400,35,34,419400,5.021428571428571
carvedilol,Infection caused by Enterobacter,1,2401,2400,53,52,419382,3.315896226415094
carvedilol,Infectious Mononucleosis,1,2401,2400,53,52,419382,3.315896226415094
carvedilol,Infective vaginitis,3,2401,2398,115,112,419322,4.58773615694238
carvedilol,Inflammatory disease of mucous membrane,3,2401,2398,140,137,419297,3.768274157035625
carvedilol,Inflammatory polyposis of intestine,1,2401,2400,5,4,419430,35.1525
carvedilol,Injection site mass,4,2401,2397,222,218,419216,3.1692242931291745
carvedilol,Injection site papule,3,2401,2398,122,119,419315,4.324433612710045
carvedilol,Injection site warmth,1,2401,2400,37,36,419398,4.7499774774774774
carvedilol,Instillation site pain,1,2401,2400,18,17,419417,9.764282407407407
carvedilol,Intentional overdose,1,2401,2400,36,35,419399,4.8819328703703695
carvedilol,Internal Carotid Artery Stenosis,2,2401,2399,99,97,419337,3.5514460991743197
carvedilol,Interstitial granulomatous dermatitis,1,2401,2400,40,39,419395,4.393697916666667
carvedilol,Intervertebral Disk Displacement,1,2401,2400,18,17,419417,9.764282407407407
carvedilol,Intestinal Polyps,4,2401,2397,161,157,419277,4.370618552693973
carvedilol,Intestinal gangrene,1,2401,2400,8,7,419427,21.970156250000002
carvedilol,Intestinal infarction,1,2401,2400,13,12,419422,13.519935897435898
carvedilol,Involuntary muscle contraction,1,2401,2400,52,51,419383,3.3796714743589744
carvedilol,Ischemia,2,2401,2399,64,62,419372,5.494099103793247
carvedilol,Itching of ear,1,2401,2400,5,4,419430,35.1525
carvedilol,Labile blood pressure,2,2401,2399,86,84,419350,4.088418624039086
carvedilol,Lack of libido,1,2401,2400,41,40,419394,4.286524390243902
carvedilol,Latent Tuberculosis,1,2401,2400,8,7,419427,21.970156250000002
carvedilol,Laziness,1,2401,2400,34,33,419401,5.169129901960784
carvedilol,Learning Disorders,1,2401,2400,52,51,419383,3.3796714743589744
carvedilol,"Leukemia, Myelocytic, Acute",1,2401,2400,48,47,419387,3.6613454861111108
carvedilol,Leukocytes in urine (finding),3,2401,2398,96,93,419341,5.495973206839032
carvedilol,Limb asymmetry,4,2401,2397,181,177,419257,3.8874928835998954
carvedilol,Lipoprotein (a) increased,2,2401,2399,33,31,419403,10.656005658923542
carvedilol,Liver damage,5,2401,2396,128,123,419311,6.875179335350584
carvedilol,Liver function tests abnormal,1,2401,2400,49,48,419386,3.586615646258503
carvedilol,Lymph Node Tuberculosis,2,2401,2399,104,102,419332,3.3806634174495787
carvedilol,Malignant neoplasm of thyroid,1,2401,2400,24,23,419411,7.323107638888888
carvedilol,Malignant neoplasm of tongue,1,2401,2400,54,53,419381,3.2544830246913574
carvedilol,Malignant neoplasm of urinary bladder,2,2401,2399,27,25,419409,13.024192178839947
carvedilol,Malnutrition,2,2401,2399,104,102,419332,3.3806634174495787
carvedilol,Melanocytic nevus,1,2401,2400,21,20,419414,8.369325396825396
carvedilol,Mental disorders,1,2401,2400,47,46,419388,3.739255319148936
carvedilol,Merkel cell carcinoma,1,2401,2400,17,16,419418,10.338676470588235
carvedilol,Metabolic Syndrome X,1,2401,2400,31,30,419404,5.669408602150537
carvedilol,Metastatic Renal Cell Carcinoma,3,2401,2398,62,59,419375,8.510580053270198
carvedilol,Metastatic malignant neoplasm to liver,2,2401,2399,88,86,419348,3.995481071658646
carvedilol,Metrorrhagia,1,2401,2400,20,19,419415,8.787812500000001
carvedilol,Milk-Alkali Syndrome,1,2401,2400,29,28,419406,6.060431034482758
carvedilol,Mitral Valve Prolapse Syndrome,2,2401,2399,78,76,419358,4.507829116832868
carvedilol,Muscle Weakness,1,2401,2400,46,45,419389,3.820552536231884
carvedilol,Muscle tone disorder,1,2401,2400,16,15,419419,10.984869791666668
carvedilol,Myocardial Ischemia,5,2401,2396,208,203,419231,4.230076971234109
carvedilol,Myoglobinuria,4,2401,2397,20,16,419418,35.195244055068834
carvedilol,Nasopharyngitis,1,2401,2400,19,18,419416,9.250350877192982
carvedilol,Nephrosclerosis,1,2401,2400,41,40,419394,4.286524390243902
carvedilol,Neuroendocrine Tumors,1,2401,2400,58,57,419377,3.030007183908046
carvedilol,Neutropenia,1,2401,2400,21,20,419414,8.369325396825396
carvedilol,Non-Infectious Cystitis,1,2401,2400,11,10,419424,15.978181818181818
carvedilol,Occupational exposure to communicable disease,1,2401,2400,36,35,419399,4.8819328703703695
carvedilol,Oesophageal irritation,1,2401,2400,18,17,419417,9.764282407407407
carvedilol,Optic Neuropathy,1,2401,2400,16,15,419419,10.984869791666668
carvedilol,Oral discharge,1,2401,2400,30,29,419405,5.858402777777777
carvedilol,Oral pain,2,2401,2399,39,37,419397,9.016491914366028
carvedilol,Osteoporosis,4,2401,2397,132,128,419306,5.33119682431322
carvedilol,Pain of skin,1,2401,2400,7,6,419428,25.108809523809523
carvedilol,Pancreatectomy,1,2401,2400,6,5,419429,29.293680555555554
carvedilol,Pancreatic Ductal Adenocarcinoma,3,2401,2398,21,18,419416,25.128916954605025
carvedilol,Papillary thyroid carcinoma,1,2401,2400,15,14,419420,11.717222222222222
carvedilol,Papilledema,1,2401,2400,12,11,419423,14.646631944444444
carvedilol,Pelvic Pain,1,2401,2400,18,17,419417,9.764282407407407
carvedilol,Pelvic discomfort,1,2401,2400,8,7,419427,21.970156250000002
carvedilol,Peripheral Ischemia,1,2401,2400,13,12,419422,13.519935897435898
carvedilol,Persistent Fetal Circulation Syndrome,1,2401,2400,12,11,419423,14.646631944444444
carvedilol,Personality Change,1,2401,2400,56,55,419379,3.138236607142857
carvedilol,Photophobia,2,2401,2399,69,67,419367,5.09591556868502
carvedilol,Piloerection,2,2401,2399,40,38,419396,8.791058774489372
carvedilol,Pneumocephalus,1,2401,2400,23,22,419412,7.641521739130434
carvedilol,"Pneumonia, Bacterial",2,2401,2399,79,77,419357,4.450757435851436
carvedilol,Polychondritis,1,2401,2400,56,55,419379,3.138236607142857
carvedilol,Polycystic liver disease,1,2401,2400,11,10,419424,15.978181818181818
carvedilol,Polymyalgia Rheumatica,1,2401,2400,43,42,419392,4.087131782945736
carvedilol,Polymyositis,1,2401,2400,7,6,419428,25.108809523809523
carvedilol,"Polyradiculoneuropathy, Chronic Inflammatory Demyelinating",1,2401,2400,28,27,419407,6.276889880952381
carvedilol,Portal Hypertension,5,2401,2396,274,269,419165,3.2106506586403127
carvedilol,Post procedural complication,1,2401,2400,53,52,419382,3.315896226415094
carvedilol,Procalcitonin increased,1,2401,2400,48,47,419387,3.6613454861111108
carvedilol,Product label issue,2,2401,2399,58,56,419378,6.062540426327062
carvedilol,Product shape issue,1,2401,2400,15,14,419420,11.717222222222222
carvedilol,Product taste abnormal,1,2401,2400,31,30,419404,5.669408602150537
carvedilol,Protein urine present,1,2401,2400,9,8,419426,19.52898148148148
carvedilol,Prothrombin consumption time shortened,1,2401,2400,56,55,419379,3.138236607142857
carvedilol,Pruritus Ani,1,2401,2400,30,29,419405,5.858402777777777
carvedilol,Pruritus of tongue,2,2401,2399,67,65,419369,5.248057337323387
carvedilol,Psychomotor Agitation,1,2401,2400,9,8,419426,19.52898148148148
carvedilol,Pulmonary Emphysema,1,2401,2400,44,43,419391,3.994232954545455
carvedilol,Pulmonary Fibrosis,1,2401,2400,24,23,419411,7.323107638888888
carvedilol,Pulmonary Hypertension,1,2401,2400,44,43,419391,3.994232954545455
carvedilol,"Radiculopathy, Cervical",1,2401,2400,31,30,419404,5.669408602150537
carvedilol,Recurrent Unspecified Lung Carcinoma,1,2401,2400,26,25,419409,6.759759615384616
carvedilol,Red blood cells urine positive,1,2401,2400,33,32,419402,5.325782828282828
carvedilol,Reduced visual acuity,3,2401,2398,161,158,419276,3.2765969570915723
carvedilol,Renal Insufficiency,23,2401,2378,907,884,418550,4.48865797558101
carvedilol,Renal Osteodystrophy,1,2401,2400,37,36,419398,4.7499774774774774
carvedilol,Renal transplant rejection,1,2401,2400,55,54,419380,3.19530303030303
carvedilol,Renal tubular disorder,1,2401,2400,19,18,419416,9.250350877192982
carvedilol,Renal vascular disorder,1,2401,2400,13,12,419422,13.519935897435898
carvedilol,Retinal Hemorrhage,2,2401,2399,33,31,419403,10.656005658923542
carvedilol,Rheumatoid Arthritis,1,2401,2400,47,46,419388,3.739255319148936
carvedilol,Right atrial dilatation,1,2401,2400,6,5,419429,29.293680555555554
carvedilol,Seborrheic dermatitis,1,2401,2400,31,30,419404,5.669408602150537
carvedilol,Seborrheic dermatitis of scalp,1,2401,2400,21,20,419414,8.369325396825396
carvedilol,Sensory disorder of eyelid,1,2401,2400,8,7,419427,21.970156250000002
carvedilol,Serotonin Syndrome,1,2401,2400,13,12,419422,13.519935897435898
carvedilol,Skin Induration,1,2401,2400,27,26,419408,6.509382716049383
carvedilol,Skin hemorrhages,3,2401,2398,106,103,419331,4.977367145577289
carvedilol,"Sleep disorder due to general medical condition, insomnia type",1,2401,2400,38,37,419397,4.624967105263157
carvedilol,Soft Tissue Neoplasms,1,2401,2400,5,4,419430,35.1525
carvedilol,Spontaneous abortion,3,2401,2398,174,171,419263,3.031700267464266
carvedilol,Squamous cell carcinoma of skin,1,2401,2400,42,41,419393,4.184454365079365
carvedilol,Staphylococcal Scalded Skin Syndrome,1,2401,2400,14,13,419421,12.554196428571428
carvedilol,Stenosis of intestine,1,2401,2400,6,5,419429,29.293680555555554
carvedilol,Stupor,1,2401,2400,7,6,419428,25.108809523809523
carvedilol,Surgical Wound Infection,1,2401,2400,12,11,419423,14.646631944444444
carvedilol,Surgical procedure on eye proper,1,2401,2400,12,11,419423,14.646631944444444
carvedilol,Swelling of skin,1,2401,2400,26,25,419409,6.759759615384616
carvedilol,Syringomyelia,1,2401,2400,31,30,419404,5.669408602150537
carvedilol,Takotsubo Cardiomyopathy,1,2401,2400,6,5,419429,29.293680555555554
carvedilol,Tarsal Tunnel Syndrome,1,2401,2400,42,41,419393,4.184454365079365
carvedilol,Thalamic hemorrhage,1,2401,2400,8,7,419427,21.970156250000002
carvedilol,Therapy change,1,2401,2400,28,27,419407,6.276889880952381
carvedilol,Tibial Fractures,1,2401,2400,22,21,419413,7.988882575757576
carvedilol,Tongue blistering,1,2401,2400,20,19,419415,8.787812500000001
carvedilol,Tooth Diseases,1,2401,2400,19,18,419416,9.250350877192982
carvedilol,Torsades de Pointes,1,2401,2400,44,43,419391,3.994232954545455
carvedilol,Toxicoderma,4,2401,2397,191,187,419247,3.6838718555262147
carvedilol,Tuberculosis,1,2401,2400,37,36,419398,4.7499774774774774
carvedilol,Tubular breast cancer stage I,1,2401,2400,8,7,419427,21.970156250000002
carvedilol,Tumor Progression,3,2401,2398,35,32,419402,15.076849755748837
carvedilol,Ulna Fractures,1,2401,2400,42,41,419393,4.184454365079365
carvedilol,Umbilical hemorrhage,2,2401,2399,91,89,419345,3.8637344314709887
carvedilol,Unilateral deafness,1,2401,2400,23,22,419412,7.641521739130434
carvedilol,Urinary tract obstruction,1,2401,2400,24,23,419411,7.323107638888888
carvedilol,Urine albumin/creatinine ratio increased,1,2401,2400,13,12,419422,13.519935897435898
carvedilol,Urine screening abnormal,1,2401,2400,52,51,419383,3.3796714743589744
carvedilol,Uveomeningoencephalitic Syndrome,1,2401,2400,11,10,419424,15.978181818181818
carvedilol,Vascular calcification,1,2401,2400,5,4,419430,35.1525
carvedilol,Vasculitis,3,2401,2398,127,124,419310,4.154131067227939
carvedilol,Vitamin B1 increased,1,2401,2400,35,34,419400,5.021428571428571
carvedilol,Vitamin D below reference range,1,2401,2400,57,56,419378,3.083172514619883
carvedilol,Vulvovaginal dryness,1,2401,2400,39,38,419396,4.506367521367522
carvedilol,Wheezing,3,2401,2398,160,157,419277,3.297083507089241
carvedilol,Wrist deformity,1,2401,2400,23,22,419412,7.641521739130434
carvedilol,furuncle,5,2401,2396,185,180,419254,4.756237873934034
carvedilol,hypoglycemic encephalopathy,1,2401,2400,14,13,419421,12.554196428571428
carvedilol,leukemia,1,2401,2400,41,40,419394,4.286524390243902
carvedilol,nail avulsion injury,1,2401,2400,30,29,419405,5.858402777777777
carvedilol,upper airway cough syndrome,3,2401,2398,54,51,419383,9.771592067463628
chlorthalidone,Abasia (gait ataxia),1,351,350,240,239,421245,5.018988095238095
chlorthalidone,Acquired phimosis,2,351,349,41,39,421445,58.95506324690754
chlorthalidone,Acrochordon excision,1,351,350,47,46,421438,25.640607902735564
chlorthalidone,Acute superior sagittal sinus thrombosis,1,351,350,25,24,421460,48.20685714285714
chlorthalidone,Amaurosis Fugax,1,351,350,68,67,421417,17.721302521008404
chlorthalidone,Amnesia,2,351,349,212,210,421274,11.397064388819809
chlorthalidone,Analgesic drug level increased,1,351,350,13,12,421472,92.70813186813187
chlorthalidone,"Anemia, Pernicious",1,351,350,91,90,421394,13.241569858712717
chlorthalidone,Anti-glomerular basement membrane antibody positive,1,351,350,329,328,421156,3.6604950065132438
chlorthalidone,Appendicitis,1,351,350,104,103,421381,11.586016483516484
chlorthalidone,Arteriosclerosis,1,351,350,10,9,421475,120.52142857142857
chlorthalidone,Arthralgia,1,351,350,118,117,421367,10.211065375302663
chlorthalidone,Arthropod bite,1,351,350,48,47,421437,25.106369047619044
chlorthalidone,Atrioventricular junctional rhythm,1,351,350,147,146,421338,8.196073858114675
chlorthalidone,Atrophic condition of skin,1,351,350,378,377,421107,3.1856160241874525
chlorthalidone,Avulsion fracture,1,351,350,107,106,421378,11.26109479305741
chlorthalidone,Bacterial Endocarditis,1,351,350,175,174,421310,6.884244897959184
chlorthalidone,Baresthesia,3,351,348,288,285,421199,12.61814535440613
chlorthalidone,Blepharoptosis,1,351,350,199,198,421286,6.053639626704953
chlorthalidone,Blood glucose outside reference range,2,351,349,668,666,420818,3.613120463943174
chlorthalidone,Blood thyroid stimulating hormone increased,1,351,350,27,26,421458,44.635767195767194
chlorthalidone,Brain Death,1,351,350,221,220,421264,5.450730446024564
chlorthalidone,Breast cancer stage II,1,351,350,134,133,421351,8.991492537313432
chlorthalidone,Cardiac enzymes increased,1,351,350,32,31,421453,37.660982142857144
chlorthalidone,Cardiovascular Diseases,1,351,350,246,245,421239,4.89650406504065
chlorthalidone,Cerebral Thrombosis,1,351,350,325,324,421160,3.7055824175824172
chlorthalidone,Cerebrovascular accident,1,351,350,23,22,421462,52.39900621118012
chlorthalidone,Clostridium difficile infection,5,351,346,1764,1759,419725,3.441264270640819
chlorthalidone,Corneal Diseases,1,351,350,251,250,421234,4.798907228229937
chlorthalidone,Coronary Artery Bypass Surgery,1,351,350,11,10,421474,109.56467532467533
chlorthalidone,Cytomegalovirus viremia,1,351,350,82,81,421403,14.695226480836238
chlorthalidone,De Quervain Disease,1,351,350,175,174,421310,6.884244897959184
chlorthalidone,Deglutition Disorders,1,351,350,144,143,421341,8.36688492063492
chlorthalidone,Delayed Ejaculation,1,351,350,43,42,421442,28.026046511627904
chlorthalidone,"Dermatitis, Phototoxic",4,351,347,1326,1322,420162,3.6556304632249708
chlorthalidone,Dilatation intrahepatic duct acquired,1,351,350,7,6,421478,172.17469387755102
chlorthalidone,Dilatation of aorta,2,351,349,308,306,421178,7.842946451828974
chlorthalidone,Discomfort in mouth,1,351,350,25,24,421460,48.20685714285714
chlorthalidone,Drug Allergy,1,351,350,223,222,421262,5.40181934657271
chlorthalidone,Drug action decreased,1,351,350,349,348,421136,3.450560785918952
chlorthalidone,Drug action increased,1,351,350,52,51,421433,23.17489010989011
chlorthalidone,Dysgraphia,1,351,350,248,247,421237,4.856993087557604
chlorthalidone,Dyskinetic syndrome,4,351,347,218,214,421270,22.294212516193852
chlorthalidone,Epicondylitis,1,351,350,132,131,421353,9.127770562770563
chlorthalidone,Euphoric mood,2,351,349,131,129,421355,18.447647586342658
chlorthalidone,Excessive tearing,1,351,350,15,14,421470,80.34666666666666
chlorthalidone,Exfoliative rash,1,351,350,277,276,421208,4.348200103145952
chlorthalidone,Extra dose administered,1,351,350,6,5,421479,200.87095238095236
chlorthalidone,Felty Syndrome,1,351,350,13,12,421472,92.70813186813187
chlorthalidone,Fracture of acetabulum,1,351,350,8,7,421477,150.6525
chlorthalidone,Gamma-Glutamyltransferase Increased,2,351,349,362,360,421124,6.672149313745666
chlorthalidone,Gastroenteritis,2,351,349,245,243,421241,9.861177708905913
chlorthalidone,Gingivitis,1,351,350,170,169,421315,7.086806722689076
chlorthalidone,Glaucoma,3,351,348,909,906,420578,3.9919388490573198
chlorthalidone,Hemorrhage,1,351,350,304,303,421181,3.9617575187969924
chlorthalidone,Hernia,2,351,349,690,688,420796,3.4977368049499606
chlorthalidone,Hiatal Hernia,1,351,350,46,45,421439,26.198074534161492
chlorthalidone,Hypercalcemia,1,351,350,36,35,421449,33.47611111111111
chlorthalidone,Hyperlipidemia,2,351,349,159,157,421327,15.197996071435009
chlorthalidone,Hypertrophy,1,351,350,122,121,421363,9.876182669789227
chlorthalidone,Hypoglycemia,4,351,347,1103,1099,420385,4.3970413412725575
chlorthalidone,Hyponatremia,6,351,345,941,935,420549,7.778847664371852
chlorthalidone,Hypophosphatemia,1,351,350,20,19,421465,60.25928571428572
chlorthalidone,Hypotension,8,351,343,2116,2108,419376,4.626353701080756
chlorthalidone,Hypoxia,1,351,350,324,323,421161,3.7170282186948853
chlorthalidone,Impaired exercise tolerance,1,351,350,84,83,421401,14.345272108843536
chlorthalidone,Inappropriate schedule of drug administration,1,351,350,139,138,421346,8.667954779033916
chlorthalidone,Infected dermal cyst,1,351,350,167,166,421318,7.214165953806672
chlorthalidone,Infectious Enterocolitis,2,351,349,650,648,420836,3.7133348027330837
chlorthalidone,Inflammatory disease of mucous membrane,1,351,350,140,139,421345,8.606020408163264
chlorthalidone,Injection site extravasation,1,351,350,323,322,421162,3.7285448916408668
chlorthalidone,Injection site induration,3,351,348,394,391,421093,9.22109662173989
chlorthalidone,Injection site mass,1,351,350,222,221,421263,5.426164736164736
chlorthalidone,Injection site papule,1,351,350,122,121,421363,9.876182669789227
chlorthalidone,International normalized ratio outside reference range,1,351,350,36,35,421449,33.47611111111111
chlorthalidone,Intracranial Hemorrhage,2,351,349,373,371,421113,6.4752145156210394
chlorthalidone,Itching of eye,1,351,350,73,72,421412,16.507318982387474
chlorthalidone,Laryngitis,1,351,350,221,220,421264,5.450730446024564
chlorthalidone,Lesion of liver,2,351,349,309,307,421177,7.817546202279282
chlorthalidone,"Leukemia, Myelocytic, Acute",1,351,350,48,47,421437,25.106369047619044
chlorthalidone,"Leukoencephalopathy, Progressive Multifocal",1,351,350,219,218,421266,5.500534898891063
chlorthalidone,Limb asymmetry,1,351,350,181,180,421304,6.65594317284925
chlorthalidone,Localized swelling,1,351,350,131,130,421354,9.197470010905125
chlorthalidone,Lung consolidation,1,351,350,51,50,421434,23.62935574229692
chlorthalidone,Lymphoma,2,351,349,255,253,421231,9.474240125849766
chlorthalidone,Malignant neoplasm of prostate,2,351,349,368,366,421118,6.563270835928741
chlorthalidone,Malignant neoplasm of ureter,1,351,350,132,131,421353,9.127770562770563
chlorthalidone,Mediastinal Diseases,2,351,349,278,276,421208,8.689925996165819
chlorthalidone,Meningitis herpes,1,351,350,53,52,421432,22.737574123989216
chlorthalidone,"Meningitis, Bacterial",1,351,350,28,27,421457,43.0415306122449
chlorthalidone,Mental disorder due to a general medical condition,1,351,350,338,337,421147,3.5629501267962804
chlorthalidone,Mitral Valve Insufficiency,2,351,349,84,82,421402,28.772752080775003
chlorthalidone,Movement Disorders,1,351,350,331,330,421154,3.638359948208891
chlorthalidone,Multiple sclerosis relapse,1,351,350,217,216,421268,5.551257406188282
chlorthalidone,Musculoskeletal stiffness,2,351,349,654,652,420832,3.6905882249853232
chlorthalidone,Neutrophil count decreased,2,351,349,567,565,420919,4.257748265389144
chlorthalidone,Obesity,1,351,350,22,21,421463,54.7809090909091
chlorthalidone,Obstruction of gallbladder,1,351,350,37,36,421448,32.57127413127413
chlorthalidone,Occult blood positive,1,351,350,161,160,421324,7.483123336291038
chlorthalidone,Oral candidiasis,1,351,350,48,47,421437,25.106369047619044
chlorthalidone,Oral infection,1,351,350,43,42,421442,28.026046511627904
chlorthalidone,Oral pain,1,351,350,39,38,421446,30.90080586080586
chlorthalidone,Oral paresthesia,1,351,350,73,72,421412,16.507318982387474
chlorthalidone,Osteopenia,1,351,350,151,150,421334,7.978883632923368
chlorthalidone,Osteoporosis,1,351,350,132,131,421353,9.127770562770563
chlorthalidone,Ovarian Diseases,1,351,350,227,226,421258,5.306582756450598
chlorthalidone,Pain in esophagus (finding),2,351,349,595,593,420891,4.057113963063736
chlorthalidone,Palpitations,1,351,350,351,350,421134,3.430883190883191
chlorthalidone,Pancreatitis,1,351,350,27,26,421458,44.635767195767194
chlorthalidone,Pancytopenia,1,351,350,233,232,421252,5.169858982219497
chlorthalidone,Peripheral arterial occlusive disease,1,351,350,147,146,421338,8.196073858114675
chlorthalidone,Polychondritis,1,351,350,56,55,421429,21.519336734693876
chlorthalidone,Polydipsia,1,351,350,152,151,421333,7.926372180451127
chlorthalidone,Pregnancy associated hypertension,1,351,350,52,51,421433,23.17489010989011
chlorthalidone,Primary sequestrum,1,351,350,17,16,421468,70.89378151260505
chlorthalidone,Pulmonary Edema,1,351,350,15,14,421470,80.34666666666666
chlorthalidone,Renal Insufficiency,3,351,348,907,904,420580,4.000760369539596
chlorthalidone,Renal Osteodystrophy,2,351,349,37,35,421449,65.32920312863007
chlorthalidone,Renal vasculitis,1,351,350,45,44,421440,26.780317460317463
chlorthalidone,Rupture iliac artery,1,351,350,178,177,421307,6.768170144462279
chlorthalidone,Scab,1,351,350,375,374,421110,3.2111238095238095
chlorthalidone,Scleritis,1,351,350,19,18,421466,63.43097744360902
chlorthalidone,Seborrheic dermatitis of scalp,1,351,350,21,20,421464,57.389659863945575
chlorthalidone,Seborrheic keratosis,1,351,350,97,96,421388,12.422326951399116
chlorthalidone,Sense of smell impaired,1,351,350,23,22,421462,52.39900621118012
chlorthalidone,"Shock, Traumatic",1,351,350,6,5,421479,200.87095238095236
chlorthalidone,Skin tag,1,351,350,110,109,421375,10.953896103896103
chlorthalidone,Small kidney,1,351,350,23,22,421462,52.39900621118012
chlorthalidone,Squamous cell carcinoma of the head and neck,1,351,350,15,14,421470,80.34666666666666
chlorthalidone,Staphylococcal Scalded Skin Syndrome,1,351,350,14,13,421471,86.08591836734693
chlorthalidone,Staphylococcal sepsis,2,351,349,146,144,421340,16.55175256113357
chlorthalidone,Strabismus,2,351,349,804,802,420682,3.0009764928936975
chlorthalidone,Sunburn,1,351,350,180,179,421305,6.692936507936508
chlorthalidone,Swelling,1,351,350,185,184,421300,6.511969111969113
chlorthalidone,Tarsal Tunnel Syndrome,1,351,350,42,41,421443,28.693401360544215
chlorthalidone,Thoracic Injuries,1,351,350,303,302,421182,3.974842055634135
chlorthalidone,Thrombosis of jugular vein,1,351,350,191,190,421294,6.307314884068812
chlorthalidone,Thyroid Diseases,1,351,350,155,154,421330,7.772903225806451
chlorthalidone,Tinea Pedis,1,351,350,359,358,421126,3.3543653004377236
chlorthalidone,Torsades de Pointes,1,351,350,44,43,421441,27.389025974025976
chlorthalidone,Trypanophobia,1,351,350,39,38,421446,30.90080586080586
chlorthalidone,Urinary bladder stone (disorder),3,351,348,198,195,421289,18.357584465343084
chlorthalidone,Uterine hemorrhage,1,351,350,329,328,421156,3.6604950065132438
chlorthalidone,VIIth nerve paralysis,1,351,350,88,87,421397,13.693084415584416
chlorthalidone,Vasculitis,1,351,350,127,126,421358,9.487244094488188
chlorthalidone,Venous Insufficiency,1,351,350,17,16,421468,70.89378151260505
chlorthalidone,Wound discharge finding,1,351,350,11,10,421474,109.56467532467533
chlorthalidone,Wound infection pseudomonas,1,351,350,27,26,421458,44.635767195767194
chlorthalidone,upper airway cough syndrome,1,351,350,54,53,421431,22.316455026455024
clonidine,Abasia (gait ataxia),5,2736,2731,240,235,418864,3.216121994385451
clonidine,Abnormal blood test,2,2736,2734,99,97,419002,3.1162835376441818
clonidine,Abnormal hair growth,1,2736,2735,23,22,419077,6.705540100151021
clonidine,Abnormal systolic arterial pressure,1,2736,2735,16,15,419084,9.63937385740402
clonidine,Abnormal ventricular axis,1,2736,2735,27,26,419073,5.712072584467466
clonidine,Abscess of limb,1,2736,2735,24,23,419076,6.426127361365021
clonidine,Absence of sensation,1,2736,2735,37,36,419063,4.168170364148426
clonidine,Absent response to treatment,1,2736,2735,5,4,419095,30.84680073126143
clonidine,"Acidosis, Respiratory",1,2736,2735,22,21,419078,7.010353997008476
clonidine,Acquired atrophy of ovary,2,2736,2734,21,19,419080,14.69376807050545
clonidine,Actinic keratosis,1,2736,2735,22,21,419078,7.010353997008476
clonidine,Acute Cholecystitis,3,2736,2733,31,28,419071,14.935873375588681
clonidine,Adrenal Cortical Adenoma,1,2736,2735,35,34,419065,4.406372420997649
clonidine,"Alkalosis, Respiratory",1,2736,2735,21,20,419079,7.344197788804735
clonidine,Allergy to arthropod sting,1,2736,2735,20,19,419080,7.711425959780622
clonidine,Altered state of consciousness,1,2736,2735,6,5,419094,25.705606337599022
clonidine,Aneurysm,1,2736,2735,10,9,419090,15.423217550274224
clonidine,"Angioedemas, Hereditary",1,2736,2735,22,21,419078,7.010353997008476
clonidine,Angioplasty renal artery,1,2736,2735,13,12,419087,11.86392912389256
clonidine,Anuria,3,2736,2733,93,90,419009,4.977892661969005
clonidine,Apathy,2,2736,2734,97,95,419004,3.1805518895315954
clonidine,Application site irritation,2,2736,2734,87,85,419014,3.546216650270329
clonidine,Application site pain,1,2736,2735,36,35,419064,4.2839630306723535
clonidine,Application site scar,2,2736,2734,15,13,419086,20.571567910265788
clonidine,Application site urticaria,1,2736,2735,33,32,419067,4.673447454434657
clonidine,Arnold Chiari Malformation,1,2736,2735,17,16,419083,9.072330358103022
clonidine,Arterial Injury,1,2736,2735,29,28,419071,5.318111328248125
clonidine,Arterial insufficiency,1,2736,2735,45,44,419055,3.4270972983952874
clonidine,Arteriopathic disease,1,2736,2735,50,49,419050,3.0843510054844607
clonidine,Aspiration Pneumonia,1,2736,2735,29,28,419071,5.318111328248125
clonidine,Ataxia,1,2736,2735,40,39,419060,3.855530164533821
clonidine,Atrial dilatation,1,2736,2735,7,6,419093,22.033324627840166
clonidine,Atrioventricular Block,1,2736,2735,27,26,419073,5.712072584467466
clonidine,Atypical fracture of femur,4,2736,2732,41,37,419062,15.062457593829233
clonidine,Aura,1,2736,2735,18,17,419082,8.568291692057688
clonidine,Avulsion fracture,4,2736,2732,107,103,418996,5.7706927929283935
clonidine,Bacillus test positive,1,2736,2735,27,26,419073,5.712072584467466
clonidine,Bacterial Endocarditis,4,2736,2732,175,171,418928,3.5277975318970927
clonidine,Bacterial osteomyelitis,1,2736,2735,38,37,419062,4.0584720484941785
clonidine,Bleeding ulcer,1,2736,2735,30,29,419070,5.140828762949421
clonidine,Blister rupture,1,2736,2735,8,7,419092,19.279113345521026
clonidine,Blood Transfusion,1,2736,2735,30,29,419070,5.140828762949421
clonidine,Blood count abnormal,2,2736,2734,27,25,419074,11.42832371508304
clonidine,Blood creatine decreased,2,2736,2734,5,3,419096,61.716166788588154
clonidine,Blood erythropoietin abnormal,1,2736,2735,18,17,419082,8.568291692057688
clonidine,Blood growth hormone increased,1,2736,2735,11,10,419089,14.021073624729933
clonidine,Blood parathyroid hormone increased,2,2736,2734,57,55,419044,5.413031481410182
clonidine,Blood triglycerides,3,2736,2733,10,7,419092,46.30351262349067
clonidine,Bone density abnormal,1,2736,2735,16,15,419084,9.63937385740402
clonidine,Bone necrosis,2,2736,2734,56,54,419045,5.509705820879924
clonidine,Bone pain,3,2736,2733,154,151,418948,3.0056951829728997
clonidine,Bradycardia,1,2736,2735,9,8,419091,17.136949014828357
clonidine,"Brain Diseases, Metabolic",1,2736,2735,7,6,419093,22.033324627840166
clonidine,Bronchiectasis,1,2736,2735,5,4,419095,30.84680073126143
clonidine,Bullous pemphigoid,1,2736,2735,19,18,419081,8.117309727701336
clonidine,Bundle-Branch Block,2,2736,2734,23,21,419078,13.415985496644508
clonidine,Bursitis,3,2736,2733,121,118,418981,3.8257296041948274
clonidine,C-reactive protein above reference range,3,2736,2733,46,43,419056,10.065121939579058
clonidine,CD4 Lymphocytes Decreased,2,2736,2734,65,63,419036,4.746722187834112
clonidine,CSF test abnormal,2,2736,2734,6,4,419095,51.43001706900756
clonidine,Calcified lymph nodes,2,2736,2734,27,25,419074,11.42832371508304
clonidine,Calcium deposits in tendon,2,2736,2734,65,63,419036,4.746722187834112
clonidine,Calcium pyrophosphate deposition disease,3,2736,2733,43,40,419059,10.76741633267812
clonidine,Capillary Leak Syndrome,1,2736,2735,47,46,419053,3.2812478120502546
clonidine,Cartilage Diseases,1,2736,2735,31,30,419069,4.974983782508699
clonidine,Catheter site inflammation,2,2736,2734,6,4,419095,51.43001706900756
clonidine,Celiac Disease,1,2736,2735,6,5,419094,25.705606337599022
clonidine,Cholecystitis infective,1,2736,2735,44,43,419056,3.504994183147748
clonidine,Cholelithiasis,3,2736,2733,153,150,418949,3.025347424004362
clonidine,Chronic Fatigue Syndrome,2,2736,2734,62,60,419039,4.976437690256507
clonidine,Clostridium difficile sepsis,1,2736,2735,51,50,419049,3.0238663655590203
clonidine,Colectomy,1,2736,2735,45,44,419055,3.4270972983952874
clonidine,Comatose,1,2736,2735,5,4,419095,30.84680073126143
clonidine,Complication of transplanted lung,1,2736,2735,48,47,419052,3.212880865326021
clonidine,Compression fracture of vertebral column,1,2736,2735,11,10,419089,14.021073624729933
clonidine,Congenital tricuspid valve incompetence,1,2736,2735,19,18,419081,8.117309727701336
clonidine,Constriction in throat,1,2736,2735,21,20,419079,7.344197788804735
clonidine,Coronary Arteriosclerosis,2,2736,2734,88,86,419013,3.5059104209616283
clonidine,Coronary Artery Bypass Surgery,2,2736,2734,11,9,419090,28.05240406996076
clonidine,Coronary Occlusion,1,2736,2735,24,23,419076,6.426127361365021
clonidine,Cushingoid,2,2736,2734,45,43,419056,6.8567016174916695
clonidine,Debridement of bone,1,2736,2735,5,4,419095,30.84680073126143
clonidine,Decreased Libido,1,2736,2735,24,23,419076,6.426127361365021
clonidine,Decreased thyroxine level,1,2736,2735,40,39,419060,3.855530164533821
clonidine,Deep Vein Thrombosis,2,2736,2734,19,17,419082,16.24055750202133
clonidine,Deformity of knee joint,1,2736,2735,41,40,419059,3.7614839256253627
clonidine,Dental abscess,1,2736,2735,15,14,419085,10.282023156611821
clonidine,Dental alveolar anomaly,1,2736,2735,7,6,419093,22.033324627840166
clonidine,Dermatologic disorders,1,2736,2735,34,33,419066,4.5359823636950205
clonidine,Deviated nasal septum,2,2736,2734,11,9,419090,28.05240406996076
clonidine,Dilatation of pulmonary artery (disorder),2,2736,2734,7,5,419094,44.08276726930713
clonidine,Discomfort,2,2736,2734,53,51,419048,5.821617368980414
clonidine,Disease Exacerbation,2,2736,2734,71,69,419030,4.345528915997815
clonidine,Disorder of tympanic membrane,1,2736,2735,37,36,419063,4.168170364148426
clonidine,Diverticulum,4,2736,2732,66,62,419037,9.35642663827144
clonidine,Drooling,1,2736,2735,34,33,419066,4.5359823636950205
clonidine,Drug Tolerance,1,2736,2735,11,10,419089,14.021073624729933
clonidine,Drug action decreased,9,2736,2727,349,340,418759,3.985796287365126
clonidine,Drug effect delayed,2,2736,2734,66,64,419035,4.674791070913968
clonidine,Drug screen positive,1,2736,2735,17,16,419083,9.072330358103022
clonidine,Dysentery,1,2736,2735,28,27,419072,5.508056933925307
clonidine,Dysgraphia,8,2736,2728,248,240,418859,4.9851835209535516
clonidine,Dyskinetic syndrome,9,2736,2727,218,209,418890,6.3829139794713425
clonidine,Edema of the tongue,2,2736,2734,24,22,419077,12.856955620580345
clonidine,Electrocardiogram R on T phenomenon,2,2736,2734,13,11,419088,23.736537054752127
clonidine,Epilepsy,3,2736,2733,101,98,419001,4.5835171881622845
clonidine,Excessive periungual granulation tissue,2,2736,2734,51,49,419050,6.04994477674025
clonidine,Exposure during breast feeding,1,2736,2735,7,6,419093,22.033324627840166
clonidine,Eye oedema,1,2736,2735,48,47,419052,3.212880865326021
clonidine,Facet joint pain,1,2736,2735,24,23,419076,6.426127361365021
clonidine,Febrile infection,1,2736,2735,16,15,419084,9.63937385740402
clonidine,Female infertility,1,2736,2735,5,4,419095,30.84680073126143
clonidine,Fibrin D dimer increased,1,2736,2735,31,30,419069,4.974983782508699
clonidine,Fibromyalgia,4,2736,2732,195,191,418908,3.1658219769493563
clonidine,Fine motor delay,1,2736,2735,17,16,419083,9.072330358103022
clonidine,Fissure in skin,8,2736,2728,401,393,418706,3.081987114325623
clonidine,Foaming at mouth,1,2736,2735,30,29,419070,5.140828762949421
clonidine,Focal Infection,1,2736,2735,13,12,419087,11.86392912389256
clonidine,Food intolerance (disorder),2,2736,2734,80,78,419021,3.85657461594733
clonidine,Foot Deformities,3,2736,2733,148,145,418954,3.127592191532916
clonidine,"Fracture Fixation, Internal",1,2736,2735,16,15,419084,9.63937385740402
clonidine,Fracture of cervical spine,1,2736,2735,25,24,419075,6.1690676416819015
clonidine,Fracture of pelvis,2,2736,2734,19,17,419082,16.24055750202133
clonidine,Gastric infection,1,2736,2735,42,41,419058,3.671916079045878
clonidine,Gastric mucosal lesion,1,2736,2735,8,7,419092,19.279113345521026
clonidine,Gastrointestinal inflammation,2,2736,2734,89,87,419012,3.46650994961492
clonidine,Gastrointestinal sounds abnormal,1,2736,2735,29,28,419071,5.318111328248125
clonidine,General symptom,1,2736,2735,31,30,419069,4.974983782508699
clonidine,Genital rash,5,2736,2731,210,205,418894,3.6758295408972814
clonidine,Genital swelling,1,2736,2735,17,16,419083,9.072330358103022
clonidine,Gingiva operations,2,2736,2734,61,59,419040,5.05803062827539
clonidine,Glioblastoma,1,2736,2735,5,4,419095,30.84680073126143
clonidine,Glycosuria,1,2736,2735,8,7,419092,19.279113345521026
clonidine,Granuloma,2,2736,2734,42,40,419059,7.34651827080503
clonidine,Gum Infection,1,2736,2735,37,36,419063,4.168170364148426
clonidine,Haematotoxicity,1,2736,2735,27,26,419073,5.712072584467466
clonidine,Haemorrhage urinary tract,6,2736,2730,33,27,419072,28.09204129204129
clonidine,Hamman-Rich syndrome,1,2736,2735,6,5,419094,25.705606337599022
clonidine,Hematological Disease,1,2736,2735,9,8,419091,17.136949014828357
clonidine,Hematoma of kidney,1,2736,2735,17,16,419083,9.072330358103022
clonidine,Hemorrhage of kidney,1,2736,2735,11,10,419089,14.021073624729933
clonidine,Hemorrhage of tongue,1,2736,2735,17,16,419083,9.072330358103022
clonidine,Hemorrhagic Stroke,4,2736,2732,68,64,419035,9.081194556885713
clonidine,Henoch-Schonlein purpura nephritis,1,2736,2735,8,7,419092,19.279113345521026
clonidine,Hiatal Hernia,2,2736,2734,46,44,419055,6.707626983874558
clonidine,Hunger,1,2736,2735,27,26,419073,5.712072584467466
clonidine,Hydrocephalus,1,2736,2735,8,7,419092,19.279113345521026
clonidine,Hydrops Fetalis,1,2736,2735,6,5,419094,25.705606337599022
clonidine,Hypercalcemia,2,2736,2734,36,34,419065,8.571059904088434
clonidine,Hypergammaglobulinemia,3,2736,2733,63,60,419039,7.348840450926071
clonidine,Hyperparathyroidism,2,2736,2734,29,27,419072,10.640113008601771
clonidine,Hyperproteinemia,1,2736,2735,18,17,419082,8.568291692057688
clonidine,Hyperuricemia,1,2736,2735,19,18,419081,8.117309727701336
clonidine,Hypomagnesemia,1,2736,2735,35,34,419065,4.406372420997649
clonidine,Hypophagia,2,2736,2734,29,27,419072,10.640113008601771
clonidine,Hypovolemic Shock,3,2736,2733,78,75,419024,5.935390807509359
clonidine,INR Increased,5,2736,2731,57,52,419047,13.54744422388817
clonidine,Immunosuppressant drug level increased,1,2736,2735,16,15,419084,9.63937385740402
clonidine,Impaired exercise tolerance,2,2736,2734,84,82,419017,3.672893370954819
clonidine,Incisional hernia,1,2736,2735,24,23,419076,6.426127361365021
clonidine,Incorrect drug dosage form administered,3,2736,2733,28,25,419074,16.536263133134703
clonidine,Incorrect product storage,1,2736,2735,18,17,419082,8.568291692057688
clonidine,Increased appetite (finding),2,2736,2734,79,77,419022,3.90540127600863
clonidine,Increased blood viscosity (finding),1,2736,2735,42,41,419058,3.671916079045878
clonidine,Infantile apnoeic attack,1,2736,2735,30,29,419070,5.140828762949421
clonidine,Infarction of basal ganglia,1,2736,2735,7,6,419093,22.033324627840166
clonidine,"Infarction, Lacunar",1,2736,2735,18,17,419082,8.568291692057688
clonidine,Infective conjunctivitis,3,2736,2733,35,32,419067,13.228790967539597
clonidine,Infective vaginitis,5,2736,2731,115,110,418989,6.713896804801554
clonidine,Inflammatory pain,1,2736,2735,32,31,419068,4.819504113345521
clonidine,Inguinal pain,1,2736,2735,19,18,419081,8.117309727701336
clonidine,Injection site discolouration,1,2736,2735,35,34,419065,4.406372420997649
clonidine,Injection site warmth,1,2736,2735,37,36,419063,4.168170364148426
clonidine,Internal Carotid Artery Stenosis,2,2736,2734,99,97,419002,3.1162835376441818
clonidine,Intervertebral disc disorder,2,2736,2734,62,60,419039,4.976437690256507
clonidine,Intestinal Obstruction,1,2736,2735,33,32,419067,4.673447454434657
clonidine,Ischemic cardiomyopathy,1,2736,2735,14,13,419086,11.016479498563593
clonidine,Jaw Diseases,4,2736,2732,17,13,419086,36.329170614072865
clonidine,Joint Range of Motion Decreased,3,2736,2733,104,101,418998,4.45126868192181
clonidine,Kidney Diseases,2,2736,2734,21,19,419080,14.69376807050545
clonidine,Kidney Failure,2,2736,2734,28,26,419073,11.02014317065524
clonidine,Klebsiella test positive,1,2736,2735,32,31,419068,4.819504113345521
clonidine,Knee Replacement Arthroplasty,1,2736,2735,51,50,419049,3.0238663655590203
clonidine,Labyrinthitis,3,2736,2733,91,88,419011,5.087321021459331
clonidine,Lack of libido,4,2736,2732,41,37,419062,15.062457593829233
clonidine,Lacrimal haemorrhage,1,2736,2735,43,42,419057,3.5865141788189274
clonidine,Laminoplasty,1,2736,2735,5,4,419095,30.84680073126143
clonidine,Laziness,1,2736,2735,34,33,419066,4.5359823636950205
clonidine,Left atrial dilatation,2,2736,2734,45,43,419056,6.8567016174916695
clonidine,Leiomyosarcoma of uterus,2,2736,2734,73,71,419028,4.226453287370605
clonidine,Leukaemia recurrent,2,2736,2734,7,5,419094,44.08276726930713
clonidine,Lichen Planus,1,2736,2735,21,20,419079,7.344197788804735
clonidine,Ligament injury,3,2736,2733,104,101,418998,4.45126868192181
clonidine,Limb asymmetry,6,2736,2730,181,175,418924,5.119956286807115
clonidine,Liquid product physical issue,3,2736,2733,99,96,419003,4.676135670647196
clonidine,Liver Cirrhosis,2,2736,2734,68,66,419033,4.537275700331339
clonidine,Liver damage,4,2736,2732,128,124,418975,4.823698297950219
clonidine,Liver function tests abnormal,1,2736,2735,49,48,419051,3.1473044062231836
clonidine,Liver mass,2,2736,2734,67,65,419034,4.605007151513828
clonidine,Localized swelling,3,2736,2733,131,128,418971,3.533605382894395
clonidine,Lordosis,1,2736,2735,5,4,419095,30.84680073126143
clonidine,Loss of job,3,2736,2733,77,74,419025,6.012488060786634
clonidine,Low density lipoprotein increased,1,2736,2735,26,25,419074,5.931781746589791
clonidine,Lumpectomy of breast,1,2736,2735,37,36,419063,4.168170364148426
clonidine,"Lupus Erythematosus, Systemic",1,2736,2735,6,5,419094,25.705606337599022
clonidine,Lupus Nephritis,2,2736,2734,7,5,419094,44.08276726930713
clonidine,Mastication disorder,4,2736,2732,165,161,418938,3.7416921780025736
clonidine,Meningitis herpes,2,2736,2734,53,51,419048,5.821617368980414
clonidine,Metabolic Syndrome X,1,2736,2735,31,30,419069,4.974983782508699
clonidine,Metastatic malignant neoplasm to bone,3,2736,2733,25,22,419077,18.520746432491766
clonidine,Metastatic malignant neoplasm to spleen,1,2736,2735,24,23,419076,6.426127361365021
clonidine,Mitral Valve Prolapse Syndrome,2,2736,2734,78,76,419023,3.9554799017125277
clonidine,Mucosal atrophy,1,2736,2735,11,10,419089,14.021073624729933
clonidine,Mucosal discolouration,2,2736,2734,13,11,419088,23.736537054752127
clonidine,Multimorbidity,1,2736,2735,8,7,419092,19.279113345521026
clonidine,Musculoskeletal discomfort,3,2736,2733,112,109,418990,4.13324251215305
clonidine,Mutism,1,2736,2735,10,9,419090,15.423217550274224
clonidine,Myeloproliferative disease,2,2736,2734,58,56,419043,5.31969073985319
clonidine,Neonatal cyanosis,1,2736,2735,36,35,419064,4.2839630306723535
clonidine,Neonatal disorder,1,2736,2735,5,4,419095,30.84680073126143
clonidine,Neurectomy,1,2736,2735,5,4,419095,30.84680073126143
clonidine,Nikolsky sign,1,2736,2735,14,13,419086,11.016479498563593
clonidine,No reaction on previous exposure to drug,3,2736,2733,151,148,418951,3.0654327898168816
clonidine,Nocturia,2,2736,2734,23,21,419078,13.415985496644508
clonidine,Nodular regenerative hyperplasia,1,2736,2735,36,35,419064,4.2839630306723535
clonidine,Nose Diseases,2,2736,2734,37,35,419064,8.339389865359141
clonidine,Nuclear magnetic resonance imaging spinal abnormal,3,2736,2733,88,85,419014,5.2607898413331995
clonidine,Obesity,1,2736,2735,22,21,419078,7.010353997008476
clonidine,Obstruction of gallbladder,2,2736,2734,37,35,419064,8.339389865359141
clonidine,Ocular icterus,1,2736,2735,15,14,419085,10.282023156611821
clonidine,Operation on gallbladder,3,2736,2733,17,14,419085,27.236908374765935
clonidine,Operative procedure on knee,2,2736,2734,85,83,419016,3.6296742544859932
clonidine,Oral Surgical Procedures,1,2736,2735,8,7,419092,19.279113345521026
clonidine,Oropharyngeal discomfort,3,2736,2733,48,45,419054,9.64569612147823
clonidine,Osteonecrosis of Jaw,4,2736,2732,143,139,418960,4.31756237905579
clonidine,Osteopenia,4,2736,2732,151,147,418952,4.088739782610804
clonidine,Ovarian Cysts,1,2736,2735,7,6,419093,22.033324627840166
clonidine,Pain of skin,1,2736,2735,7,6,419093,22.033324627840166
clonidine,"Pain, Procedural",1,2736,2735,42,41,419058,3.671916079045878
clonidine,Pallor of skin,1,2736,2735,26,25,419074,5.931781746589791
clonidine,Pancreatic Ductal Adenocarcinoma,3,2736,2733,21,18,419081,22.04871674245988
clonidine,Pancreatic duct obstruction,2,2736,2734,19,17,419082,16.24055750202133
clonidine,Panic,4,2736,2732,195,191,418908,3.1658219769493563
clonidine,Parainfluenza Virus Infections,1,2736,2735,11,10,419089,14.021073624729933
clonidine,Paranoia,2,2736,2734,76,74,419025,4.059590728833789
clonidine,Patient-device incompatibility,1,2736,2735,10,9,419090,15.423217550274224
clonidine,Pericarditis,2,2736,2734,42,40,419059,7.34651827080503
clonidine,Peritoneal effluent abnormal,1,2736,2735,8,7,419092,19.279113345521026
clonidine,Peritonitis,2,2736,2734,70,68,419031,4.407618350924862
clonidine,Peritonsillar Abscess,2,2736,2734,7,5,419094,44.08276726930713
clonidine,Phlebitis,2,2736,2734,27,25,419074,11.42832371508304
clonidine,Phonophobia,1,2736,2735,6,5,419094,25.705606337599022
clonidine,Pneumococcal sepsis,2,2736,2734,31,29,419070,9.953606909408405
clonidine,Pneumonitis,2,2736,2734,55,53,419046,5.60989559087584
clonidine,Pneumothorax,2,2736,2734,31,29,419070,9.953606909408405
clonidine,Polycystic liver disease,1,2736,2735,11,10,419089,14.021073624729933
clonidine,Polycythemia,1,2736,2735,24,23,419076,6.426127361365021
clonidine,Polydipsia,4,2736,2732,152,148,418951,4.061830546351237
clonidine,Polymenorrhea,3,2736,2733,51,48,419051,9.078237661694754
clonidine,Polymyalgia Rheumatica,3,2736,2733,43,40,419059,10.76741633267812
clonidine,Polyneuropathy,3,2736,2733,52,49,419050,8.903635058684456
clonidine,Polyp of nasal sinus,2,2736,2734,9,7,419092,34.2864342030399
clonidine,Polyp of vocal cord,1,2736,2735,15,14,419085,10.282023156611821
clonidine,Poor quality drug administered,1,2736,2735,18,17,419082,8.568291692057688
clonidine,Post-Traumatic Stress Disorder,1,2736,2735,5,4,419095,30.84680073126143
clonidine,Postmenopausal bleeding,1,2736,2735,6,5,419094,25.705606337599022
clonidine,"Pregnancy, Twin",1,2736,2735,13,12,419087,11.86392912389256
clonidine,Prescribed overdose,5,2736,2731,253,248,418851,3.0507726397112354
clonidine,Procedural nausea,1,2736,2735,12,11,419088,12.852620353443022
clonidine,Product label issue,2,2736,2734,58,56,419043,5.31969073985319
clonidine,Product physical issue,1,2736,2735,15,14,419085,10.282023156611821
clonidine,Product taste abnormal,1,2736,2735,31,30,419069,4.974983782508699
clonidine,Prolapse of urethra,1,2736,2735,27,26,419073,5.712072584467466
clonidine,Pruritus Ani,1,2736,2735,30,29,419070,5.140828762949421
clonidine,Pruritus of genital organs,1,2736,2735,14,13,419086,11.016479498563593
clonidine,Pseudoaneurysm,1,2736,2735,6,5,419094,25.705606337599022
clonidine,Psoriasis,1,2736,2735,21,20,419079,7.344197788804735
clonidine,Pulmonary Hypertension,2,2736,2734,44,42,419057,7.012552370818647
clonidine,Pure Red-Cell Aplasia,2,2736,2734,23,21,419078,13.415985496644508
clonidine,Rectal hemorrhage,1,2736,2735,43,42,419057,3.5865141788189274
clonidine,Reduction of dislocation,1,2736,2735,15,14,419085,10.282023156611821
clonidine,Renal Osteodystrophy,1,2736,2735,37,36,419063,4.168170364148426
clonidine,Renal aneurysm,1,2736,2735,9,8,419091,17.136949014828357
clonidine,Renal transplant rejection,3,2736,2733,55,52,419047,8.41792236303762
clonidine,Respiratory tract infection bacterial,1,2736,2735,14,13,419086,11.016479498563593
clonidine,Rest Dyspnea,2,2736,2734,57,55,419044,5.413031481410182
clonidine,Resuscitation (procedure),1,2736,2735,7,6,419093,22.033324627840166
clonidine,Retching,8,2736,2728,365,357,418742,3.386253163539951
clonidine,Retinal Diseases,1,2736,2735,13,12,419087,11.86392912389256
clonidine,Retinal Neovascularization,1,2736,2735,7,6,419093,22.033324627840166
clonidine,Retinal artery embolism,1,2736,2735,21,20,419079,7.344197788804735
clonidine,Retinal migraine,1,2736,2735,7,6,419093,22.033324627840166
clonidine,Retinal scar,1,2736,2735,8,7,419092,19.279113345521026
clonidine,Retinal vascular thrombosis,1,2736,2735,8,7,419092,19.279113345521026
clonidine,Retinitis,1,2736,2735,20,19,419080,7.711425959780622
clonidine,Retroperitoneal hematoma,1,2736,2735,18,17,419082,8.568291692057688
clonidine,Rheumatoid Arthritis,2,2736,2734,47,45,419054,6.564895951687963
clonidine,Rheumatoid lung disease,3,2736,2733,85,82,419017,5.446503519080519
clonidine,Right Ventricular Hypertrophy,2,2736,2734,19,17,419082,16.24055750202133
clonidine,Rotator cuff syndrome,4,2736,2732,188,184,418915,3.2837528425905735
clonidine,Rupture of tendon,1,2736,2735,47,46,419053,3.2812478120502546
clonidine,Sarcoidosis,2,2736,2734,57,55,419044,5.413031481410182
clonidine,Scleroderma,1,2736,2735,9,8,419091,17.136949014828357
clonidine,"Scoliosis, unspecified",7,2736,2729,191,184,418915,5.662484963711464
clonidine,Scratch marks,2,2736,2734,8,6,419093,38.57232991953182
clonidine,Seborrheic dermatitis of scalp,1,2736,2735,21,20,419079,7.344197788804735
clonidine,Secretion discharge,1,2736,2735,5,4,419095,30.84680073126143
clonidine,Sialadenitis,2,2736,2734,70,68,419031,4.407618350924862
clonidine,Sinoatrial Block,2,2736,2734,19,17,419082,16.24055750202133
clonidine,Sinus rhythm,2,2736,2734,6,4,419095,51.43001706900756
clonidine,Skin lesion,1,2736,2735,28,27,419072,5.508056933925307
clonidine,Skin neoplasm bleeding,1,2736,2735,16,15,419084,9.63937385740402
clonidine,Skin neoplasm excision,1,2736,2735,10,9,419090,15.423217550274224
clonidine,Sleep Apnea Syndromes,15,2736,2721,593,578,418521,3.9159730111127433
clonidine,"Sleep Disorders, Circadian Rhythm",1,2736,2735,13,12,419087,11.86392912389256
clonidine,Slow shallow breathing,1,2736,2735,42,41,419058,3.671916079045878
clonidine,Small bowel angioedema,1,2736,2735,21,20,419079,7.344197788804735
clonidine,Snoring,2,2736,2734,15,13,419086,20.571567910265788
clonidine,Somnolence,8,2736,2728,228,220,418879,5.422737562381026
clonidine,Sopor,1,2736,2735,6,5,419094,25.705606337599022
clonidine,Steroid withdrawal syndrome,1,2736,2735,25,24,419075,6.1690676416819015
clonidine,Stevens-Johnson Syndrome,1,2736,2735,14,13,419086,11.016479498563593
clonidine,Streptococcal urinary tract infection,1,2736,2735,10,9,419090,15.423217550274224
clonidine,Stupor,1,2736,2735,7,6,419093,22.033324627840166
clonidine,Subclavian artery embolism,1,2736,2735,39,38,419061,3.954399287488867
clonidine,Substance Abuse Problems,4,2736,2732,123,119,418980,5.0198431120475195
clonidine,Suture rupture,1,2736,2735,34,33,419066,4.5359823636950205
clonidine,Swallowing painful,2,2736,2734,44,42,419057,7.012552370818647
clonidine,Swelling of skin,2,2736,2734,26,24,419075,11.867902762928367
clonidine,T-Lymphocytopenia,1,2736,2735,48,47,419052,3.212880865326021
clonidine,"Tachycardia, Ventricular",1,2736,2735,33,32,419067,4.673447454434657
clonidine,Temperature intolerance,1,2736,2735,40,39,419060,3.855530164533821
clonidine,Termination of pregnancy (procedure),2,2736,2734,39,37,419062,7.911691332320447
clonidine,Tooth Avulsion,2,2736,2734,37,35,419064,8.339389865359141
clonidine,Trigger Finger Disorder,2,2736,2734,88,86,419013,3.5059104209616283
clonidine,Troponin I increased,5,2736,2731,35,30,419069,22.064131401370506
clonidine,Troponin increased,1,2736,2735,35,34,419065,4.406372420997649
clonidine,"Tuberculosis, Bovine",1,2736,2735,32,31,419068,4.819504113345521
clonidine,Ultrasound liver abnormal,1,2736,2735,41,40,419059,3.7614839256253627
clonidine,Umbilical erythema,1,2736,2735,8,7,419092,19.279113345521026
clonidine,Underweight,1,2736,2735,10,9,419090,15.423217550274224
clonidine,Unilateral deafness,2,2736,2734,23,21,419078,13.415985496644508
clonidine,Urethral Obstruction,1,2736,2735,20,19,419080,7.711425959780622
clonidine,Urinary bladder stone (disorder),5,2736,2731,198,193,418906,3.8987180482969572
clonidine,Urinary tract obstruction,2,2736,2734,24,22,419077,12.856955620580345
clonidine,Urine osmolarity decreased,1,2736,2735,20,19,419080,7.711425959780622
clonidine,Urinoma,1,2736,2735,18,17,419082,8.568291692057688
clonidine,Uterine Cervicitis,2,2736,2734,9,7,419092,34.2864342030399
clonidine,Uterine Diseases,1,2736,2735,8,7,419092,19.279113345521026
clonidine,VIIth nerve paralysis,3,2736,2733,88,85,419014,5.2607898413331995
clonidine,Vascular insufficiency of intestine,1,2736,2735,27,26,419073,5.712072584467466
clonidine,Vasculitis,5,2736,2731,127,122,418977,6.079339862817404
clonidine,Ventricular arrhythmia,1,2736,2735,16,15,419084,9.63937385740402
clonidine,Very low density lipoprotein decreased,1,2736,2735,13,12,419087,11.86392912389256
clonidine,Viral Encephalitis,1,2736,2735,11,10,419089,14.021073624729933
clonidine,Viral gastroenteritis,1,2736,2735,23,22,419077,6.705540100151021
clonidine,Vocal Cord Paralysis,1,2736,2735,8,7,419092,19.279113345521026
clonidine,Vulvovaginal discomfort,1,2736,2735,17,16,419083,9.072330358103022
clonidine,Vulvovaginal mycotic infection,1,2736,2735,39,38,419061,3.954399287488867
clonidine,Walking aid user,5,2736,2731,150,145,418954,5.14689368973514
clonidine,Weight decrease neonatal,1,2736,2735,10,9,419090,15.423217550274224
clonidine,White matter lesion,2,2736,2734,91,89,419010,3.3903068401971113
clonidine,Wound closure,2,2736,2734,70,68,419031,4.407618350924862
clonidine,Wrong technique in drug usage process,1,2736,2735,48,47,419052,3.212880865326021
clonidine,muscle injury,5,2736,2731,106,101,418998,7.284100094650519
clonidine,stage IV pancreatic cancer,1,2736,2735,5,4,419095,30.84680073126143
clonidine,tissue injury of lip (physical finding),3,2736,2733,82,79,419020,5.645806002516666
clonidine,treatment failure,2,2736,2734,63,61,419038,4.897435004238223
clonidine,upper airway cough syndrome,3,2736,2733,54,51,419048,8.573830141887221
diltiazem,APACHE II score increased,1,4184,4183,18,17,417634,5.602265784790289
diltiazem,Abdominal adhesions,1,4184,4183,18,17,417634,5.602265784790289
diltiazem,Abnormal thyroxine,1,4184,4183,6,5,417646,16.807275480117937
diltiazem,Abscess of peritoneum,1,4184,4183,12,11,417640,8.4035182086222
diltiazem,Activities of daily living impaired,4,4184,4180,114,110,417541,3.5400067153529755
diltiazem,Acute Promyelocytic Leukemia,1,4184,4183,17,16,417635,5.931824893476396
diltiazem,Acute left ventricular failure,1,4184,4183,10,9,417642,10.084269662921349
diltiazem,Acute pulmonary edema,1,4184,4183,12,11,417640,8.4035182086222
diltiazem,Adams-Stokes Syndrome,1,4184,4183,25,24,417627,4.033564427444418
diltiazem,Adenoidal disorder,1,4184,4183,15,14,417637,6.722766754323054
diltiazem,Adrenal cyst,1,4184,4183,5,4,417647,20.168778388716234
diltiazem,"Alcoholic Intoxication, Chronic",2,4184,4182,14,12,417639,14.409407665505226
diltiazem,Alopecia Areata,1,4184,4183,6,5,417646,16.807275480117937
diltiazem,Anal abscess,2,4184,4182,37,35,417616,5.451911021494952
diltiazem,Animal scratch,2,4184,4182,46,44,417607,4.3851392094483606
diltiazem,Ankle deformity,2,4184,4182,67,65,417586,3.0105426954181747
diltiazem,Ankylosing spondylitis,1,4184,4183,13,12,417639,7.757075341584067
diltiazem,Anti-neutrophil cytoplasmic antibody positive vasculitis,1,4184,4183,18,17,417634,5.602265784790289
diltiazem,Anti-nuclear factor positive,1,4184,4183,12,11,417640,8.4035182086222
diltiazem,Anticonvulsant drug level decreased,1,4184,4183,9,8,417643,11.204770632454112
diltiazem,Aortic occlusion,1,4184,4183,6,5,417646,16.807275480117937
diltiazem,Aphakic cystoid macular oedema,1,4184,4183,7,6,417645,14.406201973976298
diltiazem,Application site burn,1,4184,4183,9,8,417643,11.204770632454112
diltiazem,Application site erosion,1,4184,4183,28,27,417624,3.6013711963389223
diltiazem,Application site urticaria,1,4184,4183,33,32,417619,3.055672672215823
diltiazem,Arterial Occlusive Diseases,2,4184,4182,67,65,417586,3.0105426954181747
diltiazem,Arthroplasty of the shoulder (procedure),1,4184,4183,15,14,417637,6.722766754323054
diltiazem,Atrial Fibrillation,3,4184,4181,18,15,417636,16.81483696085466
diltiazem,Atrophic,2,4184,4182,7,5,417646,28.819293571086966
diltiazem,Atrophic endometrium,1,4184,4183,32,31,417620,3.1511699139373652
diltiazem,Bacillus test positive,1,4184,4183,27,26,417625,3.734764168902347
diltiazem,Back disorder,1,4184,4183,6,5,417646,16.807275480117937
diltiazem,Benign neoplasm of breast,1,4184,4183,6,5,417646,16.807275480117937
diltiazem,Bicytopenia,1,4184,4183,25,24,417627,4.033564427444418
diltiazem,"Bladder cancer stage 0, with cancer in situ",2,4184,4182,5,3,417648,40.347202295552364
diltiazem,Blood bicarbonate level above normal,2,4184,4182,44,42,417609,4.584485457154036
diltiazem,Blood cholesterol decreased,2,4184,4182,46,44,417607,4.3851392094483606
diltiazem,Blood count abnormal,1,4184,4183,27,26,417625,3.734764168902347
diltiazem,Blood lactate dehydrogenase increased,2,4184,4182,22,20,417631,9.169449154384592
diltiazem,Blood magnesium increased,1,4184,4183,24,23,417628,4.201639572874333
diltiazem,Blood pressure difference of extremities,2,4184,4182,11,9,417642,18.339376548845703
diltiazem,Blood triglycerides abnormal,3,4184,4181,88,85,417566,3.4388277054206253
diltiazem,Blood triglycerides increased,7,4184,4177,227,220,417431,3.1125515329911337
diltiazem,Blood urate above reference range,2,4184,4182,9,7,417644,22.414899835272863
diltiazem,Blood urine present,1,4184,4183,6,5,417646,16.807275480117937
diltiazem,Bone density decreased,1,4184,4183,9,8,417643,11.204770632454112
diltiazem,Bone necrosis,2,4184,4182,56,54,417597,3.601993236318918
diltiazem,Brachial Plexus Neuropathies,1,4184,4183,16,15,417636,6.302578890748267
diltiazem,Brain Edema,3,4184,4181,79,76,417575,3.830674631167518
diltiazem,Bronchogenic Carcinoma,1,4184,4183,16,15,417636,6.302578890748267
diltiazem,Bronchopneumonia,2,4184,4182,57,55,417596,3.538791982347068
diltiazem,Brucellosis,3,4184,4181,69,66,417585,4.385948857668749
diltiazem,Burning sensation,31,4184,4153,925,894,416757,3.3966224351006433
diltiazem,Calcified lymph nodes,2,4184,4182,27,25,417626,7.471314451706609
diltiazem,Calcium Metabolism Disorders,1,4184,4183,17,16,417635,5.931824893476396
diltiazem,Cancer Remission,1,4184,4183,12,11,417640,8.4035182086222
diltiazem,Cancer of Ear,1,4184,4183,11,10,417641,9.16749614239454
diltiazem,Candiduria,3,4184,4181,80,77,417574,3.782782229131787
diltiazem,Cardiac Arrhythmia,1,4184,4183,33,32,417619,3.055672672215823
diltiazem,Cardiac discomfort,2,4184,4182,17,15,417636,11.866486623343741
diltiazem,Catheter site infection,4,4184,4180,131,127,417524,3.080492348150042
diltiazem,Cerebral Arteriosclerosis,2,4184,4182,13,11,417640,15.517860427473053
diltiazem,Cervical polyp,1,4184,4183,11,10,417641,9.16749614239454
diltiazem,Chest pain on breathing,2,4184,4182,8,6,417645,25.216822094691533
diltiazem,Cholecystitis infective,2,4184,4182,44,42,417609,4.584485457154036
diltiazem,Chronic Fatigue Syndrome,2,4184,4182,62,60,417591,3.253366964409682
diltiazem,Chronic sinusitis,3,4184,4181,75,72,417579,4.035015546519971
diltiazem,Clostridium difficile sepsis,2,4184,4182,51,49,417602,3.955176714396902
diltiazem,Colon cancer recurrent,2,4184,4182,25,23,417628,8.06905786704926
diltiazem,Colorectal Carcinoma,5,4184,4179,159,154,417497,3.173068095794938
diltiazem,Compression of brain,1,4184,4183,13,12,417639,7.757075341584067
diltiazem,Concomitant disease progression,1,4184,4183,7,6,417645,14.406201973976298
diltiazem,Conjunctival Diseases,1,4184,4183,10,9,417642,10.084269662921349
diltiazem,Contrast media allergy,6,4184,4178,141,135,417516,4.294979782650764
diltiazem,Contusions,24,4184,4160,677,653,416998,3.589006931030565
diltiazem,Creatinine renal clearance increased,2,4184,4182,5,3,417648,40.347202295552364
diltiazem,Crystal nephropathy,1,4184,4183,21,20,417631,4.801907949409743
diltiazem,Cyanosis,1,4184,4183,11,10,417641,9.16749614239454
diltiazem,Cytomegalovirus viremia,3,4184,4181,82,79,417572,3.6905017471604995
diltiazem,Dark circles under eyes,2,4184,4182,24,22,417629,8.4052885381795
diltiazem,Death of relative,1,4184,4183,17,16,417635,5.931824893476396
diltiazem,Deformity of knee joint,2,4184,4182,41,39,417612,4.919970605731883
diltiazem,Delayed Ejaculation,2,4184,4182,43,41,417610,4.6911125198803285
diltiazem,Dementia,4,4184,4180,114,110,417541,3.5400067153529755
diltiazem,Dentin Sensitivity,2,4184,4182,28,26,417625,7.204464712714353
diltiazem,Depressed mood,7,4184,4177,174,167,417484,4.061138032850944
diltiazem,Dermatitis Herpetiformis,3,4184,4181,9,6,417645,33.6303914534003
diltiazem,Dermatomycoses,3,4184,4181,31,28,417623,9.76315281881939
diltiazem,Desmoplastic melanoma,1,4184,4183,7,6,417645,14.406201973976298
diltiazem,Device difficult to use,3,4184,4181,56,53,417598,5.404282126627259
diltiazem,Device related sepsis,1,4184,4183,31,30,417621,3.25282826802804
diltiazem,Diabetic ketoacidotic hyperglycaemic coma,1,4184,4183,14,13,417638,7.202981455551381
diltiazem,Diarrhea,6,4184,4178,160,154,417497,3.7847803973192913
diltiazem,Discharge from eye,1,4184,4183,24,23,417628,4.201639572874333
diltiazem,Discomfort in mouth,2,4184,4182,25,23,417628,8.06905786704926
diltiazem,Dislocations,4,4184,4180,127,123,417528,3.177545868967336
diltiazem,Disorder of palate,1,4184,4183,15,14,417637,6.722766754323054
diltiazem,Diverticulitis,1,4184,4183,10,9,417642,10.084269662921349
diltiazem,Diverticulum,2,4184,4182,66,64,417587,3.056164224743852
diltiazem,Drug dose omission,1,4184,4183,25,24,417627,4.033564427444418
diltiazem,Ear Diseases,2,4184,4182,31,29,417622,6.507212168895882
diltiazem,Ectopic pregnancy with contraceptive device,1,4184,4183,12,11,417640,8.4035182086222
diltiazem,Ectropion,1,4184,4183,9,8,417643,11.204770632454112
diltiazem,Edema of the tongue,1,4184,4183,24,23,417628,4.201639572874333
diltiazem,Electrolyte imbalance,1,4184,4183,19,18,417633,5.307397108597455
diltiazem,Electromechanical dissociation,9,4184,4175,117,108,417543,7.7700230308613545
diltiazem,Enamel anomaly,1,4184,4183,20,19,417632,5.042015300023906
diltiazem,Enterobacter sepsis,3,4184,4181,23,20,417631,13.159281636388217
diltiazem,Enterocolitis viral,6,4184,4178,61,55,417596,9.92962355507773
diltiazem,Epstein-Barr virus test positive,1,4184,4183,25,24,417627,4.033564427444418
diltiazem,Erosive esophagitis,1,4184,4183,22,21,417630,4.583628539760503
diltiazem,Escherichia sepsis,1,4184,4183,9,8,417643,11.204770632454112
diltiazem,Esophageal Varices,1,4184,4183,13,12,417639,7.757075341584067
diltiazem,Estimated glomerular filtration rate decreased,2,4184,4182,24,22,417629,8.4052885381795
diltiazem,Euphoric mood,5,4184,4179,131,126,417525,3.851536855487909
diltiazem,Excessive bronchial secretion,2,4184,4182,59,57,417594,3.418816720569997
diltiazem,Extrapyramidal Disorders,1,4184,4183,13,12,417639,7.757075341584067
diltiazem,Eye Infection,1,4184,4183,29,28,417623,3.4771777391247
diltiazem,Eye inflammation,1,4184,4183,15,14,417637,6.722766754323054
diltiazem,Eye oedema,2,4184,4182,48,46,417605,4.20240514905149
diltiazem,Eyelid exfoliation,6,4184,4178,107,101,417550,5.6601960424654285
diltiazem,Family tension,1,4184,4183,12,11,417640,8.4035182086222
diltiazem,"Fasciitis, Plantar",1,4184,4183,8,7,417644,12.60539684437007
diltiazem,Febrile Neutropenia,3,4184,4181,96,93,417558,3.1521989356613247
diltiazem,Febrile bone marrow aplasia,1,4184,4183,28,27,417624,3.6013711963389223
diltiazem,Feeding tube complication,2,4184,4182,7,5,417646,28.819293571086966
diltiazem,Fibrosis of urinary bladder,5,4184,4179,43,38,417613,11.73620038175373
diltiazem,Fracture of coccyx,2,4184,4182,23,21,417630,8.770756658973239
diltiazem,Frontotemporal dementia,1,4184,4183,10,9,417642,10.084269662921349
diltiazem,Gastric ulcer with perforation,1,4184,4183,5,4,417647,20.168778388716234
diltiazem,Gastrointestinal inflammation,3,4184,4181,89,86,417565,3.4001811297227422
diltiazem,General physical health deterioration,48,4184,4136,818,770,416881,5.973199718140674
diltiazem,Gingival Diseases,1,4184,4183,15,14,417637,6.722766754323054
diltiazem,Gingival Hypertrophy,1,4184,4183,10,9,417642,10.084269662921349
diltiazem,Glossalgia,1,4184,4183,6,5,417646,16.807275480117937
diltiazem,Good neonatal condition at birth,2,4184,4182,21,19,417632,9.606112363644645
diltiazem,Granuloma of skin,1,4184,4183,5,4,417647,20.168778388716234
diltiazem,Haematotoxicity,2,4184,4182,27,25,417626,7.471314451706609
diltiazem,Haemorrhagic arteriovenous malformation,2,4184,4182,57,55,417596,3.538791982347068
diltiazem,Hair Diseases,2,4184,4182,10,8,417643,20.173362027737927
diltiazem,Head discomfort,3,4184,4181,81,78,417573,3.7360723555413817
diltiazem,Hemorrhagic enterocolitis,1,4184,4183,5,4,417647,20.168778388716234
diltiazem,Hip Fractures,2,4184,4182,66,64,417587,3.056164224743852
diltiazem,Human chorionic gonadotropin decreased,1,4184,4183,14,13,417638,7.202981455551381
diltiazem,Hydrocephalus,1,4184,4183,8,7,417644,12.60539684437007
diltiazem,Hyperlactatemia,1,4184,4183,25,24,417627,4.033564427444418
diltiazem,Hyperventilation,1,4184,4183,30,29,417622,3.3612638457247592
diltiazem,Hypoglycaemic unconsciousness,1,4184,4183,14,13,417638,7.202981455551381
diltiazem,Hypophagia,1,4184,4183,29,28,417623,3.4771777391247
diltiazem,Hypoxic ischaemic encephalopathy neonatal,1,4184,4183,17,16,417635,5.931824893476396
diltiazem,Hysterectomy,1,4184,4183,17,16,417635,5.931824893476396
diltiazem,Immunologic Deficiency Syndromes,1,4184,4183,9,8,417643,11.204770632454112
diltiazem,Impaired exercise tolerance,3,4184,4181,84,81,417570,3.6026155738545116
diltiazem,Increased anteroposterior chest diameter,2,4184,4182,45,43,417608,4.482597374993357
diltiazem,Inflammatory Bowel Diseases,1,4184,4183,10,9,417642,10.084269662921349
diltiazem,Infusion-Related Reaction,1,4184,4183,8,7,417644,12.60539684437007
diltiazem,Intelligence increased,1,4184,4183,10,9,417642,10.084269662921349
diltiazem,International normalised ratio fluctuation,1,4184,4183,12,11,417640,8.4035182086222
diltiazem,Iron deficiency anemia,2,4184,4182,64,62,417589,3.1516843017694884
diltiazem,Joint injury,1,4184,4183,25,24,417627,4.033564427444418
diltiazem,Kidney Neoplasm,1,4184,4183,19,18,417633,5.307397108597455
diltiazem,Klebsiella test positive,1,4184,4183,32,31,417620,3.1511699139373652
diltiazem,Labyrinthitis,5,4184,4179,91,86,417565,5.545046004486061
diltiazem,Lack of injection site rotation,1,4184,4183,20,19,417632,5.042015300023906
diltiazem,Learning Disorders,2,4184,4182,52,50,417601,3.879106426810875
diltiazem,Lichen Planus,1,4184,4183,21,20,417631,4.801907949409743
diltiazem,Lip oedema,3,4184,4181,87,84,417567,3.478362708146047
diltiazem,Lipodystrophy acquired,2,4184,4182,9,7,417644,22.414899835272863
diltiazem,Lipoprotein (a) increased,4,4184,4180,33,29,417622,12.231462954907931
diltiazem,"Liver Failure, Acute",1,4184,4183,18,17,417634,5.602265784790289
diltiazem,Liver diseases,3,4184,4181,55,52,417599,5.502554847687591
diltiazem,Localized swelling,5,4184,4179,131,126,417525,3.851536855487909
diltiazem,Lumbosacral radiculitis,2,4184,4182,61,59,417592,3.3067086890733903
diltiazem,Lung carcinoma cell type unspecified stage III,1,4184,4183,33,32,417619,3.055672672215823
diltiazem,Lung diseases,2,4184,4182,36,34,417617,5.603366278760826
diltiazem,Lupus Nephritis,1,4184,4183,7,6,417645,14.406201973976298
diltiazem,Lymphatic Diseases,1,4184,4183,24,23,417628,4.201639572874333
diltiazem,Macromastia,1,4184,4183,6,5,417646,16.807275480117937
diltiazem,Malignant Hypertension,5,4184,4179,140,135,417516,3.6038611424469282
diltiazem,Malignant melanoma of retina,1,4184,4183,10,9,417642,10.084269662921349
diltiazem,Malignant neoplasm of skin,1,4184,4183,19,18,417633,5.307397108597455
diltiazem,Malignant neoplasm of tongue,3,4184,4181,54,51,417600,5.604467299157564
diltiazem,Malignant tumor of nasal sinuses,1,4184,4183,14,13,417638,7.202981455551381
diltiazem,Mantle cell lymphoma,2,4184,4182,60,58,417593,3.361828471225889
diltiazem,Mass of body structure,14,4184,4170,380,366,417285,3.723570617190458
diltiazem,Mastoid effusion,1,4184,4183,8,7,417644,12.60539684437007
diltiazem,Mechanical ventilation,1,4184,4183,14,13,417638,7.202981455551381
diltiazem,Mediastinal Emphysema,1,4184,4183,21,20,417631,4.801907949409743
diltiazem,Mental disorders,4,4184,4180,47,43,417608,8.58776341239947
diltiazem,Mesenteric Venous Thrombosis,1,4184,4183,12,11,417640,8.4035182086222
diltiazem,Metabolic Syndrome X,1,4184,4183,31,30,417621,3.25282826802804
diltiazem,Miliaria,1,4184,4183,27,26,417625,3.734764168902347
diltiazem,Monocyte percentage increased,1,4184,4183,28,27,417624,3.6013711963389223
diltiazem,Multimorbidity,2,4184,4182,8,6,417645,25.216822094691533
diltiazem,Mutism,1,4184,4183,10,9,417642,10.084269662921349
diltiazem,Obesity,1,4184,4183,22,21,417630,4.583628539760503
diltiazem,Obsessive-Compulsive Disorder,4,4184,4180,86,82,417569,4.692878602425726
diltiazem,Oesophageal irritation,1,4184,4183,18,17,417634,5.602265784790289
diltiazem,Onychalgia,1,4184,4183,5,4,417647,20.168778388716234
diltiazem,Optic Neuropathy,1,4184,4183,16,15,417636,6.302578890748267
diltiazem,Oral discharge,1,4184,4183,30,29,417622,3.3612638457247592
diltiazem,Oral paresthesia,3,4184,4181,73,70,417581,4.145583576059997
diltiazem,Ovarian cancer stage IV,2,4184,4182,21,19,417632,9.606112363644645
diltiazem,Ovarian enlargement,1,4184,4183,9,8,417643,11.204770632454112
diltiazem,Pain in scrotum,1,4184,4183,11,10,417641,9.16749614239454
diltiazem,Palpitations,13,4184,4171,351,338,417313,3.7426321070531086
diltiazem,Paranasal sinus hypersecretion,1,4184,4183,17,16,417635,5.931824893476396
diltiazem,Partial thromboplastin time increased (finding),1,4184,4183,15,14,417637,6.722766754323054
diltiazem,Performance status decreased,1,4184,4183,25,24,417627,4.033564427444418
diltiazem,Perinuclear antineutrophil cytoplasmic antibody increased,1,4184,4183,7,6,417645,14.406201973976298
diltiazem,Periorbital contusion,3,4184,4181,24,21,417630,12.610948337718249
diltiazem,Peripheral nerve lesion,1,4184,4183,28,27,417624,3.6013711963389223
diltiazem,Physical abuse,3,4184,4181,43,40,417611,7.038351790769983
diltiazem,Pili incarnati (disorder),1,4184,4183,18,17,417634,5.602265784790289
diltiazem,Piloerection,3,4184,4181,40,37,417614,7.566281989954556
diltiazem,Platelet aggregation inhibition,1,4184,4183,14,13,417638,7.202981455551381
diltiazem,Pleural Tuberculosis,1,4184,4183,5,4,417647,20.168778388716234
diltiazem,Polychondritis,2,4184,4182,56,54,417597,3.601993236318918
diltiazem,Polychromatophilic stain reaction,1,4184,4183,16,15,417636,6.302578890748267
diltiazem,Polyneuropathy,2,4184,4182,52,50,417601,3.879106426810875
diltiazem,Polypharmacy,1,4184,4183,16,15,417636,6.302578890748267
diltiazem,Poor quality drug administered,1,4184,4183,18,17,417634,5.602265784790289
diltiazem,Post procedural discharge,2,4184,4182,7,5,417646,28.819293571086966
diltiazem,Postoperative confusion,1,4184,4183,14,13,417638,7.202981455551381
diltiazem,Postthrombotic Syndrome,1,4184,4183,5,4,417647,20.168778388716234
diltiazem,Pre-existing condition,1,4184,4183,18,17,417634,5.602265784790289
diltiazem,Premature Obstetric Labor,3,4184,4181,44,41,417610,6.878372942532234
diltiazem,Product barcode issue,1,4184,4183,21,20,417631,4.801907949409743
diltiazem,Product taste abnormal,1,4184,4183,31,30,417621,3.25282826802804
diltiazem,Prolonged labor,1,4184,4183,27,26,417625,3.734764168902347
diltiazem,Protein urine present,1,4184,4183,9,8,417643,11.204770632454112
diltiazem,Prothrombin consumption time shortened,2,4184,4182,56,54,417597,3.601993236318918
diltiazem,Psychomotor Impairment,1,4184,4183,27,26,417625,3.734764168902347
diltiazem,Psychotic Disorders,3,4184,4181,19,16,417635,15.929807777036467
diltiazem,Pure Red-Cell Aplasia,1,4184,4183,23,22,417629,4.384329948341631
diltiazem,Raised jugular venous pressure,2,4184,4182,51,49,417602,3.955176714396902
diltiazem,Recurrent Chronic Lymphoid Leukemia,2,4184,4182,43,41,417610,4.6911125198803285
diltiazem,Red blood cell morphology abnormal,1,4184,4183,32,31,417620,3.1511699139373652
diltiazem,Refusal of treatment by relative,1,4184,4183,9,8,417643,11.204770632454112
diltiazem,Removal of internal fixation device,3,4184,4181,13,10,417641,23.28235791952606
diltiazem,Renal Osteodystrophy,2,4184,4182,37,35,417616,5.451911021494952
diltiazem,Renal cancer metastatic,2,4184,4182,29,27,417624,6.956018403997428
diltiazem,Repeat Surgery,1,4184,4183,13,12,417639,7.757075341584067
diltiazem,Respiratory Failure,2,4184,4182,45,43,417608,4.482597374993357
diltiazem,Retinal infarction,2,4184,4182,8,6,417645,25.216822094691533
diltiazem,Retinal pigment epitheliopathy,1,4184,4183,19,18,417633,5.307397108597455
diltiazem,Rheumatoid Arthritis,2,4184,4182,47,45,417606,4.2918281998840015
diltiazem,Rhinalgia,2,4184,4182,23,21,417630,8.770756658973239
diltiazem,Saliva altered,4,4184,4180,49,45,417606,8.237203398105652
diltiazem,Salpingitis,3,4184,4181,76,73,417578,3.9819137954908794
diltiazem,Second degree atrioventricular block,3,4184,4181,57,54,417597,5.309457571218167
diltiazem,Sense of smell impaired,1,4184,4183,23,22,417629,4.384329948341631
diltiazem,Septic thrombophlebitis,5,4184,4179,128,123,417528,3.941835292534099
diltiazem,Short stature for age,2,4184,4182,14,12,417639,14.409407665505226
diltiazem,Sialadenitis,3,4184,4181,70,67,417584,4.323282194963611
diltiazem,Sinoatrial Block,1,4184,4183,19,18,417633,5.307397108597455
diltiazem,Sinusitis,1,4184,4183,14,13,417638,7.202981455551381
diltiazem,Skin Induration,1,4184,4183,27,26,417625,3.734764168902347
diltiazem,Skin irritation,1,4184,4183,13,12,417639,7.757075341584067
diltiazem,Skin neoplasm bleeding,1,4184,4183,16,15,417636,6.302578890748267
diltiazem,Slow respiration,1,4184,4183,8,7,417644,12.60539684437007
diltiazem,Small bowel obstruction,1,4184,4183,13,12,417639,7.757075341584067
diltiazem,Small intestinal ulcer haemorrhage,2,4184,4182,66,64,417587,3.056164224743852
diltiazem,Somnambulism,1,4184,4183,16,15,417636,6.302578890748267
diltiazem,Sperm concentration decreased,1,4184,4183,6,5,417646,16.807275480117937
diltiazem,Splenic vein thrombosis,1,4184,4183,6,5,417646,16.807275480117937
diltiazem,Spondylolisthesis,1,4184,4183,29,28,417623,3.4771777391247
diltiazem,Spontaneous penile erection,2,4184,4182,11,9,417642,18.339376548845703
diltiazem,Streptococcal pneumonia,1,4184,4183,23,22,417629,4.384329948341631
diltiazem,Stricture of artery,6,4184,4178,97,91,417560,6.243869458577824
diltiazem,Sudden death,2,4184,4182,60,58,417593,3.361828471225889
diltiazem,Sudden onset of sleep,3,4184,4181,29,26,417625,10.436523187820105
diltiazem,Superficial Thrombophlebitis,2,4184,4182,42,40,417611,4.802817061784063
diltiazem,Superficial injury of eye,1,4184,4183,17,16,417635,5.931824893476396
diltiazem,Syphilis,1,4184,4183,13,12,417639,7.757075341584067
diltiazem,Tenalgia,1,4184,4183,19,18,417633,5.307397108597455
diltiazem,Therapeutic response unexpected with drug substitution,1,4184,4183,14,13,417638,7.202981455551381
diltiazem,Therapy change,2,4184,4182,28,26,417625,7.204464712714353
diltiazem,Thrombocytopenia,2,4184,4182,62,60,417591,3.253366964409682
diltiazem,Thrombosis of jugular vein,6,4184,4178,191,185,417466,3.1702635846205127
diltiazem,Thyroid hormones decreased,1,4184,4183,21,20,417631,4.801907949409743
diltiazem,Thyroxine level above reference range,5,4184,4179,161,156,417495,3.1336362379778215
diltiazem,Tibial Fractures,1,4184,4183,22,21,417630,4.583628539760503
diltiazem,Tongue blistering,1,4184,4183,20,19,417632,5.042015300023906
diltiazem,Tracheitis,1,4184,4183,5,4,417647,20.168778388716234
diltiazem,Uremic encephalopathy,1,4184,4183,6,5,417646,16.807275480117937
diltiazem,Urgent desire for stool,1,4184,4183,14,13,417638,7.202981455551381
diltiazem,Vaginal Discharge,3,4184,4181,38,35,417616,7.964545122672742
diltiazem,Vaginal odor,2,4184,4182,53,51,417600,3.805906716114886
diltiazem,Vascular Grafting (surgical procedure),2,4184,4182,38,36,417615,5.308427093558861
diltiazem,Vascular insufficiency of intestine,3,4184,4181,27,24,417627,11.209652130006111
diltiazem,Venous Insufficiency,3,4184,4181,17,14,417637,17.803987225122054
diltiazem,Venous Thrombosis,10,4184,4174,231,221,417430,4.372605512998422
diltiazem,Ventricular hypertrophy,2,4184,4182,26,24,417627,7.758691093698268
diltiazem,Wheelchair user,2,4184,4182,13,11,417640,15.517860427473053
diltiazem,White matter lesion,3,4184,4181,91,88,417563,3.325436104197166
diltiazem,Wrong drug administered,2,4184,4182,25,23,417628,8.06905786704926
diltiazem,hypertensive nephropathy,2,4184,4182,61,59,417592,3.3067086890733903
diltiazem,hypoglycemic encephalopathy,1,4184,4183,14,13,417638,7.202981455551381
diltiazem,nail avulsion injury,1,4184,4183,30,29,417622,3.3612638457247592
doxazosin,5-hydroxyindolacetic acid in urine increased,2,9495,9493,6,4,412336,14.811931598721863
doxazosin,ADAMTS13 activity abnormal,18,9495,9477,57,39,412301,14.05434764499092
doxazosin,ADAMTS13 activity decreased,4,9495,9491,11,7,412333,16.161684275054835
doxazosin,Abnormal nail growth,2,9495,9493,11,9,412331,8.07913965314155
doxazosin,Abscess of tongue,8,9495,9487,69,61,412279,5.154464614430426
doxazosin,Acarodermatitis,2,9495,9493,19,17,412323,4.67730793326939
doxazosin,Accidental death,4,9495,9491,19,15,412325,9.356587126862566
doxazosin,Achromia of skin,2,9495,9493,23,21,412319,3.8638264350390905
doxazosin,Acidosis,19,9495,9476,157,138,412202,5.385299234001823
doxazosin,Acquired ventricular septal defect,1,9495,9494,5,4,412336,8.88624394354329
doxazosin,Acromegaly,5,9495,9490,11,6,412334,20.20423412204234
doxazosin,Actinic keratosis,3,9495,9492,22,19,412321,6.059835076427996
doxazosin,Acute Promyelocytic Leukemia,7,9495,9488,17,10,412330,18.306256819759945
doxazosin,Acute heart failure,17,9495,9478,84,67,412273,9.005525326822013
doxazosin,Acute hepatitis,5,9495,9490,11,6,412334,20.20423412204234
doxazosin,Acute promyelocytic leukaemia differentiation syndrome,1,9495,9494,8,7,412333,5.553862966083843
doxazosin,Addisonian crisis,3,9495,9492,37,34,412306,3.6030170499197047
doxazosin,"Adenocarcinoma of lung, stage I",1,9495,9494,5,4,412336,8.88624394354329
doxazosin,Agnosia,1,9495,9494,11,10,412330,4.039144339965912
doxazosin,Agranulocytosis,2,9495,9493,8,6,412334,11.108896028652692
doxazosin,Alanine aminotransferase measurement,3,9495,9492,5,2,412338,26.66434892541087
doxazosin,Altered bowel function,17,9495,9478,104,87,412253,7.27334860486633
doxazosin,Anaemia postoperative,4,9495,9491,29,25,412315,6.130032444530026
doxazosin,Androgenetic Alopecia,2,9495,9493,6,4,412336,14.811931598721863
doxazosin,Anemia due to blood loss,2,9495,9493,12,10,412330,7.4058604585835175
doxazosin,"Anemia, Hemolytic",2,9495,9493,25,23,412317,3.554703465711577
doxazosin,Anorectal cellulitis,6,9495,9489,32,26,412314,8.334709927284225
doxazosin,Anti-nuclear factor positive,1,9495,9494,12,11,412329,3.702540200828593
doxazosin,Antibody test positive,1,9495,9494,10,9,412331,4.443069306930694
doxazosin,Anticonvulsant drug level increased,5,9495,9490,14,9,412331,15.874642480806866
doxazosin,Appendicitis purulent perforated,2,9495,9493,11,9,412331,8.07913965314155
doxazosin,Arteriogram coronary abnormal,2,9495,9493,9,7,412333,9.874550838629633
doxazosin,Arteriopathic disease,11,9495,9484,50,39,412301,9.784131168283425
doxazosin,Arthralgia,14,9495,9481,118,104,412236,5.277314665012452
doxazosin,Aspartate aminotransferase abnormal,1,9495,9494,6,5,412335,7.405185731339091
doxazosin,Aspiration Pneumonia,2,9495,9493,29,27,412313,3.0643704798817275
doxazosin,Atrial Premature Complexes,1,9495,9494,5,4,412336,8.88624394354329
doxazosin,Autoimmune myocarditis,1,9495,9494,12,11,412329,3.702540200828593
doxazosin,Bacterial conjunctivitis,11,9495,9484,29,18,412322,16.870031559504937
doxazosin,Bacterial ear infection,1,9495,9494,14,13,412327,3.1735908393270935
doxazosin,Bacterial resistance,1,9495,9494,12,11,412329,3.702540200828593
doxazosin,Bacterial vulvovaginitis,1,9495,9494,6,5,412335,7.405185731339091
doxazosin,Benign neoplasm of pericardium,4,9495,9491,57,53,412287,3.1185814076863214
doxazosin,Bile duct calculus,116,9495,9379,1599,1483,410857,3.250470610129838
doxazosin,Biopsy of thyroid (procedure),1,9495,9494,10,9,412331,4.443069306930694
doxazosin,Bladder tamponade,2,9495,9493,12,10,412330,7.4058604585835175
doxazosin,Blood HIV RNA increased,5,9495,9490,6,1,412339,37.041534949069195
doxazosin,Blood Platelet Disorders,4,9495,9491,40,36,412304,4.444157623011274
doxazosin,Blood aldosterone increased,1,9495,9494,13,12,412328,3.417721313866248
doxazosin,Blood bicarbonate level above normal,4,9495,9491,44,40,412300,4.040104979837358
doxazosin,Blood growth hormone abnormal,1,9495,9494,14,13,412327,3.1735908393270935
doxazosin,Blood growth hormone increased,3,9495,9492,11,8,412332,12.119986208481782
doxazosin,Blood lactate dehydrogenase decreased,2,9495,9493,12,10,412330,7.4058604585835175
doxazosin,Blood oestrogen increased,5,9495,9490,70,65,412275,3.1745069998494655
doxazosin,Blood pH decreased,2,9495,9493,9,7,412333,9.874550838629633
doxazosin,Blood potassium decreased,19,9495,9476,143,124,412216,5.912727626953038
doxazosin,Blood testosterone free abnormal,4,9495,9491,26,22,412318,6.83739250950293
doxazosin,Brain Stem Infarctions,1,9495,9494,5,4,412336,8.88624394354329
doxazosin,Brain natriuretic peptide decreased,4,9495,9491,22,18,412322,8.080631411576517
doxazosin,Breast cancer stage II,16,9495,9479,134,118,412222,5.311990527371582
doxazosin,Breast tenderness,30,9495,9465,378,348,411992,3.533963893710328
doxazosin,"Bronchitis, Chronic",4,9495,9491,56,52,412288,3.1742778873218236
doxazosin,Bronchospasm,1,9495,9494,13,12,412328,3.417721313866248
doxazosin,Bullous pemphigoid,2,9495,9493,19,17,412323,4.67730793326939
doxazosin,Burning sensation of skin,3,9495,9492,26,23,412317,5.1275041330351065
doxazosin,Calcium deficiency,5,9495,9490,49,44,412296,4.535235801380615
doxazosin,Cerebral circulatory failure,3,9495,9492,22,19,412321,6.059835076427996
doxazosin,Cerebral disorder,1,9495,9494,9,8,412332,4.936755377665426
doxazosin,Cerebral hypoperfusion,1,9495,9494,8,7,412333,5.553862966083843
doxazosin,Cervical spine flattening,1,9495,9494,8,7,412333,5.553862966083843
doxazosin,Cholesterolosis of gallbladder,3,9495,9492,10,7,412333,13.332016434892541
doxazosin,Chronic graft-versus-host disease,4,9495,9491,12,8,412332,14.814842131141782
doxazosin,Chvostek sign,1,9495,9494,8,7,412333,5.553862966083843
doxazosin,Coagulation factor V level abnormal,6,9495,9489,13,7,412333,20.517133198764565
doxazosin,Cognition Disorders,1,9495,9494,13,12,412328,3.417721313866248
doxazosin,Colitis,12,9495,9483,175,163,412177,3.0490170380078636
doxazosin,Colon adenoma,17,9495,9478,84,67,412273,9.005525326822013
doxazosin,Congenital anomaly of gastrointestinal tract,3,9495,9492,11,8,412332,12.119986208481782
doxazosin,Congenital stenosis of aortic valve,2,9495,9493,24,22,412318,3.702824888514344
doxazosin,Congenital tricuspid valve incompetence,5,9495,9490,19,14,412326,11.696966335755087
doxazosin,Contraindicated drug administered,1,9495,9494,5,4,412336,8.88624394354329
doxazosin,Coombs test positive,3,9495,9492,5,2,412338,26.66434892541087
doxazosin,Corneal Opacity,2,9495,9493,9,7,412333,9.874550838629633
doxazosin,Coronary Artery Bypass Surgery,1,9495,9494,11,10,412330,4.039144339965912
doxazosin,Creatinine measurement,2,9495,9493,9,7,412333,9.874550838629633
doxazosin,Crystal nephropathy,4,9495,9491,21,17,412323,8.465443452694533
doxazosin,De Quervain Disease,16,9495,9479,175,159,412181,4.0670715717450605
doxazosin,Deafness Neurosensory,4,9495,9491,44,40,412300,4.040104979837358
doxazosin,Decreased platelet count,24,9495,9471,245,221,412119,4.360533443659377
doxazosin,Deep Vein Thrombosis,2,9495,9493,19,17,412323,4.67730793326939
doxazosin,Deformity of spine,4,9495,9491,17,13,412327,10.457411665540729
doxazosin,Dental Restoration Failure,8,9495,9487,9,1,412339,39.523183771945234
doxazosin,Dermabrasion,7,9495,9488,34,27,412313,9.152759522864795
doxazosin,Diaper Rash,16,9495,9479,151,135,412205,4.713761825548144
doxazosin,Discoloration of skin,10,9495,9485,86,76,412264,5.170330141839624
doxazosin,Disease of diaphragm,3,9495,9492,37,34,412306,3.6030170499197047
doxazosin,Disorder of palate,2,9495,9493,15,13,412327,5.924646230555848
doxazosin,Disseminated Intravascular Coagulation,3,9495,9492,42,39,412301,3.1740488230690502
doxazosin,Documented hypersensitivity to administered drug,1,9495,9494,5,4,412336,8.88624394354329
doxazosin,Documented hypersensitivity to administered product,2,9495,9493,18,16,412324,4.9371700785374015
doxazosin,Drug dispensed to wrong patient,2,9495,9493,11,9,412331,8.07913965314155
doxazosin,Drug dose omission,2,9495,9493,25,23,412317,3.554703465711577
doxazosin,Drug dose titration not performed,1,9495,9494,10,9,412331,4.443069306930694
doxazosin,Drug reaction with eosinophilia and systemic symptoms syndrome (SMQ),15,9495,9480,161,146,412194,4.144134759021935
doxazosin,Drug withdrawal syndrome,16,9495,9479,134,118,412222,5.311990527371582
doxazosin,Dyslipidemias,2,9495,9493,11,9,412331,8.07913965314155
doxazosin,Dysphemia,1,9495,9494,10,9,412331,4.443069306930694
doxazosin,Dystonia,1,9495,9494,11,10,412330,4.039144339965912
doxazosin,Ear tube insertion,1,9495,9494,11,10,412330,4.039144339965912
doxazosin,Eating Disorders,4,9495,9491,54,50,412290,3.291859344330106
doxazosin,Edema of mouth,4,9495,9491,15,11,412329,11.851789414533068
doxazosin,Electrocardiogram abnormal (finding),10,9495,9485,142,132,412208,3.1309109268155058
doxazosin,Endotracheal intubation complication,5,9495,9490,47,42,412298,4.728246978902765
doxazosin,Enlarged uvula,13,9495,9482,55,42,412298,10.513969051408411
doxazosin,Epistaxis,18,9495,9477,258,240,412100,3.1035505790027753
doxazosin,Excision of benign neoplasm,3,9495,9492,25,22,412318,5.332616940581542
doxazosin,Exposure during breast feeding,1,9495,9494,7,6,412334,6.347287008336092
doxazosin,Eye Burns,1,9495,9494,8,7,412333,5.553862966083843
doxazosin,Eyelid irritation,30,9495,9465,343,313,412027,3.8948958800182965
doxazosin,Eyelid pain,12,9495,9483,76,64,412276,7.022411295559366
doxazosin,Faecal calprotectin increased,1,9495,9494,6,5,412335,7.405185731339091
doxazosin,Feeding Disorders,2,9495,9493,5,3,412337,17.774360054777205
doxazosin,Femoral artery embolus,2,9495,9493,20,18,412322,4.443432002528179
doxazosin,Fetal Growth Retardation,2,9495,9493,13,11,412329,6.836162678572876
doxazosin,Food craving,25,9495,9470,369,344,411996,3.015270015424547
doxazosin,Formication,3,9495,9492,34,31,412309,3.9209582062913664
doxazosin,Fracture of sternum,5,9495,9490,54,49,412291,4.11525777621668
doxazosin,Friedreich Ataxia,3,9495,9492,11,8,412332,12.119986208481782
doxazosin,Gastric Obstruction,1,9495,9494,7,6,412334,6.347287008336092
doxazosin,Gastric infection,5,9495,9490,42,37,412303,5.291196246675698
doxazosin,Gastrointestinal angiodysplasia haemorrhagic,4,9495,9491,13,9,412331,13.675206470907662
doxazosin,Gunshot wound,13,9495,9482,85,72,412268,6.8026725560504735
doxazosin,Head Banging,1,9495,9494,11,10,412330,4.039144339965912
doxazosin,Heart failure,19,9495,9476,187,168,412172,4.521025816980924
doxazosin,"Hematoma, Epidural, Spinal",1,9495,9494,6,5,412335,7.405185731339091
doxazosin,Hepatitis C RNA increased,1,9495,9494,5,4,412336,8.88624394354329
doxazosin,"Hernia, Inguinal",4,9495,9491,17,13,412327,10.457411665540729
doxazosin,Hiatal Hernia,6,9495,9489,46,40,412300,5.797866637342094
doxazosin,Hilar lymphadenopathy,4,9495,9491,22,18,412322,8.080631411576517
doxazosin,Hydrocele operation,5,9495,9490,44,39,412301,5.0506633777181715
doxazosin,Hyperammonemia (disorder),5,9495,9490,25,20,412320,8.889567966280294
doxazosin,Hyperlipasaemia,2,9495,9493,6,4,412336,14.811931598721863
doxazosin,Hypervolemia (finding),14,9495,9481,117,103,412237,5.322432539392776
doxazosin,Hyphema,1,9495,9494,5,4,412336,8.88624394354329
doxazosin,Hypocoagulability state,3,9495,9492,15,12,412328,8.887905604719764
doxazosin,Hypofibrinogenemia,1,9495,9494,5,4,412336,8.88624394354329
doxazosin,Hypoglycaemic unconsciousness,1,9495,9494,14,13,412327,3.1735908393270935
doxazosin,Hypothermia due to exposure,4,9495,9491,43,39,412301,4.134070710808036
doxazosin,Ileitis,5,9495,9490,13,8,412332,17.095809353975845
doxazosin,Immunologic Deficiency Syndromes,1,9495,9494,9,8,412332,4.936755377665426
doxazosin,Incision and drainage,2,9495,9493,20,18,412322,4.443432002528179
doxazosin,Incisional hernia,3,9495,9492,24,21,412319,5.554822482090182
doxazosin,Incorrect product storage,3,9495,9492,18,15,412325,7.406535327995504
doxazosin,Incorrect route of product administration,1,9495,9494,5,4,412336,8.88624394354329
doxazosin,Infective glossitis,1,9495,9494,11,10,412330,4.039144339965912
doxazosin,Infective spondylitis,7,9495,9488,24,17,412323,12.966716729904443
doxazosin,Inflammatory marker increased,1,9495,9494,8,7,412333,5.553862966083843
doxazosin,Influenza,5,9495,9490,33,28,412312,6.734393460420858
doxazosin,Injection site dryness,2,9495,9493,28,26,412314,3.17381980707589
doxazosin,Insertion of prosthesis of bone,4,9495,9491,11,7,412333,16.161684275054835
doxazosin,Intentional device misuse,1,9495,9494,14,13,412327,3.1735908393270935
doxazosin,Intestinal resection,1,9495,9494,8,7,412333,5.553862966083843
doxazosin,Intracranial hematoma,12,9495,9483,14,2,412338,38.12726533194739
doxazosin,Iridocyclitis,1,9495,9494,12,11,412329,3.702540200828593
doxazosin,Irritable Bowel Syndrome,3,9495,9492,27,24,412316,4.937584866788406
doxazosin,Keratosis pilaris,4,9495,9491,10,6,412334,17.777894847750503
doxazosin,Labile blood pressure,10,9495,9485,86,76,412264,5.170330141839624
doxazosin,Left Bundle-Branch Block,17,9495,9478,109,92,412248,6.939626484122575
doxazosin,Left cardiac ventricular dilatation,1,9495,9494,6,5,412335,7.405185731339091
doxazosin,Left ventricle outflow tract obstruction,3,9495,9492,32,29,412311,4.166037847661189
doxazosin,Lethargy,8,9495,9487,114,106,412234,3.119474664314417
doxazosin,Leukoencephalopathy,1,9495,9494,7,6,412334,6.347287008336092
doxazosin,Lichen Planus,2,9495,9493,21,19,412321,4.2318299699527975
doxazosin,Light chain analysis abnormal,2,9495,9493,6,4,412336,14.811931598721863
doxazosin,Limb prosthesis user,1,9495,9494,11,10,412330,4.039144339965912
doxazosin,Linear IgA Bullous Dermatosis,6,9495,9489,7,1,412339,38.10378935007452
doxazosin,Lip Diseases,4,9495,9491,13,9,412331,13.675206470907662
doxazosin,Lipoprotein (a) increased,6,9495,9489,33,27,412313,8.082123798848427
doxazosin,Liver Abscess,3,9495,9492,17,14,412326,7.842232468208524
doxazosin,Liver palpable,2,9495,9493,8,6,412334,11.108896028652692
doxazosin,Loose tooth,7,9495,9488,41,34,412306,7.589967301443673
doxazosin,Lordosis,2,9495,9493,5,3,412337,17.774360054777205
doxazosin,Lumpectomy of breast,3,9495,9492,37,34,412306,3.6030170499197047
doxazosin,Lung Neoplasms,2,9495,9493,7,5,412335,12.695911272968052
doxazosin,Lymph node excision,4,9495,9491,33,29,412311,5.386947123750412
doxazosin,Lymphocyte stimulation test positive,9,9495,9486,76,67,412273,5.265142814341356
doxazosin,Lymphoma,18,9495,9477,255,237,412103,3.1400852838761337
doxazosin,Malaria,1,9495,9494,6,5,412335,7.405185731339091
doxazosin,Malignant mesothelioma,1,9495,9494,7,6,412334,6.347287008336092
doxazosin,Malignant neoplasm of breast,2,9495,9493,24,22,412318,3.702824888514344
doxazosin,Malignant neoplasm of thyroid,2,9495,9493,24,22,412318,3.702824888514344
doxazosin,Malnutrition,8,9495,9487,104,96,412244,3.4195052338828034
doxazosin,Mammary Neoplasms,2,9495,9493,20,18,412322,4.443432002528179
doxazosin,Mantoux: positive,1,9495,9494,13,12,412328,3.417721313866248
doxazosin,Mask-like facies,3,9495,9492,11,8,412332,12.119986208481782
doxazosin,Mass of body structure,33,9495,9462,380,347,411993,3.8681081667389785
doxazosin,Mass of stomach,3,9495,9492,10,7,412333,13.332016434892541
doxazosin,Maternal hypertension affecting foetus,11,9495,9484,159,148,412192,3.0759756915984284
doxazosin,Mesenteric artery embolism,4,9495,9491,21,17,412323,8.465443452694533
doxazosin,Metastatic Neoplasm,3,9495,9492,18,15,412325,7.406535327995504
doxazosin,Metastatic malignant neoplasm to mediastinum,2,9495,9493,9,7,412333,9.874550838629633
doxazosin,Metastatic non-small cell lung cancer,2,9495,9493,13,11,412329,6.836162678572876
doxazosin,Milk-Alkali Syndrome,6,9495,9489,29,23,412317,9.196986710565046
doxazosin,Molluscum Contagiosum,3,9495,9492,15,12,412328,8.887905604719764
doxazosin,Monocyte count decreased,1,9495,9494,10,9,412331,4.443069306930694
doxazosin,Morbid thoughts,2,9495,9493,13,11,412329,6.836162678572876
doxazosin,Mucinous carcinoma of breast,1,9495,9494,6,5,412335,7.405185731339091
doxazosin,Mucosal toxicity,2,9495,9493,12,10,412330,7.4058604585835175
doxazosin,Mucous membrane hyperplasia,1,9495,9494,11,10,412330,4.039144339965912
doxazosin,Multiple Sclerosis,2,9495,9493,5,3,412337,17.774360054777205
doxazosin,Myocardial oedema,10,9495,9485,130,120,412220,3.4200154089452988
doxazosin,Myocardial rupture,2,9495,9493,11,9,412331,8.07913965314155
doxazosin,Nail Diseases,2,9495,9493,29,27,412313,3.0643704798817275
doxazosin,Nasal Polyp,2,9495,9493,26,24,412316,3.4179759985090232
doxazosin,Near Drowning,9,9495,9486,26,17,412323,15.392242008465916
doxazosin,Neoplasm of chest wall,1,9495,9494,14,13,412327,3.1735908393270935
doxazosin,Nephrotic Syndrome,1,9495,9494,5,4,412336,8.88624394354329
doxazosin,Neutralising antibodies positive,4,9495,9491,10,6,412334,17.777894847750503
doxazosin,Neutropenia,3,9495,9492,21,18,412322,6.34841370176389
doxazosin,Neutropenic colitis,1,9495,9494,6,5,412335,7.405185731339091
doxazosin,Neutrophilia (finding),37,9495,9458,346,309,412031,4.765544842608087
doxazosin,Occupational exposure to communicable disease,4,9495,9491,36,32,412308,4.93799974244606
doxazosin,Oestradiol decreased,3,9495,9492,36,33,412307,3.7031096361848572
doxazosin,Operative procedure on foot,2,9495,9493,18,16,412324,4.9371700785374015
doxazosin,Oral candidiasis,4,9495,9491,48,44,412296,3.703394443859094
doxazosin,Orbital swelling,17,9495,9478,158,141,412199,4.786907588793235
doxazosin,Ovarian cancer stage IV,4,9495,9491,21,17,412323,8.465443452694533
doxazosin,PCO2 decreased,2,9495,9493,14,12,412328,6.3478502957066105
doxazosin,Palatal edema,7,9495,9488,68,61,412279,4.57601087441722
doxazosin,Pancreatic duct obstruction,3,9495,9492,19,16,412324,7.016701044647015
doxazosin,"Pancreatitis, Acute",108,9495,9387,1247,1139,411201,3.880497085622945
doxazosin,Papillary thyroid carcinoma,3,9495,9492,15,12,412328,8.887905604719764
doxazosin,Paraneoplastic inappropriate antidiuretic hormone secretion,15,9495,9480,200,185,412155,3.3357199367088604
doxazosin,Partitioning of stomach using band,1,9495,9494,6,5,412335,7.405185731339091
doxazosin,Parvovirus B19 test positive,13,9495,9482,33,20,412320,17.52419576486229
doxazosin,Peptic Ulcer,14,9495,9481,105,91,412249,5.930879302464578
doxazosin,Periarthritis,10,9495,9485,52,42,412298,8.551619966749119
doxazosin,Periorbital hematoma,7,9495,9488,8,1,412339,38.901625737774026
doxazosin,Peripheral T-cell lymphoma unspecified stage III,3,9495,9492,6,3,412337,22.220238095238095
doxazosin,Peritoneal cloudy effluent,1,9495,9494,13,12,412328,3.417721313866248
doxazosin,Peritonitis,9,9495,9486,70,61,412279,5.7165220927080505
doxazosin,Pili incarnati (disorder),2,9495,9493,18,16,412324,4.9371700785374015
doxazosin,Pilonidal Cyst,3,9495,9492,41,38,412302,3.251472356695754
doxazosin,Plasmacytoma,7,9495,9488,41,34,412306,7.589967301443673
doxazosin,Platelet count outside reference range,1,9495,9494,6,5,412335,7.405185731339091
doxazosin,Pleural Neoplasms,74,9495,9421,693,619,411721,4.773424266471714
doxazosin,Pleural infection bacterial,1,9495,9494,8,7,412333,5.553862966083843
doxazosin,Pneumonitis,4,9495,9491,55,51,412289,3.231999693489526
doxazosin,Polycystic liver disease,1,9495,9494,11,10,412330,4.039144339965912
doxazosin,Polycythemia,2,9495,9493,24,22,412318,3.702824888514344
doxazosin,Poriomania,1,9495,9494,12,11,412329,3.702540200828593
doxazosin,Premature Obstetric Labor,5,9495,9490,44,39,412301,5.0506633777181715
doxazosin,Product availability issue,16,9495,9479,146,130,412210,4.87524983127808
doxazosin,Product compounding quality issue,1,9495,9494,6,5,412335,7.405185731339091
doxazosin,Product formulation issue,10,9495,9485,24,14,412326,18.529739940256547
doxazosin,Product shape issue,2,9495,9493,15,13,412327,5.924646230555848
doxazosin,Product tampering,3,9495,9492,11,8,412332,12.119986208481782
doxazosin,Productive Cough,8,9495,9487,106,98,412242,3.3549703566548863
doxazosin,Prostate specific antigen outside reference range,5,9495,9490,27,22,412318,8.231042422823243
doxazosin,Prosthesis Implantation,3,9495,9492,8,5,412335,16.665099557522126
doxazosin,Protein/Creatinine ratio in urine above normal,1,9495,9494,6,5,412335,7.405185731339091
doxazosin,Pseudo-Bartter syndrome,3,9495,9492,42,39,412301,3.1740488230690502
doxazosin,Pseudoendophthalmitis,7,9495,9488,14,7,412333,22.22918423271501
doxazosin,Psychogenic polydipsia,1,9495,9494,9,8,412332,4.936755377665426
doxazosin,Pterygium of eye,2,9495,9493,7,5,412335,12.695911272968052
doxazosin,Ptosis of eyebrow,1,9495,9494,13,12,412328,3.417721313866248
doxazosin,Pulpitis,2,9495,9493,15,13,412327,5.924646230555848
doxazosin,Pyelonephritis,16,9495,9479,170,154,412186,4.186740969201268
doxazosin,Rales,32,9495,9463,375,343,411997,3.800548099616049
doxazosin,Reading disorder,6,9495,9489,78,72,412268,3.4189952738798777
doxazosin,Rectal hemorrhage,3,9495,9492,43,40,412300,3.100226384029636
doxazosin,Recurrent Chronic Lymphoid Leukemia,5,9495,9490,43,38,412302,5.168132918371848
doxazosin,Recurrent Liver Carcinoma,1,9495,9494,6,5,412335,7.405185731339091
doxazosin,Red blood cell schistocytes present,1,9495,9494,12,11,412329,3.702540200828593
doxazosin,Red man syndrome,2,9495,9493,11,9,412331,8.07913965314155
doxazosin,Renal transplant rejection,4,9495,9491,55,51,412289,3.231999693489526
doxazosin,Renal tubular disorder,2,9495,9493,19,17,412323,4.67730793326939
doxazosin,Residual schizophrenia,3,9495,9492,5,2,412338,26.66434892541087
doxazosin,"Respiratory Distress Syndrome, Adult",2,9495,9493,25,23,412317,3.554703465711577
doxazosin,Restless Legs Syndrome,17,9495,9478,173,156,412184,4.371702281035365
doxazosin,Resuscitation (procedure),1,9495,9494,7,6,412334,6.347287008336092
doxazosin,Retinoic acid syndrome,1,9495,9494,6,5,412335,7.405185731339091
doxazosin,"Sarcoidosis, Pulmonary",1,9495,9494,9,8,412332,4.936755377665426
doxazosin,Scarred macula,2,9495,9493,13,11,412329,6.836162678572876
doxazosin,Scleroderma,1,9495,9494,9,8,412332,4.936755377665426
doxazosin,Secondary hypoparathyroidism,1,9495,9494,8,7,412333,5.553862966083843
doxazosin,Secondary malignant neoplasm of ovary,4,9495,9491,9,5,412335,19.753263325489645
doxazosin,"Shock, Hemorrhagic",8,9495,9487,11,3,412337,32.33699703901032
doxazosin,Shortened QT interval,2,9495,9493,6,4,412336,14.811931598721863
doxazosin,Shortened therapeutic response,4,9495,9491,7,3,412337,25.3971732618872
doxazosin,Sjogren-Larsson Syndrome,6,9495,9489,79,73,412267,3.3757088487535865
doxazosin,Skin laceration,3,9495,9492,14,11,412329,9.522778580458732
doxazosin,Skin sensitisation,4,9495,9491,38,34,412306,4.678082837480383
doxazosin,Solar dermatitis,1,9495,9494,5,4,412336,8.88624394354329
doxazosin,Splenic hematoma,5,9495,9490,9,4,412336,24.694181009249505
doxazosin,Spontaneous penile erection,1,9495,9494,11,10,412330,4.039144339965912
doxazosin,Squamous cell carcinoma of the hypopharynx recurrent,1,9495,9494,10,9,412331,4.443069306930694
doxazosin,Staphylococcal Scalded Skin Syndrome,2,9495,9493,14,12,412328,6.3478502957066105
doxazosin,Steatohepatitis,6,9495,9489,79,73,412267,3.3757088487535865
doxazosin,Stenosis of ureter,1,9495,9494,6,5,412335,7.405185731339091
doxazosin,Stoma site haemorrhage,1,9495,9494,14,13,412327,3.1735908393270935
doxazosin,Streptococcal pneumonia,3,9495,9492,23,20,412320,5.796350244599571
doxazosin,Streptococcal urinary tract infection,2,9495,9493,10,8,412332,8.887074686611188
doxazosin,Subacute thyroiditis,4,9495,9491,13,9,412331,13.675206470907662
doxazosin,Subarachnoid Hemorrhage,2,9495,9493,15,13,412327,5.924646230555848
doxazosin,Substance-induced mood disorder,2,9495,9493,19,17,412323,4.67730793326939
doxazosin,Surgical Wound Infection,2,9495,9493,12,10,412330,7.4058604585835175
doxazosin,Surgical procedure on eye proper,1,9495,9494,12,11,412329,3.702540200828593
doxazosin,Swelling of scrotum,3,9495,9492,25,22,412318,5.332616940581542
doxazosin,Tenotomy (procedure),1,9495,9494,5,4,412336,8.88624394354329
doxazosin,Terminal state,4,9495,9491,40,36,412304,4.444157623011274
doxazosin,Therapeutic product ineffective,5,9495,9490,57,52,412288,3.89863753165844
doxazosin,Thrombosis of renal artery,5,9495,9490,45,40,412300,4.938414705537993
doxazosin,Tobacco user,3,9495,9492,24,21,412319,5.554822482090182
doxazosin,Tonsillitis,1,9495,9494,7,6,412334,6.347287008336092
doxazosin,Torsades de Pointes,9,9495,9486,44,35,412305,9.095027600483009
doxazosin,Total lung capacity abnormal,10,9495,9485,18,8,412332,24.70667135242781
doxazosin,Toxic Optic Neuropathy,2,9495,9493,9,7,412333,9.874550838629633
doxazosin,Tracheal Diseases,2,9495,9493,16,14,412326,5.554342673548931
doxazosin,Transurethral Resection of Prostate,3,9495,9492,6,3,412337,22.220238095238095
doxazosin,Trigeminal Neuralgia,4,9495,9491,24,20,412320,7.407210339619991
doxazosin,"Tuberculosis, Bovine",3,9495,9492,32,29,412311,4.166037847661189
doxazosin,Tumor pain,1,9495,9494,13,12,412328,3.417721313866248
doxazosin,Ubiquinone decreased,1,9495,9494,10,9,412331,4.443069306930694
doxazosin,Uhthoff's phenomenon,4,9495,9491,24,20,412320,7.407210339619991
doxazosin,Unilateral deafness,2,9495,9493,23,21,412319,3.8638264350390905
doxazosin,Urinary tract infection pseudomonal,1,9495,9494,11,10,412330,4.039144339965912
doxazosin,Urine albumin/creatinine ratio increased,1,9495,9494,13,12,412328,3.417721313866248
doxazosin,Urinoma,2,9495,9493,18,16,412324,4.9371700785374015
doxazosin,Uterine Prolapse,2,9495,9493,21,19,412321,4.2318299699527975
doxazosin,Vaccination site swelling,6,9495,9489,76,70,412270,3.508985473484533
doxazosin,Vaginal lesion,2,9495,9493,26,24,412316,3.4179759985090232
doxazosin,Vanishing bile duct syndrome,1,9495,9494,8,7,412333,5.553862966083843
doxazosin,Vascular Diseases,1,9495,9494,7,6,412334,6.347287008336092
doxazosin,Vascular pain,1,9495,9494,11,10,412330,4.039144339965912
doxazosin,Venous valve ruptured,3,9495,9492,16,13,412327,8.332391750948167
doxazosin,Vertebral Artery Stenosis,1,9495,9494,5,4,412336,8.88624394354329
doxazosin,Visual field defects,5,9495,9490,28,23,412317,7.93705780520849
doxazosin,Vitrectomy,4,9495,9491,29,25,412315,6.130032444530026
doxazosin,Vulvovaginal pain,4,9495,9491,23,19,412321,7.72928128707746
doxazosin,Weaning failure,2,9495,9493,16,14,412326,5.554342673548931
doxazosin,Wheezing,11,9495,9484,160,149,412191,3.0567435944749057
doxazosin,Wolff-Parkinson-White Syndrome,1,9495,9494,10,9,412331,4.443069306930694
doxazosin,Wound infection pseudomonas,2,9495,9493,27,25,412315,3.2913764918399915
doxazosin,Wrong schedule,2,9495,9493,13,11,412329,6.836162678572876
enalapril,Abdominal wall cyst,2,29504,29502,6,4,392327,4.766106252683434
enalapril,Abdominal wall haemorrhage,2,29504,29502,8,6,392325,3.57456274150905
enalapril,Abnormal weight gain,3,29504,29501,7,4,392327,6.128044085672641
enalapril,Abruptio Placentae,3,29504,29501,14,11,392320,3.063971197102277
enalapril,Abscess of abdominal wall,5,29504,29499,7,2,392329,10.214099267287512
enalapril,Absence of sensation,9,29504,29495,37,28,392303,3.4785391935417365
enalapril,Accessory nipple,2,29504,29502,6,4,392327,4.766106252683434
enalapril,Accidental underdose,2,29504,29502,8,6,392325,3.57456274150905
enalapril,Acquired hemophilia,4,29504,29500,8,4,392327,7.149610169491525
enalapril,Acute respiratory failure,5,29504,29499,20,15,392316,3.5748245703244175
enalapril,Acute superior sagittal sinus thrombosis,8,29504,29496,25,17,392314,4.576186601573095
enalapril,Adenocarcinoma Of Esophagus,10,29504,29494,24,14,392317,5.958994484753962
enalapril,Adenomatous Polyposis Coli,8,29504,29496,33,25,392306,3.466742280411931
enalapril,Adrenal atrophy,2,29504,29502,6,4,392327,4.766106252683434
enalapril,Adult-Onset Still Disease,2,29504,29502,6,4,392327,4.766106252683434
enalapril,Alcohol test false positive,3,29504,29501,6,3,392328,7.149401715196095
enalapril,Allergy to dust,5,29504,29499,6,1,392330,11.916477394713946
enalapril,Anaemia of malignant disease,3,29504,29501,9,6,392325,4.766233912974701
enalapril,Aneurysm of splenic artery,3,29504,29501,7,4,392327,6.128044085672641
enalapril,"Angina Pectoris, Variant",8,29504,29496,31,23,392308,3.690420570968617
enalapril,Angioplasty renal artery,3,29504,29501,13,10,392321,3.2996691116076904
enalapril,Anorectal discomfort,16,29504,29488,24,8,392323,9.536331162958943
enalapril,Anticoagulation drug level below therapeutic,12,29504,29492,16,4,392327,10.727120914146209
enalapril,Anticonvulsant drug level decreased,3,29504,29501,9,6,392325,4.766233912974701
enalapril,Antineutrophil cytoplasmic antibody measurement,3,29504,29501,5,2,392329,8.57930239652893
enalapril,Antisocial behavior,3,29504,29501,8,5,392326,5.362025863530049
enalapril,Aortic Injury,6,29504,29498,18,12,392319,4.766616945781635
enalapril,Apnea,3,29504,29501,14,11,392320,3.063971197102277
enalapril,Application site blister,5,29504,29499,11,6,392325,6.499819716538927
enalapril,Arterial hemorrhage,2,29504,29502,7,5,392326,4.085224246298072
enalapril,"Arthritis, Bacterial",2,29504,29502,6,4,392327,4.766106252683434
enalapril,Attention deficit hyperactivity disorder,9,29504,29495,17,8,392323,7.5712972288423765
enalapril,Aura,4,29504,29500,18,14,392317,3.1775291902071565
enalapril,Autonomic nervous system imbalance,11,29504,29493,35,24,392307,4.494819593995669
enalapril,Bacterial Infections,3,29504,29501,5,2,392329,8.57930239652893
enalapril,Bacterial osteomyelitis,10,29504,29494,38,28,392303,3.763450550156499
enalapril,Bacteriuria,8,29504,29496,23,15,392316,4.974139455902643
enalapril,Bilateral Deafness,4,29504,29500,13,9,392322,4.399707953063885
enalapril,Biliary stent placement,2,29504,29502,8,6,392325,3.57456274150905
enalapril,Bladder malposition acquired,8,29504,29496,29,21,392310,3.944951039533122
enalapril,Bladder tamponade,3,29504,29501,12,9,392322,3.5746500118640046
enalapril,Bleeding gastric ulcer,11,29504,29493,51,40,392291,3.084563103375145
enalapril,Blood HIV RNA decreased,3,29504,29501,7,4,392327,6.128044085672641
enalapril,Blood antidiuretic hormone increased,3,29504,29501,5,2,392329,8.57930239652893
enalapril,Blood bicarbonate level decreased below normal,6,29504,29498,11,5,392326,7.80004807721941
enalapril,Blood calcitonin increased,6,29504,29498,15,9,392322,5.7199810156620785
enalapril,Blood cholesterol decreased,10,29504,29494,46,36,392295,3.10887844543179
enalapril,Blood stem cell harvest failure,2,29504,29502,9,7,392324,3.177381571117589
enalapril,Bone density decreased,6,29504,29498,9,3,392328,9.533437295183854
enalapril,Bone trimming,3,29504,29501,14,11,392320,3.063971197102277
enalapril,Brain stem syndrome,3,29504,29501,5,2,392329,8.57930239652893
enalapril,Bromhidrosis,2,29504,29502,7,5,392326,4.085224246298072
enalapril,Bronchial aspiration procedure,3,29504,29501,7,4,392327,6.128044085672641
enalapril,Bronchopneumopathy,12,29504,29492,21,9,392322,8.172947627443762
enalapril,Bronchopulmonary disease,2,29504,29502,5,3,392328,5.719341061622941
enalapril,Bunion,6,29504,29498,19,13,392318,4.51573166423415
enalapril,Cancer Remission,4,29504,29500,12,8,392323,4.766361581920903
enalapril,Carotid Artery Thrombosis,2,29504,29502,9,7,392324,3.177381571117589
enalapril,Carotid Atherosclerosis,6,29504,29498,26,20,392311,3.2999029921194136
enalapril,Carotid artery embolism,8,29504,29496,11,3,392328,10.400769287669206
enalapril,Carotid intima-media thickness increased,11,29504,29493,27,16,392315,5.826728501803943
enalapril,Cavitation of lung,12,29504,29492,27,15,392316,6.3566466235664665
enalapril,Cerebral disorder,2,29504,29502,9,7,392324,3.177381571117589
enalapril,Chondroplasty,32,29504,29472,87,55,392276,5.263494202952812
enalapril,Choroidal Effusions,3,29504,29501,13,10,392321,3.2996691116076904
enalapril,Complement factor C3 decreased,3,29504,29501,9,6,392325,4.766233912974701
enalapril,Concomitant disease aggravated,4,29504,29500,17,13,392318,3.3644506480558323
enalapril,Concomitant disease progression,2,29504,29502,7,5,392326,4.085224246298072
enalapril,Conjunctival deposit,2,29504,29502,5,3,392328,5.719341061622941
enalapril,Contracted bladder,6,29504,29498,6,0,392331,14.300257644586075
enalapril,Contracture,2,29504,29502,6,4,392327,4.766106252683434
enalapril,Corneal Endothelial Cell Loss,2,29504,29502,5,3,392328,5.719341061622941
enalapril,Critical Illness,2,29504,29502,9,7,392324,3.177381571117589
enalapril,Cutaneous plaque,3,29504,29501,13,10,392321,3.2996691116076904
enalapril,Cyst of thyroid,3,29504,29501,8,5,392326,5.362025863530049
enalapril,Cyst of tongue,2,29504,29502,6,4,392327,4.766106252683434
enalapril,Cyst of vulva,2,29504,29502,5,3,392328,5.719341061622941
enalapril,Degenerative skin disorder,3,29504,29501,8,5,392326,5.362025863530049
enalapril,Delayed Emergence from Anesthesia,2,29504,29502,6,4,392327,4.766106252683434
enalapril,Device battery issue,4,29504,29500,8,4,392327,7.149610169491525
enalapril,Device component issue,8,29504,29496,23,15,392316,4.974139455902643
enalapril,Device defective,2,29504,29502,5,3,392328,5.719341061622941
enalapril,Device difficult to use,14,29504,29490,56,42,392289,3.575610376398779
enalapril,Device occlusion,3,29504,29501,12,9,392322,3.5746500118640046
enalapril,Dextrocardia,3,29504,29501,6,3,392328,7.149401715196095
enalapril,Diabetic ketoacidotic hyperglycaemic coma,3,29504,29501,14,11,392320,3.063971197102277
enalapril,Diabetic metabolic decompensation,3,29504,29501,6,3,392328,7.149401715196095
enalapril,Difficulty weight-bearing,13,29504,29491,61,48,392283,3.0479218166587083
enalapril,Digestive System Fistula,3,29504,29501,14,11,392320,3.063971197102277
enalapril,Dilatation of pulmonary artery (disorder),2,29504,29502,7,5,392326,4.085224246298072
enalapril,Disease of diaphragm,8,29504,29496,37,29,392302,3.091930009749375
enalapril,Disorder of endocrine pancreas,3,29504,29501,10,7,392324,4.289600352530423
enalapril,Disorder of extraocular muscle,5,29504,29499,12,7,392324,5.958153948721426
enalapril,Disorder of ocular blood vessel,4,29504,29500,5,1,392330,11.439457627118644
enalapril,Disuse syndrome,2,29504,29502,7,5,392326,4.085224246298072
enalapril,Double kidney (disorder),2,29504,29502,7,5,392326,4.085224246298072
enalapril,Drooling,9,29504,29495,34,25,392306,3.785496046189284
enalapril,Drug dose titration not performed,3,29504,29501,10,7,392324,4.289600352530423
enalapril,Drug level below therapeutic,3,29504,29501,14,11,392320,3.063971197102277
enalapril,Dwarfism,12,29504,29492,35,23,392308,4.90360582046463
enalapril,Dyslalia,7,29504,29497,12,5,392326,8.341981105423152
enalapril,EKG: QRS complex abnormal,7,29504,29497,7,0,392331,14.300708546631862
enalapril,Ear discharge,6,29504,29498,16,10,392321,5.362469489456913
enalapril,Ectopic Pregnancy,4,29504,29500,12,8,392323,4.766361581920903
enalapril,Eczema,16,29504,29488,64,48,392283,3.5757850651112313
enalapril,Embolic Stroke,9,29504,29495,15,6,392325,8.5808442108832
enalapril,Embolism,2,29504,29502,8,6,392325,3.57456274150905
enalapril,Erythrocyte sedimentation rate below reference range,4,29504,29500,7,3,392328,8.171002421307506
enalapril,Esophageal mass,2,29504,29502,6,4,392327,4.766106252683434
enalapril,Exposure via body fluid,4,29504,29500,12,8,392323,4.766361581920903
enalapril,Exposure via breast milk,2,29504,29502,7,5,392326,4.085224246298072
enalapril,"Eye Infections, Bacterial",12,29504,29492,39,27,392304,4.400630157852456
enalapril,Failure to lose weight,5,29504,29499,16,11,392320,4.468573087223296
enalapril,Febrile infection,4,29504,29500,16,12,392319,3.574737288135593
enalapril,Fine motor delay,4,29504,29500,17,13,392318,3.3644506480558323
enalapril,Food aversion,2,29504,29502,5,3,392328,5.719341061622941
enalapril,Foreign-Body Reaction,6,29504,29498,11,5,392326,7.80004807721941
enalapril,Formication,9,29504,29495,34,25,392306,3.785496046189284
enalapril,Fracture of clavicle,2,29504,29502,9,7,392324,3.177381571117589
enalapril,Fracture of sternum,17,29504,29487,54,37,392294,4.503099922250734
enalapril,Furunculosis of skin AND/OR subcutaneous tissue,4,29504,29500,16,12,392319,3.574737288135593
enalapril,Gas retention,2,29504,29502,9,7,392324,3.177381571117589
enalapril,Gastric hemorrhage,12,29504,29492,42,30,392301,4.0862703687198465
enalapril,Gastric ulcer operation,4,29504,29500,19,15,392316,3.0102836752899194
enalapril,Gastroenteritis pseudomonas,7,29504,29497,25,18,392313,4.004027528223209
enalapril,Gastrointestinal melanosis,6,29504,29498,7,1,392330,12.257334637699408
enalapril,Gastrointestinal mucosa hyperaemia,2,29504,29502,6,4,392327,4.766106252683434
enalapril,Genital infection fungal,2,29504,29502,6,4,392327,4.766106252683434
enalapril,Globulin below reference range,2,29504,29502,9,7,392324,3.177381571117589
enalapril,Glucocorticoid deficiency,2,29504,29502,8,6,392325,3.57456274150905
enalapril,"Graft Occlusion, Vascular",11,29504,29493,45,34,392297,3.4958879131394642
enalapril,Graves Disease,10,29504,29494,46,36,392295,3.10887844543179
enalapril,Heart Injuries,99,29504,29405,212,113,392218,6.695799552765061
enalapril,Heart valve disease,2,29504,29502,9,7,392324,3.177381571117589
enalapril,Hemodynamic instability,13,29504,29491,51,38,392293,3.6456399792292893
enalapril,Histrionic Personality Disorder,5,29504,29499,21,16,392315,3.404586757581774
enalapril,Horner Syndrome,5,29504,29499,8,3,392328,8.937315671717686
enalapril,Hyperglycaemic seizure,2,29504,29502,8,6,392325,3.57456274150905
enalapril,Hypernatremia,24,29504,29480,29,5,392326,11.841276376737005
enalapril,Hyperproteinemia,4,29504,29500,18,14,392317,3.1775291902071565
enalapril,Hypertrophy of tonsils,2,29504,29502,5,3,392328,5.719341061622941
enalapril,Hypochondriasis,6,29504,29498,22,16,392315,3.899922336799413
enalapril,Hypogammaglobulinemia,3,29504,29501,6,3,392328,7.149401715196095
enalapril,Ileocolectomy,3,29504,29501,11,8,392323,3.8996274394396493
enalapril,Impaired fasting glycemia,4,29504,29500,7,3,392328,8.171002421307506
enalapril,Impairment of urinary concentration,2,29504,29502,5,3,392328,5.719341061622941
enalapril,Inadequate food diet,3,29504,29501,7,4,392327,6.128044085672641
enalapril,Increased bone formation,7,29504,29497,32,25,392306,3.128094594365529
enalapril,Increased systolic arterial pressure,4,29504,29500,11,7,392324,5.1996795069337445
enalapril,Infarction of basal ganglia,2,29504,29502,7,5,392326,4.085224246298072
enalapril,Infectious pleural effusion,8,29504,29496,15,7,392324,7.627158484766296
enalapril,Infrequent bowel movements,2,29504,29502,6,4,392327,4.766106252683434
enalapril,Infusion site reaction,2,29504,29502,8,6,392325,3.57456274150905
enalapril,Infusion site thrombosis,3,29504,29501,6,3,392328,7.149401715196095
enalapril,Injected limb mobility decreased,6,29504,29498,27,21,392310,3.1776768293142283
enalapril,Injection site infection,4,29504,29500,6,2,392329,9.532858757062147
enalapril,Injury of liver,30,29504,29474,105,75,392256,4.088155177929216
enalapril,Injury of pharynx,2,29504,29502,6,4,392327,4.766106252683434
enalapril,Injury of urethra,4,29504,29500,17,13,392318,3.3644506480558323
enalapril,Instillation site reaction,3,29504,29501,6,3,392328,7.149401715196095
enalapril,Intelligence increased,4,29504,29500,10,6,392325,5.7196610169491535
enalapril,Intervertebral disc annular tear,3,29504,29501,12,9,392322,3.5746500118640046
enalapril,Intraocular pressure test abnormal,7,29504,29497,24,17,392314,4.1708718965770535
enalapril,Irritable Bowel Syndrome,15,29504,29489,27,12,392319,7.946616629176228
enalapril,Irritable Mood,5,29504,29499,18,13,392318,3.972046133390586
enalapril,Laboratory test interference,2,29504,29502,7,5,392326,4.085224246298072
enalapril,Latent Tuberculosis,3,29504,29501,8,5,392326,5.362025863530049
enalapril,Left cardiac ventricular dilatation,2,29504,29502,6,4,392327,4.766106252683434
enalapril,Leukocytoclastic vasculitis,36,29504,29468,122,86,392245,4.222882504389312
enalapril,Liver enzymes abnormal,3,29504,29501,13,10,392321,3.2996691116076904
enalapril,Loss of anatomical alignment after fracture reduction,22,29504,29482,75,53,392278,4.19633222531262
enalapril,Lymphoma transformation,2,29504,29502,6,4,392327,4.766106252683434
enalapril,Macular retinal cyst,8,29504,29496,13,5,392326,8.800609209071373
enalapril,Malignant Vaginal Neoplasm,2,29504,29502,8,6,392325,3.57456274150905
enalapril,Manufacturing issue,3,29504,29501,13,10,392321,3.2996691116076904
enalapril,Mechanical ventilation,3,29504,29501,14,11,392320,3.063971197102277
enalapril,Medial Tibial Stress Syndrome,8,29504,29496,19,11,392320,6.021383809401453
enalapril,Melena,21,29504,29483,86,65,392266,3.4930373751054016
enalapril,Meningeal disorder,14,29504,29490,43,29,392302,4.656752387486495
enalapril,Menopause,20,29504,29484,36,16,392315,7.947794660757624
enalapril,Mesenteritis,4,29504,29500,10,6,392325,5.7196610169491535
enalapril,Metastases to stomach,4,29504,29500,5,1,392330,11.439457627118644
enalapril,Metastatic malignant neoplasm to kidney,7,29504,29497,15,8,392323,6.673537421884712
enalapril,Metastatic malignant neoplasm to spleen,9,29504,29495,24,15,392316,5.362913205628073
enalapril,Migraine with Aura,3,29504,29501,9,6,392325,4.766233912974701
enalapril,Mole excision,19,29504,29485,82,63,392268,3.3143380056829232
enalapril,Morose,4,29504,29500,17,13,392318,3.3644506480558323
enalapril,Morton Neuroma,2,29504,29502,9,7,392324,3.177381571117589
enalapril,Multiple Sclerosis,2,29504,29502,5,3,392328,5.719341061622941
enalapril,Muscular Atrophy,28,29504,29476,95,67,392264,4.217068658891087
enalapril,Mycobacterial peritonitis,2,29504,29502,6,4,392327,4.766106252683434
enalapril,Myocardial fibrosis,5,29504,29499,9,4,392327,7.944261764052266
enalapril,Necrosis of kidney,4,29504,29500,9,5,392326,6.355193973634651
enalapril,Needle issue,13,29504,29491,59,46,392285,3.1512561430692156
enalapril,Negativism,8,29504,29496,17,9,392322,6.729813813238884
enalapril,"Nephritis, Tubulointerstitial",4,29504,29500,9,5,392326,6.355193973634651
enalapril,Nephroptosis,8,29504,29496,25,17,392314,4.576186601573095
enalapril,Neurodermatitis,15,29504,29489,69,54,392277,3.1092360157877588
enalapril,Neutrophilic dermatosis,2,29504,29502,9,7,392324,3.177381571117589
enalapril,Nocturia,6,29504,29498,23,17,392314,3.7303516524333262
enalapril,Nonalcoholic Steatohepatitis,6,29504,29498,26,20,392311,3.2999029921194136
enalapril,Occlusion of inferior vena cava,2,29504,29502,9,7,392324,3.177381571117589
enalapril,Onycholysis,3,29504,29501,8,5,392326,5.362025863530049
enalapril,Operative procedure on foot,4,29504,29500,18,14,392317,3.1775291902071565
enalapril,Organ Transplantation,2,29504,29502,5,3,392328,5.719341061622941
enalapril,Osteogenesis Imperfecta,10,29504,29494,32,22,392309,4.469161100562826
enalapril,"Osteoporosis, Postmenopausal",3,29504,29501,8,5,392326,5.362025863530049
enalapril,Ovariectomy,2,29504,29502,8,6,392325,3.57456274150905
enalapril,Paradoxical drug reaction,2,29504,29502,5,3,392328,5.719341061622941
enalapril,Paroxysmal nocturnal dyspnea,7,29504,29497,18,11,392320,5.561241632859085
enalapril,Pelvic mass,3,29504,29501,12,9,392322,3.5746500118640046
enalapril,Penetrating Atherosclerotic Ulcer,5,29504,29499,17,12,392319,4.205705876370685
enalapril,Penile haematoma,6,29504,29498,13,7,392324,6.600009387859412
enalapril,Peptic Ulcer Perforation,2,29504,29502,6,4,392327,4.766106252683434
enalapril,Perforation of stomach,46,29504,29458,132,86,392245,4.988699370649944
enalapril,Perianal erythema,3,29504,29501,14,11,392320,3.063971197102277
enalapril,Peripheral T-cell lymphoma unspecified stage III,2,29504,29502,6,4,392327,4.766106252683434
enalapril,Plague,5,29504,29499,19,14,392317,3.7629821528294447
enalapril,Platelet Transfusion,2,29504,29502,8,6,392325,3.57456274150905
enalapril,Pleurocutaneous fistula,6,29504,29498,10,4,392327,8.58007322530341
enalapril,Poor personal hygiene,9,29504,29495,10,1,392330,12.871418884556704
enalapril,Post procedural inflammation,3,29504,29501,7,4,392327,6.128044085672641
enalapril,Post-injection delirium sedation syndrome,7,29504,29497,8,1,392330,12.513090314269247
enalapril,Posterior reversible encephalopathy syndrome,2,29504,29502,5,3,392328,5.719341061622941
enalapril,Postoperative abscess,5,29504,29499,11,6,392325,6.499819716538927
enalapril,Postoperative confusion,3,29504,29501,14,11,392320,3.063971197102277
enalapril,Pre-existing condition improved,3,29504,29501,12,9,392322,3.5746500118640046
enalapril,Primary Hypothyroidism,3,29504,29501,8,5,392326,5.362025863530049
enalapril,Procedural nausea,3,29504,29501,12,9,392322,3.5746500118640046
enalapril,Proctitis infectious,4,29504,29500,19,15,392316,3.0102836752899194
enalapril,Product compounding quality issue,2,29504,29502,6,4,392327,4.766106252683434
enalapril,Product physical issue,5,29504,29499,15,10,392321,4.766489259522922
enalapril,Pseudomonal sepsis,5,29504,29499,6,1,392330,11.916477394713946
enalapril,Pterygium of eye,2,29504,29502,7,5,392326,4.085224246298072
enalapril,Pulmonary Infarction,28,29504,29476,99,71,392260,4.046643665587892
enalapril,Pulmonary arterial hypertension,5,29504,29499,21,16,392315,3.404586757581774
enalapril,Pulmonary artery thrombosis,6,29504,29498,14,8,392323,6.128565617039412
enalapril,Pulmonary cryptococcosis,9,29504,29495,27,18,392313,4.767000056506752
enalapril,Pulmonary function challenge test abnormal,19,29504,29485,57,38,392293,4.768277655304957
enalapril,Pulmonary sepsis,2,29504,29502,6,4,392327,4.766106252683434
enalapril,Pulsus paradoxus,6,29504,29498,16,10,392321,5.362469489456913
enalapril,Pupillary light reflex tests abnormal,2,29504,29502,9,7,392324,3.177381571117589
enalapril,Pustular acne,3,29504,29501,6,3,392328,7.149401715196095
enalapril,Pyometra,2,29504,29502,9,7,392324,3.177381571117589
enalapril,Refusal of treatment by relative,2,29504,29502,9,7,392324,3.177381571117589
enalapril,Respiratory tract oedema,2,29504,29502,6,4,392327,4.766106252683434
enalapril,Reticulocyte count increased,2,29504,29502,6,4,392327,4.766106252683434
enalapril,Retinal Vascular Disorder,2,29504,29502,8,6,392325,3.57456274150905
enalapril,Retinal pigment epitheliopathy,5,29504,29499,19,14,392317,3.7629821528294447
enalapril,Right atrial dilatation,2,29504,29502,6,4,392327,4.766106252683434
enalapril,"Sarcoidosis, Pulmonary",2,29504,29502,9,7,392324,3.177381571117589
enalapril,Sarcoma,2,29504,29502,5,3,392328,5.719341061622941
enalapril,Sarcopenia,4,29504,29500,16,12,392319,3.574737288135593
enalapril,Schistosomiasis,5,29504,29499,13,8,392323,5.49982137595277
enalapril,Sciatica,19,29504,29485,69,50,392281,3.938899907346649
enalapril,Senile cardiac amyloidosis,10,29504,29494,14,4,392327,10.215661296728632
enalapril,Senile dementia,11,29504,29493,30,19,392312,5.244018354637824
enalapril,Sensory disorder of eyelid,2,29504,29502,8,6,392325,3.57456274150905
enalapril,Shunt stenosis,2,29504,29502,7,5,392326,4.085224246298072
enalapril,Sigmoiditis,2,29504,29502,8,6,392325,3.57456274150905
enalapril,Skeletal injury,14,29504,29490,51,37,392294,3.926206956163273
enalapril,Skin Papilloma,6,29504,29498,23,17,392314,3.7303516524333262
enalapril,Sperm concentration decreased,4,29504,29500,6,2,392329,9.532858757062147
enalapril,Spinal Cord Ischemia,5,29504,29499,14,9,392322,5.1069648850082086
enalapril,Splenic Diseases,2,29504,29502,5,3,392328,5.719341061622941
enalapril,Splenic cyst,9,29504,29495,20,11,392320,6.435556874046449
enalapril,Squamous cell carcinoma of the hypopharynx recurrent,9,29504,29495,10,1,392330,12.871418884556704
enalapril,Stage II Rectal Cancer,2,29504,29502,7,5,392326,4.085224246298072
enalapril,Stage IV Non-Hodgkin Lymphoma,3,29504,29501,10,7,392324,4.289600352530423
enalapril,Stage IV Renal Cell Cancer,2,29504,29502,5,3,392328,5.719341061622941
enalapril,Stenting,8,29504,29496,23,15,392316,4.974139455902643
enalapril,Stoma site extravasation,2,29504,29502,6,4,392327,4.766106252683434
enalapril,Streptococcal Infections,4,29504,29500,6,2,392329,9.532858757062147
enalapril,Stridor,20,29504,29484,69,49,392282,4.146351054563615
enalapril,Stupor,2,29504,29502,7,5,392326,4.085224246298072
enalapril,Sweat discolouration,2,29504,29502,5,3,392328,5.719341061622941
enalapril,Swelling of structure of eye,2,29504,29502,6,4,392327,4.766106252683434
enalapril,Tachyarrhythmia,18,29504,29486,36,18,392313,7.152530014244048
enalapril,Tachypnea,14,29504,29490,51,37,392294,3.926206956163273
enalapril,Teeth brittle,2,29504,29502,6,4,392327,4.766106252683434
enalapril,Tenderness of gums,7,29504,29497,31,24,392307,3.2290085268376116
enalapril,Thoracentesis,2,29504,29502,6,4,392327,4.766106252683434
enalapril,Thrombosis of subclavian vein,3,29504,29501,7,4,392327,6.128044085672641
enalapril,Traumatic hematuria,15,29504,29489,20,5,392326,10.728110481874596
enalapril,Tri-iodothyronine uptake decreased,3,29504,29501,6,3,392328,7.149401715196095
enalapril,Trichotillomania,4,29504,29500,5,1,392330,11.439457627118644
enalapril,Tuberculous abscess central nervous system,15,29504,29489,17,2,392329,12.621396213543235
enalapril,Tuberous Sclerosis,2,29504,29502,6,4,392327,4.766106252683434
enalapril,Tubo-ovarian abscess,2,29504,29502,8,6,392325,3.57456274150905
enalapril,Uhthoff's phenomenon,6,29504,29498,24,18,392313,3.5749118584310806
enalapril,Ulcer on tongue,2,29504,29502,5,3,392328,5.719341061622941
enalapril,Ultrasound liver abnormal,10,29504,29494,41,31,392300,3.488051310973542
enalapril,Underweight,3,29504,29501,10,7,392324,4.289600352530423
enalapril,Urethrorectal fistula,3,29504,29501,9,6,392325,4.766233912974701
enalapril,Urine albumin/creatinine ratio increased,6,29504,29498,13,7,392324,6.600009387859412
enalapril,Urine sodium abnormal,2,29504,29502,8,6,392325,3.57456274150905
enalapril,Uterine Diseases,2,29504,29502,8,6,392325,3.57456274150905
enalapril,Uveitis,28,29504,29476,92,64,392267,4.354612743160243
enalapril,Vaccination site erythema,2,29504,29502,7,5,392326,4.085224246298072
enalapril,Vascular Diseases,2,29504,29502,7,5,392326,4.085224246298072
enalapril,Venous Injury,6,29504,29498,22,16,392315,3.899922336799413
enalapril,Ventricular drainage,2,29504,29502,8,6,392325,3.57456274150905
enalapril,Vertebral column mass,5,29504,29499,5,0,392331,14.299806773110953
enalapril,Vulvovaginal discomfort,6,29504,29498,17,11,392320,5.047018142805295
enalapril,"Waterhouse-Friderichsen Syndrome, Meningococcal",2,29504,29502,5,3,392328,5.719341061622941
enalapril,White Blood Cell Count procedure,3,29504,29501,13,10,392321,3.2996691116076904
eprosartan,Age related macular degeneration,2,110,108,915,913,420812,8.51892329487958
eprosartan,Amylase increased,2,110,108,413,411,421314,18.89615281140705
eprosartan,Anemia of chronic disease,1,110,109,189,188,421537,20.467258870928593
eprosartan,Anhedonia,2,110,108,522,520,421205,14.946537533702283
eprosartan,Anxiety,3,110,107,2507,2504,419221,4.689613008808979
eprosartan,Bile duct calculus,3,110,107,1599,1596,420129,7.368553944346057
eprosartan,Blood glucose outside reference range,1,110,109,668,667,421058,5.78430753172554
eprosartan,Blood testosterone decreased,1,110,109,991,990,420735,3.89601829307807
eprosartan,Clostridium difficile infection,2,110,108,1764,1762,419963,4.409916435710087
eprosartan,Contusions,2,110,108,677,675,421050,11.52026916133268
eprosartan,Decompression of median nerve,1,110,109,19,18,421707,203.67745050700145
eprosartan,Dehydration,2,110,108,1376,1374,420351,5.658632105943152
eprosartan,Dermatitis,1,110,109,479,478,421247,8.070253394878474
eprosartan,Diaper Rash,2,110,108,151,149,421576,51.7149865096885
eprosartan,Disease of mucous membrane,4,110,106,29,25,421700,548.8692257644761
eprosartan,Drug abuse,3,110,107,725,722,421003,16.285272317112472
eprosartan,Drug prescribing error,1,110,109,289,288,421437,13.381987873400846
eprosartan,"Edema, Cardiac",1,110,109,299,298,421427,12.934122917369827
eprosartan,Eructation,1,110,109,478,477,421248,8.08715596330275
eprosartan,Erythrocyanosis,1,110,109,245,244,421481,15.78693128627598
eprosartan,Esophagitis,1,110,109,623,622,421103,6.2027773278159835
eprosartan,Excoriation,2,110,108,1205,1203,420522,6.464269248501614
eprosartan,Femoral Fractures,1,110,109,77,76,421649,50.25116168235434
eprosartan,General physical health deterioration,1,110,109,818,817,420908,4.721933110517934
eprosartan,Hemorrhage,2,110,108,304,302,421423,25.67805799220273
eprosartan,Hemorrhagic gastritis,2,110,108,323,321,421404,24.166494668042656
eprosartan,Hepatotoxicity,1,110,109,186,185,421540,20.797523922264972
eprosartan,Hyperuricemia,3,110,107,19,16,421709,622.453516969995
eprosartan,Hypoglycemia,1,110,109,1103,1102,420623,3.4994801500494894
eprosartan,Infusion site inflammation,1,110,109,529,528,421197,7.306602382893117
eprosartan,Injury of cornea,5,110,105,14,9,421716,1434.765306122449
eprosartan,Joint stiffness,2,110,108,168,166,421559,46.480048500881836
eprosartan,Joint swelling,2,110,108,891,889,420836,8.748888057530033
eprosartan,"Leukoencephalopathy, Progressive Multifocal",1,110,109,219,218,421507,17.662268023962127
eprosartan,Liver Failure,1,110,109,606,605,421120,6.37703999757774
eprosartan,Macular rash,1,110,109,126,125,421600,30.705475462356198
eprosartan,Melena,1,110,109,86,85,421640,44.991359078301684
eprosartan,Microscopic Polyarteritis,1,110,109,1007,1006,420719,3.833969552581471
eprosartan,Migration of implanted drug,1,110,109,8,7,421718,483.7465596330275
eprosartan,Multiple sclerosis relapse,2,110,108,217,215,421510,35.98037207714627
eprosartan,Osteopenia,1,110,109,151,150,421575,25.620268546084212
eprosartan,Rales,1,110,109,375,374,421351,10.310948012232414
eprosartan,Renal Insufficiency,1,110,109,907,906,420819,4.2576899345559
eprosartan,Respiration Disorders,1,110,109,363,362,421363,10.652109080799658
eprosartan,Rotator cuff syndrome,1,110,109,188,187,421538,20.576176068709742
eprosartan,Skin rash,3,110,107,2510,2507,419218,4.683974382842461
eprosartan,Stage II Colon Cancer,2,110,108,219,217,421508,35.651615085405034
eprosartan,Syncope,2,110,108,1527,1525,420200,5.097237381454801
eprosartan,Throat irritation,1,110,109,132,131,421594,29.309355018070615
eprosartan,Transitional cell carcinoma of bladder,3,110,107,3162,3159,418566,3.712364113568249
eprosartan,Ulceration of gingivae,3,110,107,1062,1059,420666,11.108638259675802
eprosartan,Upper Respiratory Infections,1,110,109,418,417,421308,9.249308634388306
eprosartan,bite injury,2,110,108,1079,1077,420648,7.221295438162908
eprosartan,nervous system disorder,2,110,108,1380,1378,420347,5.642176596886743
felodipine,Abnormal blood test,1,458,457,99,98,421279,9.321574608226689
felodipine,Abnormal coordination,1,458,457,102,101,421276,9.047346290813918
felodipine,Abnormal weight loss (finding),2,458,456,172,170,421207,10.752320481436149
felodipine,Abscess,1,458,457,158,157,421220,5.839916350441792
felodipine,Activities of daily living impaired,1,458,457,114,113,421264,8.094763714537985
felodipine,Acute psychosis,1,458,457,5,4,421373,184.6083150984683
felodipine,Adverse reactions,2,458,456,284,282,421095,6.510239065974797
felodipine,Age related macular degeneration,5,458,453,915,910,420467,5.0775039505904775
felodipine,Aggressive behavior,3,458,455,489,486,420891,5.681197330277085
felodipine,Allergic oedema,1,458,457,7,6,421371,131.86245701781806
felodipine,Altered bowel function,1,458,457,104,103,421274,8.873316781686585
felodipine,Amnesia,1,458,457,212,211,421166,4.351833120019817
felodipine,Amputation of toe (procedure),1,458,457,54,53,421324,17.091376934921794
felodipine,Apallic syndrome,2,458,456,198,196,421181,9.339823675349992
felodipine,Application site reaction,1,458,457,16,15,421362,57.68859409190372
felodipine,Arteriopathic disease,2,458,456,50,48,421329,36.998684210526314
felodipine,Arteritis,1,458,457,5,4,421373,184.6083150984683
felodipine,Aspergillosis,1,458,457,50,49,421328,18.45886214442013
felodipine,Ataxia,1,458,457,40,39,421338,23.074124726477027
felodipine,Atrioventricular Block,1,458,457,27,26,421351,34.18494205365103
felodipine,Atrophic condition of skin,3,458,455,378,375,421002,7.3514215942787375
felodipine,Baresthesia,1,458,457,288,287,421090,3.202855275954291
felodipine,Blood creatine increased,1,458,457,237,236,421141,3.892548172358714
felodipine,Blood creatine phosphokinase MB increased,1,458,457,61,60,421317,15.129820281952865
felodipine,Breast Diseases,1,458,457,97,96,421281,9.513817140021207
felodipine,Breast tenderness,2,458,456,378,376,421001,4.890200037129861
felodipine,Bronchospasm,2,458,456,13,11,421366,142.31511470985154
felodipine,Cholecystitis infective,1,458,457,44,43,421334,20.976278098269347
felodipine,Cholelithiasis,1,458,457,153,152,421225,6.030834799273466
felodipine,Chronic fibrous thyroiditis,1,458,457,240,239,421138,3.8438639679066378
felodipine,Coughing,1,458,457,145,144,421233,6.363691239719308
felodipine,Decreased body weight,1,458,457,16,15,421362,57.68859409190372
felodipine,Decreased diastolic arterial pressure,1,458,457,253,252,421125,3.6462407348146098
felodipine,Decreased thyroxine level,2,458,456,40,38,421339,46.24945175438597
felodipine,Delayed union of fracture,1,458,457,85,84,421293,10.85725318573819
felodipine,Dementia,1,458,457,114,113,421264,8.094763714537985
felodipine,Disorder of ligament,1,458,457,93,92,421285,9.923107691583729
felodipine,Duodenal ulcer with hemorrhage,1,458,457,279,278,421099,3.306243774656283
felodipine,Dysgraphia,2,458,456,248,246,421131,7.455910441426147
felodipine,Dysuria,7,458,451,771,764,420613,8.476473954693562
felodipine,Ear discomfort,2,458,456,401,399,420978,4.609463184144901
felodipine,Echocardiogram abnormal (finding),1,458,457,235,234,421143,3.9256948647516183
felodipine,Edema of esophagus,3,458,455,325,322,421055,8.551344040574811
felodipine,Electromechanical dissociation,1,458,457,117,116,421261,7.88714956329836
felodipine,Eosinophilic pneumonia acute,2,458,456,65,63,421314,28.459514170040485
felodipine,Epiphyseal fracture of bone,1,458,457,51,50,421327,18.096880765435277
felodipine,Facet joint pain,1,458,457,24,23,421354,38.458333333333336
felodipine,Failure to lose weight,1,458,457,16,15,421362,57.68859409190372
felodipine,Fear of death,1,458,457,26,25,421352,35.49983167816866
felodipine,Feeling intoxicated,1,458,457,101,100,421277,9.136945642047793
felodipine,Felty Syndrome,2,458,456,13,11,421366,142.31511470985154
felodipine,Femoral Fractures,1,458,457,77,76,421301,11.985506834522152
felodipine,Fibromyalgia,1,458,457,195,194,421183,4.731414464456041
felodipine,Fibrosis of pleura,2,458,456,143,141,421236,12.933750460066248
felodipine,Foot Deformities,2,458,456,148,146,421231,12.496651256519677
felodipine,"Fracture Fixation, Internal",1,458,457,16,15,421362,57.68859409190372
felodipine,Fracture of lower leg,1,458,457,126,125,421252,7.323625438505087
felodipine,Gastrointestinal viral infection,1,458,457,5,4,421373,184.6083150984683
felodipine,Genital rash,1,458,457,210,209,421168,4.393299989580078
felodipine,Gingiva operations,1,458,457,61,60,421317,15.129820281952865
felodipine,Growth of eyelashes,1,458,457,131,130,421247,7.044014231546595
felodipine,Hair color change (finding),1,458,457,166,165,421212,5.558369143971949
felodipine,"Hallucinations, Auditory",1,458,457,116,115,421262,7.955161095600996
felodipine,Hemorrhoids,2,458,456,77,75,421302,24.02358168147642
felodipine,Hepatic Encephalopathy,2,458,456,118,116,421261,15.67488105857865
felodipine,Hydrocele operation,1,458,457,44,43,421334,20.976278098269347
felodipine,Hypercalcemia,1,458,457,36,35,421342,25.63815949428641
felodipine,"Hypertonia, Neonatal",1,458,457,37,36,421341,24.945177124608197
felodipine,Impaired wound healing,2,458,456,326,324,421053,5.670931546658057
felodipine,Inappropriate schedule of drug administration,1,458,457,139,138,421239,6.638477401885932
felodipine,Incorrect drug administration duration,1,458,457,236,235,421142,3.909051292511961
felodipine,Increased frequency of micturition,2,458,456,231,229,421148,8.004936583883953
felodipine,Infectious Enterocolitis,3,458,455,650,647,420730,4.272375316990702
felodipine,Injury of retina,1,458,457,110,109,421268,8.389198329023275
felodipine,Intentional drug misuse,1,458,457,26,25,421352,35.49983167816866
felodipine,Internal Carotid Artery Stenosis,1,458,457,99,98,421279,9.321574608226689
felodipine,Intracranial Hemorrhage,2,458,456,373,371,421006,4.955811109543295
felodipine,"Kidney Failure, Acute",1,458,457,173,172,421205,5.333375494871049
felodipine,Klebsiella bacteraemia,1,458,457,75,74,421303,12.30517870167761
felodipine,Large intestine perforation,1,458,457,78,77,421300,11.83181843685126
felodipine,"Leishmaniasis, Visceral",1,458,457,84,83,421294,10.986532249661353
felodipine,Lethargy,1,458,457,114,113,421264,8.094763714537985
felodipine,Limb asymmetry,1,458,457,181,180,421197,5.097549475923933
felodipine,Limb reconstructive surgery,1,458,457,26,25,421352,35.49983167816866
felodipine,Locked-In Syndrome,1,458,457,14,13,421364,65.93013441700532
felodipine,Loss of interest,4,458,454,879,875,420502,4.219412327785379
felodipine,Low birth weight baby,1,458,457,118,117,421260,7.82029076883136
felodipine,Low density lipoprotein abnormal,1,458,457,249,248,421129,3.7048500347121527
felodipine,Lymph nodes scan abnormal,7,458,451,27,20,421357,242.4781144781145
felodipine,Lymphedema,5,458,453,549,544,420833,8.469864936046676
felodipine,Lymphoma,1,458,457,255,254,421123,3.6176256060411034
felodipine,Macular rash,1,458,457,126,125,421252,7.323625438505087
felodipine,Malaise,6,458,452,396,390,420987,14.12707830517565
felodipine,Malignant melanoma in situ,1,458,457,53,52,421325,17.413897031501588
felodipine,Melanocytic nevus,1,458,457,21,20,421357,43.95269355006773
felodipine,Mental Depression,2,458,456,585,583,420794,3.1582696056380266
felodipine,Metastatic Renal Cell Carcinoma,1,458,457,62,61,421316,14.885755629279313
felodipine,Metastatic malignant neoplasm to liver,1,458,457,88,87,421290,10.487044957230953
felodipine,Microscopic Polyarteritis,5,458,453,1007,1002,420375,4.6126123756223
felodipine,Middle insomnia,2,458,456,156,154,421223,11.855572424651372
felodipine,Nasal discomfort,1,458,457,289,288,421089,3.191765160176569
felodipine,Nephrolithiasis,2,458,456,13,11,421366,142.31511470985154
felodipine,Nephrosclerosis,1,458,457,41,40,421337,22.511287826226184
felodipine,Occult blood positive,3,458,455,161,158,421219,17.268746160671625
felodipine,Orbital swelling,3,458,455,158,155,421222,17.596758937265268
felodipine,Pancreatitis,1,458,457,27,26,421351,34.18494205365103
felodipine,"Pancreatitis, Acute",9,458,449,1247,1238,420139,6.760621036143761
felodipine,Parkinsonian Disorders,1,458,457,79,78,421299,11.682020884691022
felodipine,Periodontal Diseases,1,458,457,6,5,421372,153.83989788475563
felodipine,Peripheral Vascular Diseases,1,458,457,28,27,421350,32.963973116598936
felodipine,Peripheral arterial occlusive disease,1,458,457,147,146,421231,6.277080635317584
felodipine,Petechiae of skin,2,458,456,417,415,420962,4.432433000967647
felodipine,"Pleural Effusion, Malignant",2,458,456,170,168,421209,10.878869969040249
felodipine,Procalcitonin increased,1,458,457,48,47,421330,19.228072574762948
felodipine,Product quality issue,1,458,457,281,280,421097,3.2826962162330533
felodipine,Product taste abnormal,1,458,457,31,30,421347,29.77369944236606
felodipine,Productive Cough,1,458,457,106,105,421272,8.705854423847075
felodipine,Protein total decreased,3,458,455,44,41,421336,63.20544455544455
felodipine,Pulmonary Hypertension,1,458,457,44,43,421334,20.976278098269347
felodipine,Pulmonary vascular disorder,3,458,455,517,514,420863,5.373154505069398
felodipine,Pulmonary vasculitis,1,458,457,5,4,421373,184.6083150984683
felodipine,Purpura,1,458,457,139,138,421239,6.638477401885932
felodipine,Rectal hemorrhage,1,458,457,43,42,421335,21.464149407154853
felodipine,Renal Insufficiency,8,458,450,907,899,420478,8.250456939850546
felodipine,Renal function tests outside reference range,1,458,457,33,32,421345,27.96910019229494
felodipine,Renal pain,1,458,457,304,303,421074,3.034168778072095
felodipine,Retinal Perforations,1,458,457,14,13,421364,65.93013441700532
felodipine,Rhonchi,1,458,457,10,9,421368,92.30306345733042
felodipine,Schizophrenia,3,458,455,106,103,421274,26.232365747460086
felodipine,Sensory neuropathy,1,458,457,35,34,421343,26.37074085651766
felodipine,Sepsis due to urinary tract infection,2,458,456,520,518,420859,3.553601551956816
felodipine,Septic thrombophlebitis,1,458,457,128,127,421250,7.209159600656456
felodipine,Sjogren-Larsson Syndrome,1,458,457,79,78,421299,11.682020884691022
felodipine,Skin tightness,1,458,457,174,173,421204,5.302711335798183
felodipine,Soft Tissue Neoplasms,1,458,457,5,4,421373,184.6083150984683
felodipine,Staghorn Calculi,1,458,457,108,107,421270,8.544594375557176
felodipine,Staphylococcal Infections,12,458,446,2882,2870,418507,3.911269266795916
felodipine,Status Epilepticus,1,458,457,7,6,421371,131.86245701781806
felodipine,Sunburn,1,458,457,180,179,421198,5.12588135181133
felodipine,Swelling at injection site,1,458,457,40,39,421338,23.074124726477027
felodipine,Tachycardia,1,458,457,128,127,421250,7.209159600656456
felodipine,Tarsal Tunnel Syndrome,1,458,457,42,41,421336,21.975252683130144
felodipine,Tendon Injuries,2,458,456,19,17,421360,97.37211449676822
felodipine,Toxicoderma,1,458,457,191,190,421187,4.830547504210249
felodipine,Urinary Retention,2,458,456,84,82,421295,22.021251044277356
felodipine,Urinary bladder stone (disorder),1,458,457,198,197,421180,4.659693212209624
felodipine,Urinary tract infection,1,458,457,132,131,421246,6.990633910218155
felodipine,Urologic Diseases,1,458,457,96,95,421282,9.612942195477753
felodipine,Vaginal odor,1,458,457,53,52,421325,17.413897031501588
felodipine,Vasculitis,1,458,457,127,126,421251,7.265941866675856
felodipine,Venous Thrombosis,1,458,457,231,230,421147,3.9937101556357573
felodipine,Violence-related symptom,2,458,456,296,294,421083,6.246132645803698
felodipine,Visual Impairment,2,458,456,486,484,420893,3.802514258898275
felodipine,melanoma,1,458,457,194,193,421184,4.755814478106882
felodipine,prostatitis,4,458,454,150,146,421231,24.76857562408223
furosemide,Abasia (gait ataxia),5,2331,2326,240,235,419269,3.776108842075093
furosemide,Abdominal tenderness,1,2331,2330,24,23,419481,7.543115164520744
furosemide,Abnormal blood pressure,1,2331,2330,29,28,419476,6.242504069853485
furosemide,Abnormal blood test,3,2331,2328,99,96,419408,5.489638654587108
furosemide,Abnormal urine,2,2331,2329,11,9,419495,32.93055935048206
furosemide,Acquired phimosis,2,2331,2329,41,39,419465,8.834399773795935
furosemide,Acute superior sagittal sinus thrombosis,1,2331,2330,25,24,419480,7.24137339055794
furosemide,Acute tonsillitis,6,2331,2325,117,111,419393,9.301748001102839
furosemide,Adenocarcinoma of lung (disorder),1,2331,2330,45,44,419460,4.022794468288031
furosemide,"Adenocarcinoma, Oxyphilic",1,2331,2330,5,4,419500,36.208583690987126
furosemide,Allergy to arthropod sting,1,2331,2330,20,19,419485,9.051824034334764
furosemide,Altered bowel function,6,2331,2325,104,98,419406,10.464789081885858
furosemide,Amputation of toe (procedure),1,2331,2330,54,53,419451,3.3522571928151326
furosemide,Anastomotic stenosis,1,2331,2330,8,7,419497,22.630203862660945
furosemide,Aneurysm,1,2331,2330,10,9,419495,18.104077253218886
furosemide,"Angioedemas, Hereditary",1,2331,2330,22,21,419483,8.228891923527117
furosemide,Angiogram peripheral abnormal,1,2331,2330,10,9,419495,18.104077253218886
furosemide,Anxiety Disorders,1,2331,2330,6,5,419499,30.173748211731045
furosemide,Aortic Aneurysm,4,2331,2327,226,222,419282,3.206749546493453
furosemide,Aortic valve sclerosis,1,2331,2330,53,52,419452,3.415515426350312
furosemide,Application site dryness,1,2331,2330,21,20,419484,8.620764357245044
furosemide,Arrested labor,1,2331,2330,23,22,419482,7.871095353610748
furosemide,Arterial Injury,2,2331,2329,29,27,419477,12.490368813017279
furosemide,Arthroscopic Surgical Procedures,1,2331,2330,12,11,419493,15.086659513590842
furosemide,Ascites,2,2331,2329,101,99,419405,3.5857313511514315
furosemide,Asocial behavior,1,2331,2330,49,48,419456,3.6943680476482434
furosemide,Aspartate aminotransferase abnormal,1,2331,2330,6,5,419499,30.173748211731045
furosemide,Aspergillosis,1,2331,2330,50,49,419455,3.620472103004292
furosemide,Aspiration Pneumonia,1,2331,2330,29,28,419476,6.242504069853485
furosemide,Asthenopia,2,2331,2329,34,32,419472,10.653423584977142
furosemide,Ataxia,1,2331,2330,40,39,419465,4.525697424892704
furosemide,Atrial Fibrillation,2,2331,2329,18,16,419488,20.123896760650734
furosemide,Axonal neuropathy,2,2331,2329,111,109,419395,3.2626151269345773
furosemide,Band sensation,1,2331,2330,27,26,419478,6.704943570179622
furosemide,Benign neoplasm of adrenal gland,1,2331,2330,9,8,419496,20.115689079637576
furosemide,Benign neoplasm of pericardium,1,2331,2330,57,56,419448,3.175800015059107
furosemide,Biliary Colic,2,2331,2329,59,57,419447,6.138897177081893
furosemide,Bladder cyst,1,2331,2330,42,41,419463,4.310167586347843
furosemide,Blister of lip,1,2331,2330,22,21,419483,8.228891923527117
furosemide,Blood bicarbonate level above normal,1,2331,2330,44,43,419461,4.114231369488881
furosemide,Blood potassium abnormal,2,2331,2329,24,22,419482,15.092707886074136
furosemide,Blood potassium increased,1,2331,2330,46,45,419459,3.935333084530696
furosemide,Blood sodium increased,1,2331,2330,22,21,419483,8.228891923527117
furosemide,Blood testosterone increased,1,2331,2330,17,16,419488,10.649280484726079
furosemide,Blood urea increased,1,2331,2330,47,46,419458,3.8515934617843115
furosemide,Blunted affect,3,2331,2328,102,99,419405,5.3281407923994335
furosemide,Bone Cysts,2,2331,2329,24,22,419482,15.092707886074136
furosemide,Bone Diseases,1,2331,2330,36,35,419469,5.028600381497377
furosemide,Bone Marrow Diseases,3,2331,2328,12,9,419495,45.29886168384879
furosemide,Bone necrosis,1,2331,2330,56,55,419449,3.2325183936235438
furosemide,Bone trimming,1,2331,2330,14,13,419491,12.931361128142242
furosemide,Bradycardia,1,2331,2330,9,8,419496,20.115689079637576
furosemide,Bronchiectasis,1,2331,2330,5,4,419500,36.208583690987126
furosemide,"Bronchitis, Chronic",1,2331,2330,56,55,419449,3.2325183936235438
furosemide,Bullous Dermatitis,1,2331,2330,8,7,419497,22.630203862660945
furosemide,Burning Mouth Syndrome,1,2331,2330,25,24,419480,7.24137339055794
furosemide,Bursal fluid accumulation,1,2331,2330,13,12,419492,13.926114229118522
furosemide,Central cyanosis,1,2331,2330,17,16,419488,10.649280484726079
furosemide,Cerebellar ischaemia,1,2331,2330,12,11,419493,15.086659513590842
furosemide,Cerebrospinal fluid leak,2,2331,2329,70,68,419436,5.17407839048028
furosemide,Cerebrovascular accident,1,2331,2330,23,22,419482,7.871095353610748
furosemide,Cervical spinal cord injury,1,2331,2330,17,16,419488,10.649280484726079
furosemide,Cheilitis,1,2331,2330,46,45,419459,3.935333084530696
furosemide,Clostridium difficile colitis,1,2331,2330,29,28,419476,6.242504069853485
furosemide,Cognition Disorders,1,2331,2330,13,12,419492,13.926114229118522
furosemide,Colectomy,2,2331,2329,45,43,419461,8.049043461666905
furosemide,Colitis,3,2331,2328,175,172,419332,3.1050073637702504
furosemide,Congenital cystic kidney disease,1,2331,2330,55,54,419450,3.291299258681233
furosemide,Congenital stenosis of aortic valve,1,2331,2330,24,23,419481,7.543115164520744
furosemide,Cortical cataract,2,2331,2329,108,106,419398,3.3532671787287502
furosemide,Creatinine measurement,1,2331,2330,9,8,419496,20.115689079637576
furosemide,Culture urine positive,1,2331,2330,17,16,419488,10.649280484726079
furosemide,Cyst of skin,1,2331,2330,5,4,419500,36.208583690987126
furosemide,Cyst removal,1,2331,2330,25,24,419480,7.24137339055794
furosemide,Cystatin C increased,1,2331,2330,29,28,419476,6.242504069853485
furosemide,Cystic acne,1,2331,2330,11,10,419494,16.458213031603588
furosemide,Cytomegaloviral pneumonia,16,2331,2315,89,73,419431,32.751406314461136
furosemide,Death of relative,1,2331,2330,17,16,419488,10.649280484726079
furosemide,Deformity,18,2331,2313,398,380,419124,8.240365250376396
furosemide,Delayed union of fracture,2,2331,2329,85,83,419421,4.26085419139747
furosemide,Dementia,2,2331,2329,114,112,419392,3.1767342357611503
furosemide,Dentin Sensitivity,1,2331,2330,28,27,419477,6.465465971796443
furosemide,Dermatitis acneiform,1,2331,2330,16,15,419489,11.314887339055794
furosemide,Device defective,1,2331,2330,5,4,419500,36.208583690987126
furosemide,Device related sepsis,1,2331,2330,31,30,419474,5.8397341824726565
furosemide,Diabetic Foot,1,2331,2330,19,18,419486,9.528258414276031
furosemide,Difficulty driving a car,1,2331,2330,51,50,419454,3.5494740385424555
furosemide,Diffuse Large B-Cell Lymphoma,1,2331,2330,58,57,419447,3.1210374426520646
furosemide,Dilatation of ureter,1,2331,2330,18,17,419487,10.05762994754411
furosemide,Discharge from eye,1,2331,2330,24,23,419481,7.543115164520744
furosemide,Disease recurrence,1,2331,2330,59,58,419446,3.0681312286317013
furosemide,Disorder of accommodation,1,2331,2330,7,6,419498,25.863151440833843
furosemide,Drug action increased,1,2331,2330,52,51,419453,3.4812066688676135
furosemide,Drug administered at inappropriate site,1,2331,2330,32,31,419473,5.657229077253219
furosemide,Drug dose omission,1,2331,2330,25,24,419480,7.24137339055794
furosemide,Drug level increased,1,2331,2330,58,57,419447,3.1210374426520646
furosemide,Duodenal ulcer perforation,1,2331,2330,29,28,419476,6.242504069853485
furosemide,Dysesthesia,1,2331,2330,7,6,419498,25.863151440833843
furosemide,Dyskinetic syndrome,5,2331,2326,218,213,419291,4.157400979750251
furosemide,Ear Diseases,1,2331,2330,31,30,419474,5.8397341824726565
furosemide,Eating Disorders,1,2331,2330,54,53,419451,3.3522571928151326
furosemide,Ecchymosis,1,2331,2330,56,55,419449,3.2325183936235438
furosemide,Electromechanical dissociation,5,2331,2326,117,112,419392,7.7481241410734105
furosemide,Enterovesical Fistula,1,2331,2330,32,31,419473,5.657229077253219
furosemide,Epididymitis,1,2331,2330,19,18,419486,9.528258414276031
furosemide,Epigastric discomfort,1,2331,2330,18,17,419487,10.05762994754411
furosemide,Epiphyseal fracture of bone,1,2331,2330,51,50,419454,3.5494740385424555
furosemide,Epstein-Barr virus test positive,1,2331,2330,25,24,419480,7.24137339055794
furosemide,Eye Injuries,1,2331,2330,60,59,419445,3.016988555078684
furosemide,Eye oedema,1,2331,2330,48,47,419457,3.771342989985694
furosemide,Eyelids pruritus,1,2331,2330,17,16,419488,10.649280484726079
furosemide,Facet joint pain,1,2331,2330,24,23,419481,7.543115164520744
furosemide,Facial Pain,1,2331,2330,36,35,419469,5.028600381497377
furosemide,Faeces discoloured,1,2331,2330,55,54,419450,3.291299258681233
furosemide,Failure to lose weight,1,2331,2330,16,15,419489,11.314887339055794
furosemide,Familial benign hypercalcemia,1,2331,2330,10,9,419495,18.104077253218886
furosemide,Foaming at mouth,1,2331,2330,30,29,419475,6.034406294706724
furosemide,Food aversion,1,2331,2330,5,4,419500,36.208583690987126
furosemide,Fracture of forearm,1,2331,2330,53,52,419452,3.415515426350312
furosemide,Fracture of ilium,1,2331,2330,8,7,419497,22.630203862660945
furosemide,Fracture of sacrum,3,2331,2328,31,28,419476,17.534253408713003
furosemide,Fracture of sternum,1,2331,2330,54,53,419451,3.3522571928151326
furosemide,"Fractures, Ununited",10,2331,2321,317,307,419197,5.729038255837185
furosemide,Gastric hemorrhage,1,2331,2330,42,41,419463,4.310167586347843
furosemide,Gastric infection,1,2331,2330,42,41,419463,4.310167586347843
furosemide,Gastrointestinal obstruction,2,2331,2329,26,24,419480,13.931664299633386
furosemide,Gastrointestinal oedema,1,2331,2330,15,14,419490,12.069241773962805
furosemide,General physical condition abnormal,3,2331,2328,78,75,419429,6.967965239228126
furosemide,Gingival Diseases,1,2331,2330,15,14,419490,12.069241773962805
furosemide,Gingival Hyperplasia,3,2331,2328,132,129,419375,4.116906825991878
furosemide,Gingival Hypertrophy,1,2331,2330,10,9,419495,18.104077253218886
furosemide,Graft versus host disease in skin,1,2331,2330,16,15,419489,11.314887339055794
furosemide,Graves Disease,1,2331,2330,46,45,419459,3.935333084530696
furosemide,Haematoma infection,1,2331,2330,8,7,419497,22.630203862660945
furosemide,Haemorrhagic arteriovenous malformation,1,2331,2330,57,56,419448,3.175800015059107
furosemide,Hair color change (finding),7,2331,2324,166,159,419345,7.651128610828857
furosemide,Hamman-Rich syndrome,1,2331,2330,6,5,419499,30.173748211731045
furosemide,"Heart Failure, Right-Sided",2,2331,2329,116,114,419390,3.1219481500125847
furosemide,Helicobacter Infections,2,2331,2329,59,57,419447,6.138897177081893
furosemide,"Hemianopsia, Homonymous",1,2331,2330,8,7,419497,22.630203862660945
furosemide,Hemorrhage of kidney,2,2331,2329,11,9,419495,32.93055935048206
furosemide,Hemorrhagic diarrhea,2,2331,2329,41,39,419465,8.834399773795935
furosemide,Heparin resistance,1,2331,2330,9,8,419496,20.115689079637576
furosemide,"Hepatitis, Alcoholic",1,2331,2330,5,4,419500,36.208583690987126
furosemide,Hiccough,1,2331,2330,44,43,419461,4.114231369488881
furosemide,Hilar lymphadenopathy,1,2331,2330,22,21,419483,8.228891923527117
furosemide,Hoigne's syndrome,1,2331,2330,18,17,419487,10.05762994754411
furosemide,Hydrocephalus,1,2331,2330,8,7,419497,22.630203862660945
furosemide,Hyperbilirubinemia,1,2331,2330,31,30,419474,5.8397341824726565
furosemide,Hypercalcemia,1,2331,2330,36,35,419469,5.028600381497377
furosemide,Hyperglycaemic hyperosmolar nonketotic syndrome,1,2331,2330,18,17,419487,10.05762994754411
furosemide,Hyperlactatemia,1,2331,2330,25,24,419480,7.24137339055794
furosemide,Hypernatremia,1,2331,2330,29,28,419476,6.242504069853485
furosemide,Hyperuricemia,1,2331,2330,19,18,419486,9.528258414276031
furosemide,Hypervolemia (finding),3,2331,2328,117,114,419390,4.644880606220812
furosemide,Hypocalcemia,9,2331,2322,294,285,419219,5.557414438643675
furosemide,Hypoparathyroidism,6,2331,2325,262,256,419248,4.152405811376508
furosemide,Hypothermia due to exposure,3,2331,2328,43,40,419464,12.640613761687844
furosemide,Hypovolemia,1,2331,2330,59,58,419446,3.0681312286317013
furosemide,INR Increased,2,2331,2329,57,55,419449,6.354327209177947
furosemide,Idiopathic erosive/hemorrhagic gastritis,2,2331,2329,98,96,419408,3.6955249252985864
furosemide,Iliotibial Band Syndrome,1,2331,2330,20,19,419485,9.051824034334764
furosemide,Incisional hernia,1,2331,2330,24,23,419481,7.543115164520744
furosemide,Increased Libido,1,2331,2330,17,16,419488,10.649280484726079
furosemide,Infected dermal cyst,3,2331,2328,167,164,419340,3.253811963701463
furosemide,Infection,7,2331,2324,170,163,419341,7.471031183557761
furosemide,Infective vaginitis,2,2331,2329,115,113,419391,3.149102992514048
furosemide,Inguinal pain,2,2331,2329,19,17,419487,19.064699102845132
furosemide,Injection site discomfort,1,2331,2330,21,20,419484,8.620764357245044
furosemide,Injection site hemorrhage,1,2331,2330,56,55,419449,3.2325183936235438
furosemide,Injection site hypertrophy,1,2331,2330,46,45,419459,3.935333084530696
furosemide,Injection site macule,1,2331,2330,31,30,419474,5.8397341824726565
furosemide,Insulin Resistance,4,2331,2327,205,201,419303,3.5354219292085483
furosemide,Intentional device misuse,1,2331,2330,14,13,419491,12.931361128142242
furosemide,Intestinal Perforation,19,2331,2312,77,58,419446,45.013043185188515
furosemide,Intestinal hemorrhage NOS,1,2331,2330,24,23,419481,7.543115164520744
furosemide,Intracranial tumour haemorrhage,4,2331,2327,145,141,419363,4.999066431545723
furosemide,"Intubation, Intratracheal",1,2331,2330,6,5,419499,30.173748211731045
furosemide,Invasive Lobular Breast Carcinoma,1,2331,2330,17,16,419488,10.649280484726079
furosemide,Ischemic stroke,1,2331,2330,19,18,419486,9.528258414276031
furosemide,Klebsiella test positive,1,2331,2330,32,31,419473,5.657229077253219
furosemide,Labelled drug-drug interaction medication error,1,2331,2330,20,19,419485,9.051824034334764
furosemide,Lack of libido,1,2331,2330,41,40,419464,4.415304092955093
furosemide,Large intestine perforation,2,2331,2329,78,76,419428,4.643315608107364
furosemide,Left atrial dilatation,2,2331,2329,45,43,419461,8.049043461666905
furosemide,"Leukemia, Myelocytic, Acute",1,2331,2330,48,47,419457,3.771342989985694
furosemide,Leukocytes in urine (finding),2,2331,2329,96,94,419410,3.7725329182767995
furosemide,Limb crushing injury,2,2331,2329,36,34,419470,10.061519011497543
furosemide,Lipid above reference range,3,2331,2328,20,17,419487,27.17880154639175
furosemide,Lung Abscess,1,2331,2330,6,5,419499,30.173748211731045
furosemide,Lymph node excision,1,2331,2330,33,32,419472,5.485784887501626
furosemide,"Lymphoma, Non-Hodgkin",1,2331,2330,31,30,419474,5.8397341824726565
furosemide,Macular degeneration,3,2331,2328,26,23,419481,20.906473037272008
furosemide,Malignant melanoma in situ,2,2331,2329,53,51,419453,6.833963884410671
furosemide,Malignant tumor of nasal sinuses,1,2331,2330,14,13,419491,12.931361128142242
furosemide,Mantle cell lymphoma,1,2331,2330,60,59,419445,3.016988555078684
furosemide,Mass of urinary bladder,1,2331,2330,31,30,419474,5.8397341824726565
furosemide,Mental disorders,1,2331,2330,47,46,419458,3.8515934617843115
furosemide,Metabolic acidosis,1,2331,2330,25,24,419480,7.24137339055794
furosemide,Metastatic malignant neoplasm to liver,3,2331,2328,88,85,419419,6.176004568884723
furosemide,Metrorrhagia,1,2331,2330,20,19,419485,9.051824034334764
furosemide,Middle insomnia,21,2331,2310,156,135,419369,24.573368298368298
furosemide,Migraine with Aura,1,2331,2330,9,8,419496,20.115689079637576
furosemide,Milk-Alkali Syndrome,1,2331,2330,29,28,419476,6.242504069853485
furosemide,Mitral Valve Prolapse Syndrome,3,2331,2328,78,75,419429,6.967965239228126
furosemide,Monoparesis,1,2331,2330,41,40,419464,4.415304092955093
furosemide,Morbid thoughts,1,2331,2330,13,12,419492,13.926114229118522
furosemide,Multiple Organ Failure,2,2331,2329,80,78,419426,4.5272112494632895
furosemide,Muscle Weakness,1,2331,2330,46,45,419459,3.935333084530696
furosemide,Mycobacterial peritonitis,1,2331,2330,6,5,419499,30.173748211731045
furosemide,Myocardial strain imaging,1,2331,2330,24,23,419481,7.543115164520744
furosemide,Myocarditis,1,2331,2330,20,19,419485,9.051824034334764
furosemide,Myopathy,17,2331,2314,55,38,419466,56.338964406380136
furosemide,Nephrectomy,4,2331,2327,62,58,419446,11.693666218445458
furosemide,Neurectomy,1,2331,2330,5,4,419500,36.208583690987126
furosemide,Nitrite detected in urine,1,2331,2330,22,21,419483,8.228891923527117
furosemide,Nodular regenerative hyperplasia,1,2331,2330,36,35,419469,5.028600381497377
furosemide,Occupational exposure to communicable disease,3,2331,2328,36,33,419471,15.098761454753722
furosemide,Oliguria,1,2331,2330,25,24,419480,7.24137339055794
furosemide,Oral Hemorrhage,1,2331,2330,7,6,419498,25.863151440833843
furosemide,Oral mucosal erythema,1,2331,2330,24,23,419481,7.543115164520744
furosemide,Oral pain,1,2331,2330,39,38,419466,4.641751953339936
furosemide,Orbital swelling,5,2331,2326,158,153,419351,5.73697715423882
furosemide,Oropharyngeal candidiasis,1,2331,2330,21,20,419484,8.620764357245044
furosemide,Osteolysis,1,2331,2330,28,27,419477,6.465465971796443
furosemide,Pancreatic Insufficiency,1,2331,2330,32,31,419473,5.657229077253219
furosemide,Pancreatic carcinoma stage III,1,2331,2330,6,5,419499,30.173748211731045
furosemide,Parasomnia,1,2331,2330,23,22,419482,7.871095353610748
furosemide,Patent ductus arteriosus,1,2331,2330,10,9,419495,18.104077253218886
furosemide,Pemphigus,1,2331,2330,45,44,419460,4.022794468288031
furosemide,Periarthritis,1,2331,2330,52,51,419453,3.4812066688676135
furosemide,Periodontal Diseases,1,2331,2330,6,5,419499,30.173748211731045
furosemide,Peripheral nerve lesion,1,2331,2330,28,27,419477,6.465465971796443
furosemide,Phlebitis,1,2331,2330,27,26,419478,6.704943570179622
furosemide,Phonophobia,1,2331,2330,6,5,419499,30.173748211731045
furosemide,Photophobia,2,2331,2329,69,67,419437,5.2490774792938435
furosemide,Physical abuse,1,2331,2330,43,42,419462,4.209921149815351
furosemide,Platelet aggregation inhibition,2,2331,2329,14,12,419492,25.87382690302398
furosemide,Polycystic liver disease,1,2331,2330,11,10,419494,16.458213031603588
furosemide,Polyp of vocal cord,1,2331,2330,15,14,419490,12.069241773962805
furosemide,Poriomania,1,2331,2330,12,11,419493,15.086659513590842
furosemide,Post procedural complication,1,2331,2330,53,52,419452,3.415515426350312
furosemide,Postoperative adhesion,1,2331,2330,55,54,419450,3.291299258681233
furosemide,Pregnancy,1,2331,2330,53,52,419452,3.415515426350312
furosemide,Premature infant,16,2331,2315,20,4,419500,145.76760259179267
furosemide,Premature ventricular contractions,1,2331,2330,7,6,419498,25.863151440833843
furosemide,Prescribed overdose,5,2331,2326,253,248,419256,3.5819690795577745
furosemide,Primary sequestrum,1,2331,2330,17,16,419488,10.649280484726079
furosemide,Product counterfeit,3,2331,2328,125,122,419382,4.347525773195876
furosemide,Product label issue,1,2331,2330,58,57,419447,3.1210374426520646
furosemide,Prolonged labor,1,2331,2330,27,26,419478,6.704943570179622
furosemide,Prosthesis user,1,2331,2330,19,18,419486,9.528258414276031
furosemide,Protein total decreased,1,2331,2330,44,43,419461,4.114231369488881
furosemide,Protein urine present,1,2331,2330,9,8,419496,20.115689079637576
furosemide,Pseudodementia,1,2331,2330,7,6,419498,25.863151440833843
furosemide,Pseudolymphoma,1,2331,2330,13,12,419492,13.926114229118522
furosemide,Pulmonary Hypertension,1,2331,2330,44,43,419461,4.114231369488881
furosemide,Pulmonary function challenge test abnormal,1,2331,2330,57,56,419448,3.175800015059107
furosemide,"Purpura, Thrombotic Thrombocytopenic",3,2331,2328,110,107,419397,4.940545923149015
furosemide,Putaminal Hemorrhage,1,2331,2330,5,4,419500,36.208583690987126
furosemide,Rectal hemorrhage,2,2331,2329,43,41,419463,8.42345751744935
furosemide,Recurrent Unspecified Lung Carcinoma,1,2331,2330,26,25,419479,6.962842522284583
furosemide,Reduced fluid intake,1,2331,2330,8,7,419497,22.630203862660945
furosemide,Reduced visual acuity,5,2331,2326,161,156,419348,5.6300369039163005
furosemide,Reduction of dislocation,1,2331,2330,15,14,419490,12.069241773962805
furosemide,Renal Insufficiency,47,2331,2284,907,860,418644,9.549976153559491
furosemide,Renal aneurysm,1,2331,2330,9,8,419496,20.115689079637576
furosemide,Renal transplant rejection,1,2331,2330,55,54,419450,3.291299258681233
furosemide,Renal tubular necrosis,1,2331,2330,46,45,419459,3.935333084530696
furosemide,Respiratory Failure,1,2331,2330,45,44,419460,4.022794468288031
furosemide,Retinal Hemorrhage,1,2331,2330,33,32,419472,5.485784887501626
furosemide,Retinitis,1,2331,2330,20,19,419485,9.051824034334764
furosemide,Retroperitoneal hematoma,1,2331,2330,18,17,419487,10.05762994754411
furosemide,Rupture of tendon,1,2331,2330,47,46,419458,3.8515934617843115
furosemide,Sciatic Neuropathy,1,2331,2330,14,13,419491,12.931361128142242
furosemide,Scleritis,1,2331,2330,19,18,419486,9.528258414276031
furosemide,Second Primary Cancers,2,2331,2329,32,30,419474,11.319316230141693
furosemide,Second degree atrioventricular block,2,2331,2329,57,55,419449,6.354327209177947
furosemide,Senile dementia,1,2331,2330,30,29,419475,6.034406294706724
furosemide,Septic thrombophlebitis,16,2331,2315,128,112,419392,22.770356371490283
furosemide,Skin neoplasm excision,1,2331,2330,10,9,419495,18.104077253218886
furosemide,Sleep Talking,1,2331,2330,9,8,419496,20.115689079637576
furosemide,Sluggishness,1,2331,2330,21,20,419484,8.620764357245044
furosemide,Small kidney,1,2331,2330,23,22,419482,7.871095353610748
furosemide,Somnolence,4,2331,2327,228,224,419280,3.1786050859852684
furosemide,Spinal Cord Ischemia,1,2331,2330,14,13,419491,12.931361128142242
furosemide,Spondylolisthesis,1,2331,2330,29,28,419476,6.242504069853485
furosemide,Stage II Rectal Cancer,1,2331,2330,7,6,419498,25.863151440833843
furosemide,Stage IV Lung Cancer AJCC v7,2,2331,2329,9,7,419497,40.24865225895711
furosemide,Staphylococcal Scalded Skin Syndrome,1,2331,2330,14,13,419491,12.931361128142242
furosemide,Starvation,4,2331,2327,208,204,419300,3.4844054741992005
furosemide,Stomatitis,3,2331,2328,175,172,419332,3.1050073637702504
furosemide,Subcutaneous hematoma,1,2331,2330,31,30,419474,5.8397341824726565
furosemide,Subileus,1,2331,2330,5,4,419500,36.208583690987126
furosemide,Superficial Thrombophlebitis,1,2331,2330,42,41,419463,4.310167586347843
furosemide,Superficial phlebitis,17,2331,2314,92,75,419429,33.67794802901056
furosemide,T-Lymphocytopenia,1,2331,2330,48,47,419457,3.771342989985694
furosemide,"Tachycardia, Paroxysmal",1,2331,2330,24,23,419481,7.543115164520744
furosemide,Tooth Avulsion,1,2331,2330,37,36,419468,4.892680663496114
furosemide,Tooth Injuries,1,2331,2330,25,24,419480,7.24137339055794
furosemide,Torsades de Pointes,1,2331,2330,44,43,419461,4.114231369488881
furosemide,Toxic Epidermal Necrolysis,1,2331,2330,8,7,419497,22.630203862660945
furosemide,Tracheal oedema,21,2331,2310,684,663,418841,5.597434875066454
furosemide,Tremor,2,2331,2329,81,79,419425,4.471309150856881
furosemide,Tumour lysis syndrome (SMQ),16,2331,2315,176,160,419344,16.558374239151778
furosemide,Unilateral deafness,1,2331,2330,23,22,419482,7.871095353610748
furosemide,Uveitis,2,2331,2329,92,90,419414,3.9365934250564716
furosemide,Vaginal Discharge,2,2331,2329,38,36,419468,9.531920182594744
furosemide,Vascular Grafting (surgical procedure),1,2331,2330,38,37,419467,4.763914614863339
furosemide,Vascular calcification,1,2331,2330,5,4,419500,36.208583690987126
furosemide,Vasculitis,11,2331,2320,127,116,419388,15.743918001629106
furosemide,"Ventricular Dysfunction, Left",2,2331,2329,23,21,419483,15.748949913192824
furosemide,Vesicular eczema of hands and/or feet,1,2331,2330,24,23,419481,7.543115164520744
furosemide,Vibratory sense increased,1,2331,2330,39,38,419466,4.641751953339936
furosemide,Viral Encephalitis,1,2331,2330,11,10,419494,16.458213031603588
furosemide,Walking disability,1,2331,2330,6,5,419499,30.173748211731045
furosemide,Wound closure,2,2331,2329,70,68,419436,5.17407839048028
furosemide,c-ANCA positive,1,2331,2330,29,28,419476,6.242504069853485
furosemide,pseudomembranous colitis,1,2331,2330,13,12,419492,13.926114229118522
furosemide,upper airway cough syndrome,1,2331,2330,54,53,419451,3.3522571928151326
guanfacine,Adverse event,1,28,27,707,706,421101,22.061291843470062
guanfacine,Chest Pain,1,28,27,1357,1356,420451,11.476241163787222
guanfacine,Chronic Obstructive Airway Disease,1,28,27,492,491,421316,31.718081903041256
guanfacine,Clostridium difficile infection,1,28,27,1764,1763,420044,8.819832871420173
guanfacine,Confusion,2,28,26,1333,1331,420476,24.2657972185354
guanfacine,Coronary Artery Disease,1,28,27,827,826,420981,18.85476286443638
guanfacine,Crying,1,28,27,692,691,421116,22.540301862556195
guanfacine,Cystitis,1,28,27,388,387,421420,40.22976326842306
guanfacine,General physical health deterioration,1,28,27,818,817,420990,19.0626188535724
guanfacine,Hallucinations,1,28,27,4751,4750,417057,3.2514324469702287
guanfacine,Heat Cramps,1,28,27,264,263,421544,59.14295735129069
guanfacine,Hernia,1,28,27,690,689,421118,22.605743424584006
guanfacine,Hyperchlorhydria,2,28,26,4666,4664,417143,6.877394572851066
guanfacine,Hypokalemia,1,28,27,982,981,420826,15.872859621332127
guanfacine,Initial insomnia,1,28,27,95,94,421713,164.42105263157896
guanfacine,Leriche Syndrome,1,28,27,106,105,421702,147.3546470999301
guanfacine,Malaise,1,28,27,396,395,421412,39.41629255518145
guanfacine,Normal menstruation (finding),1,28,27,93,92,421715,167.957785742732
guanfacine,Oropharyngeal pain,1,28,27,3244,3243,418564,4.779090743024159
guanfacine,Pain in limb,1,28,27,3721,3720,418087,4.16170483840465
guanfacine,Pulmonary congestion,1,28,27,723,722,421085,21.57225551969674
guanfacine,Skin Transplantation,1,28,27,375,374,421433,41.62567901234568
guanfacine,Strabismus,1,28,27,804,803,421004,19.395199926294456
guanfacine,Transient Ischemic Attack,1,28,27,3013,3012,418795,5.148332534326561
guanfacine,Unconscious State,1,28,27,3942,3941,417866,3.9263111411766913
guanfacine,Visual Impairment,1,28,27,486,485,421322,32.110120408474316
hydralazine,5q-syndrome,1,15307,15306,7,6,406522,3.9370928300759735
hydralazine,Abdominal tenderness,3,15307,15304,24,21,406507,3.4452675771040253
hydralazine,Abnormal posture,6,15307,15301,49,43,406485,3.3754176397701094
hydralazine,Abnormality of body mass index,2,15307,15305,12,10,406518,4.593520635957748
hydralazine,Acidosis,19,15307,15288,157,138,406390,3.337983748129335
hydralazine,Acute kidney injury,1,15307,15306,5,4,406524,5.511956095648765
hydralazine,Acute left ventricular failure,5,15307,15302,10,5,406523,13.783328976604365
hydralazine,Adrenal Gland Hyperfunction,4,15307,15303,33,29,406499,3.3410125564605075
hydralazine,"Alkalosis, Respiratory",5,15307,15302,21,16,406512,6.563318831649768
hydralazine,Allergy to arthropod bite,3,15307,15304,5,2,406526,16.538029273392574
hydralazine,Amblyopia,11,15307,15296,73,62,406466,4.154888734452914
hydralazine,Amputation of hand (procedure),1,15307,15306,6,5,406523,4.59328585739797
hydralazine,Anemia of renal disease,7,15307,15300,55,48,406480,3.508568033273915
hydralazine,Angiofibroma,76,15307,15231,185,109,406419,11.372751518506886
hydralazine,Anorexia Nervosa,29,15307,15278,64,35,406493,12.509162480363923
hydralazine,Anti-nuclear factor positive,2,15307,15305,12,10,406518,4.593520635957748
hydralazine,Antipsychotic drug level below therapeutic,1,15307,15306,7,6,406522,3.9370928300759735
hydralazine,Aortic valve thickened,4,15307,15303,7,3,406525,15.751458630894035
hydralazine,Application site discolouration,1,15307,15306,7,6,406522,3.9370928300759735
hydralazine,Application site discomfort,7,15307,15300,14,7,406521,13.785
hydralazine,Application site infection,1,15307,15306,5,4,406524,5.511956095648765
hydralazine,Application site papules,1,15307,15306,7,6,406522,3.9370928300759735
hydralazine,Arterial Stiffness,2,15307,15305,5,3,406525,11.024632473048024
hydralazine,Arterial hemorrhage,1,15307,15306,7,6,406522,3.9370928300759735
hydralazine,Arteriogram coronary abnormal,2,15307,15305,9,7,406521,6.124737740026861
hydralazine,"Arthritis, Gouty",5,15307,15302,44,39,406489,3.13232227516308
hydralazine,Ascorbic Acid Deficiency,1,15307,15306,8,7,406521,3.4449480595844766
hydralazine,Aspergillosis,21,15307,15286,50,29,406499,11.589016093157136
hydralazine,Athletic Injuries,1,15307,15306,8,7,406521,3.4449480595844766
hydralazine,Atrial dilatation,2,15307,15305,7,5,406523,7.874700144677275
hydralazine,Autoimmune hepatitis,4,15307,15303,6,2,406526,18.376745300485744
hydralazine,Bacterial Endocarditis,22,15307,15285,175,153,406375,3.468020000934623
hydralazine,Bacterial pyelonephritis,444,15307,14863,1344,900,405628,9.346175426033968
hydralazine,Basophil count outside reference range,2,15307,15305,6,4,406524,9.187171948165087
hydralazine,Benign neoplasm of adrenal gland,1,15307,15306,9,8,406520,3.0621687936466455
hydralazine,Bicytopenia,3,15307,15304,25,22,406506,3.3074490329325665
hydralazine,Biliary sphincterotomy,2,15307,15305,7,5,406523,7.874700144677275
hydralazine,Biopsy of pancreas,1,15307,15306,9,8,406520,3.0621687936466455
hydralazine,"Bladder cancer stage 0, with cancer in situ",1,15307,15306,5,4,406524,5.511956095648765
hydralazine,"Bladder cancer stage I, with cancer in situ",1,15307,15306,7,6,406522,3.9370928300759735
hydralazine,Bleeding from anus,4,15307,15303,33,29,406499,3.3410125564605075
hydralazine,Blood Transfusion,15,15307,15292,30,15,406513,13.79168846455663
hydralazine,Blood albumin abnormal,2,15307,15305,15,13,406515,3.6747903735162804
hydralazine,Blood chloride increased,12,15307,15295,39,27,406501,8.485347147132044
hydralazine,Blood creatine phosphokinase abnormal,5,15307,15302,21,16,406512,6.563318831649768
hydralazine,Blood creatinine abnormal,2,15307,15305,17,15,406513,3.242446720602648
hydralazine,Blood erythropoietin abnormal,2,15307,15305,18,16,406512,3.062303531888635
hydralazine,Blood folate decreased,13,15307,15294,88,75,406453,4.073723949974441
hydralazine,Blood pressure inadequately controlled,177,15307,15130,692,515,406013,7.119636655727433
hydralazine,Blood pressure orthostatic increased,2,15307,15305,14,12,406516,3.9372847342138417
hydralazine,Body height below normal,33,15307,15274,131,98,406430,6.955007111821016
hydralazine,Bone scan abnormal,2,15307,15305,14,12,406516,3.9372847342138417
hydralazine,Bradyarrhythmia (disorder),4,15307,15303,28,24,406504,3.9376686177313505
hydralazine,"Brain Diseases, Metabolic",2,15307,15305,7,5,406523,7.874700144677275
hydralazine,Breast cancer stage III,2,15307,15305,8,6,406522,6.890346292061418
hydralazine,Bronchopulmonary Dysplasia,2,15307,15305,7,5,406523,7.874700144677275
hydralazine,Burning Mouth Syndrome,3,15307,15304,25,22,406506,3.3074490329325665
hydralazine,CSF white blood cell count increased,1,15307,15306,6,5,406523,4.59328585739797
hydralazine,Calcified lymph nodes,3,15307,15304,27,24,406504,3.0624382877388623
hydralazine,Cancer of Ear,2,15307,15305,11,9,406519,5.01112530070387
hydralazine,Carcinoid Tumor,1,15307,15306,7,6,406522,3.9370928300759735
hydralazine,"Carcinoma, Neuroendocrine",8,15307,15299,22,14,406514,10.02591969766295
hydralazine,Catheter site inflammation,2,15307,15305,6,4,406524,9.187171948165087
hydralazine,Central Nervous System Necrotic Lesion,2,15307,15305,14,12,406516,3.9372847342138417
hydralazine,Cerebellar Neoplasms,2,15307,15305,16,14,406514,3.445107807905913
hydralazine,Cerebral venous sinus thrombosis,28,15307,15279,222,194,406334,3.4803596056295834
hydralazine,Cervical spine flattening,1,15307,15306,8,7,406521,3.4449480595844766
hydralazine,Cervico-occipital neuralgia,1,15307,15306,8,7,406521,3.4449480595844766
hydralazine,Chromatopsia,47,15307,15260,81,34,406494,16.03679271232788
hydralazine,Clumsiness,3,15307,15304,10,7,406521,8.26891662310507
hydralazine,Coagulation time shortened,3,15307,15304,12,9,406519,6.890731181390486
hydralazine,Coital bleeding,1,15307,15306,9,8,406520,3.0621687936466455
hydralazine,Colonic Pseudo-Obstruction,2,15307,15305,15,13,406515,3.6747903735162804
hydralazine,Colorectal Carcinoma,19,15307,15288,159,140,406388,3.2959808984067744
hydralazine,Congenital absence of bile duct,1,15307,15306,6,5,406523,4.59328585739797
hydralazine,Congenital hearing disorder,2,15307,15305,12,10,406518,4.593520635957748
hydralazine,Constipation,20,15307,15287,178,158,406370,3.099181723767643
hydralazine,Contraindicated drug administered,1,15307,15306,5,4,406524,5.511956095648765
hydralazine,Cornea verticillata,2,15307,15305,11,9,406519,5.01112530070387
hydralazine,Coronary angioplasty,1,15307,15306,5,4,406524,5.511956095648765
hydralazine,Critical Illness,2,15307,15305,9,7,406521,6.124737740026861
hydralazine,Cryptococcal fungaemia,2,15307,15305,10,8,406520,5.512250898399216
hydralazine,Culture urine positive,2,15307,15305,17,15,406513,3.242446720602648
hydralazine,Cytokine Release Syndrome,1,15307,15306,8,7,406521,3.4449480595844766
hydralazine,Cytomegalovirus gastrointestinal infection,8,15307,15299,12,4,406524,18.38128853737717
hydralazine,Decreased systolic arterial pressure,1,15307,15306,9,8,406520,3.0621687936466455
hydralazine,Decreased therapeutic response,1,15307,15306,8,7,406521,3.4449480595844766
hydralazine,Dental Fistula,1,15307,15306,8,7,406521,3.4449480595844766
hydralazine,Dental Plaque,9,15307,15298,42,33,406495,5.908237304596306
hydralazine,Dental discomfort,1,15307,15306,7,6,406522,3.9370928300759735
hydralazine,Device ineffective,1,15307,15306,6,5,406523,4.59328585739797
hydralazine,"Diabetes Mellitus, Non-Insulin-Dependent",1,15307,15306,8,7,406521,3.4449480595844766
hydralazine,Diastolic dysfunction,16,15307,15291,109,93,406435,4.048442478906162
hydralazine,Discomfort,6,15307,15301,53,47,406481,3.1206395438453276
hydralazine,Disorder of synovial membrane,2,15307,15305,7,5,406523,7.874700144677275
hydralazine,Disorder of transplanted kidney,3,15307,15304,10,7,406521,8.26891662310507
hydralazine,Dissociative disorder,24,15307,15283,101,77,406451,6.5572217366996135
hydralazine,Disturbance of attention,5,15307,15302,19,14,406514,7.2542288933679115
hydralazine,Double stranded DNA antibody positive,1,15307,15306,5,4,406524,5.511956095648765
hydralazine,Drug delivery system issue,2,15307,15305,6,4,406524,9.187171948165087
hydralazine,Drug dispensed to wrong patient,3,15307,15304,11,8,406520,7.517179109442569
hydralazine,Drug screen false positive,1,15307,15306,5,4,406524,5.511956095648765
hydralazine,Drug screen positive,4,15307,15303,17,13,406515,6.485740973511538
hydralazine,Dysesthesia,2,15307,15305,7,5,406523,7.874700144677275
hydralazine,Ectropion,1,15307,15306,9,8,406520,3.0621687936466455
hydralazine,Edema,4,15307,15303,9,5,406523,12.251076404771759
hydralazine,Edema of penis (disorder),5,15307,15302,37,32,406496,3.7249856051319914
hydralazine,Electrocardiogram QT borderline prolonged,1,15307,15306,7,6,406522,3.9370928300759735
hydralazine,Employment dissatisfaction,3,15307,15304,18,15,406513,4.593755445199512
hydralazine,Enterococcal infection,10,15307,15297,31,21,406507,8.894934068877093
hydralazine,Epiphyseal fracture of bone,7,15307,15300,51,44,406484,3.7837857234397028
hydralazine,Erosion of bone,1,15307,15306,6,5,406523,4.59328585739797
hydralazine,Eye operation complication,2,15307,15305,6,4,406524,9.187171948165087
hydralazine,Febrile bone marrow aplasia,4,15307,15303,28,24,406504,3.9376686177313505
hydralazine,Feeding tube complication,1,15307,15306,7,6,406522,3.9370928300759735
hydralazine,Femoral Fractures,9,15307,15298,77,68,406460,3.2224074787808608
hydralazine,Flank Pain,9,15307,15298,70,61,406467,3.544707057878714
hydralazine,Focal glomerulosclerosis,1,15307,15306,7,6,406522,3.9370928300759735
hydralazine,Foetal monitoring abnormal,2,15307,15305,7,5,406523,7.874700144677275
hydralazine,Folic Acid Deficiency,2,15307,15305,15,13,406515,3.6747903735162804
hydralazine,Food intolerance (disorder),10,15307,15297,80,70,406458,3.4463865463816434
hydralazine,Fracture of ilium,2,15307,15305,8,6,406522,6.890346292061418
hydralazine,Fungemia,5,15307,15302,38,33,406495,3.62695106934766
hydralazine,Gangrene,2,15307,15305,13,11,406517,4.2401628427110305
hydralazine,Gastroduodenitis,4,15307,15303,13,9,406519,8.481434007409307
hydralazine,Gastroenterostomy,1,15307,15306,6,5,406523,4.59328585739797
hydralazine,Gastrointestinal arteriovenous malformation,60,15307,15247,231,171,406357,7.182234699779134
hydralazine,Gastrointestinal carcinoma,43,15307,15264,350,307,406221,3.3924556379155435
hydralazine,General symptom,4,15307,15303,31,27,406501,3.5565786173067475
hydralazine,Genital pain,2,15307,15305,11,9,406519,5.01112530070387
hydralazine,Gingival discolouration,25,15307,15282,113,88,406440,6.105308692162565
hydralazine,Glassy eye,1,15307,15306,9,8,406520,3.0621687936466455
hydralazine,"Glomerulonephritis, Membranoproliferative",2,15307,15305,17,15,406513,3.242446720602648
hydralazine,Glucocorticoid deficiency,4,15307,15303,8,4,406524,13.782493628700255
hydralazine,Graft versus host disease in liver,1,15307,15306,8,7,406521,3.4449480595844766
hydralazine,Haematoma infection,2,15307,15305,8,6,406522,6.890346292061418
hydralazine,Haemorrhage urinary tract,17,15307,15290,33,16,406512,14.211376023148421
hydralazine,Hematoma of abdominal wall,4,15307,15303,22,18,406510,5.011649528018867
hydralazine,"Hemianopsia, Homonymous",1,15307,15306,8,7,406521,3.4449480595844766
hydralazine,Hemoperitoneum,4,15307,15303,14,10,406518,7.875598622118911
hydralazine,Hernia of abdominal cavity,4,15307,15303,26,22,406506,4.240586310376547
hydralazine,Herpes dermatitis,4,15307,15303,5,1,406527,22.052146637914138
hydralazine,Hirsutism,3,15307,15304,17,14,406514,4.863987884751392
hydralazine,Hostility,40,15307,15267,62,22,406506,17.823515615590868
hydralazine,Human chorionic gonadotropin decreased,3,15307,15304,14,11,406517,5.906313008737212
hydralazine,Hydrops Fetalis,1,15307,15306,6,5,406523,4.59328585739797
hydralazine,Hyperbilirubinemia,8,15307,15299,31,23,406505,7.115017005117349
hydralazine,Hypercalcemia,6,15307,15301,36,30,406498,4.594460057076879
hydralazine,Hyperglycaemic hyperosmolar nonketotic syndrome,9,15307,15298,18,9,406519,13.78667146032161
hydralazine,Hyperglycaemic seizure,1,15307,15306,8,7,406521,3.4449480595844766
hydralazine,Hyperplasia,11,15307,15296,87,76,406452,3.486170225556678
hydralazine,Hypersensitivity,44,15307,15263,203,159,406369,5.98756579628962
hydralazine,Hypertensive Encephalopathy,4,15307,15303,33,29,406499,3.3410125564605075
hydralazine,Hyphema,2,15307,15305,5,3,406525,11.024632473048024
hydralazine,Hypokalemic alkalosis,1,15307,15306,5,4,406524,5.511956095648765
hydralazine,Hyponatremic encephalopathy,2,15307,15305,13,11,406517,4.2401628427110305
hydralazine,Hypopigmentation disorder,2,15307,15305,6,4,406524,9.187171948165087
hydralazine,Hypovolemic Shock,11,15307,15296,78,67,406461,3.8885036141508422
hydralazine,Ileal Stenosis,5,15307,15302,45,40,406488,3.062707852277843
hydralazine,Immune-mediated hepatitis,2,15307,15305,10,8,406520,5.512250898399216
hydralazine,Impacted tooth,1,15307,15306,5,4,406524,5.511956095648765
hydralazine,Incision site erythema,5,15307,15302,35,30,406498,3.9378605971208245
hydralazine,Infected neoplasm,1,15307,15306,7,6,406522,3.9370928300759735
hydralazine,Infective pulmonary exacerbation of cystic fibrosis,1,15307,15306,5,4,406524,5.511956095648765
hydralazine,Influenza A virus test,5,15307,15302,19,14,406514,7.2542288933679115
hydralazine,Infusion site infection,1,15307,15306,7,6,406522,3.9370928300759735
hydralazine,Inhibitory drug interaction,1,15307,15306,5,4,406524,5.511956095648765
hydralazine,Injury of cornea,3,15307,15304,14,11,406517,5.906313008737212
hydralazine,Injury of tongue,16,15307,15291,137,121,406407,3.2208097220491805
hydralazine,Instillation site pain,2,15307,15305,18,16,406512,3.062303531888635
hydralazine,International normalised ratio fluctuation,3,15307,15304,12,9,406519,6.890731181390486
hydralazine,International normalized ratio decreased,2,15307,15305,11,9,406519,5.01112530070387
hydralazine,Interstitial Cystitis,1,15307,15306,5,4,406524,5.511956095648765
hydralazine,Intestinal fibrosis,7,15307,15300,59,52,406476,3.270667996011964
hydralazine,Intestinal hemorrhage NOS,7,15307,15300,24,17,406511,8.041059368191721
hydralazine,Intraocular pressure test,2,15307,15305,10,8,406520,5.512250898399216
hydralazine,Joint crepitus,1,15307,15306,5,4,406524,5.511956095648765
hydralazine,Jugular vein distension,8,15307,15299,9,1,406527,24.508559019834266
hydralazine,Kidney Transplantation,2,15307,15305,9,7,406521,6.124737740026861
hydralazine,Klebsiella Infections,4,15307,15303,32,28,406500,3.445427367182905
hydralazine,Labelled drug-drug interaction medication error,3,15307,15304,20,17,406511,4.134360297961317
hydralazine,Lacrimation decreased,3,15307,15304,12,9,406519,6.890731181390486
hydralazine,Large intestinal obstruction reduction,14,15307,15293,98,84,406444,3.939589541433522
hydralazine,Large intestine perforation,16,15307,15291,78,62,406466,5.657854712592793
hydralazine,"Leishmaniasis, Visceral",11,15307,15296,84,73,406455,3.6107019886929668
hydralazine,Lipoatrophy,1,15307,15306,8,7,406521,3.4449480595844766
hydralazine,Lipomatosis,5,15307,15302,11,6,406522,12.530269364670096
hydralazine,Lividity,1,15307,15306,5,4,406524,5.511956095648765
hydralazine,Loin abscess,9,15307,15298,48,39,406489,5.169634102497058
hydralazine,Loss of anatomical alignment after fracture reduction,10,15307,15297,75,65,406463,3.676189231003901
hydralazine,Low birth weight baby,24,15307,15283,118,94,406434,5.612311009130562
hydralazine,Lower gastrointestinal hemorrhage,20,15307,15287,37,17,406511,14.914562629614636
hydralazine,Lung Neoplasms,2,15307,15305,7,5,406523,7.874700144677275
hydralazine,Lung carcinoma cell type unspecified stage III,4,15307,15303,33,29,406499,3.3410125564605075
hydralazine,Lysis of adhesions of intestines,1,15307,15306,6,5,406523,4.59328585739797
hydralazine,Major Depressive Disorder,1,15307,15306,8,7,406521,3.4449480595844766
hydralazine,Malabsorption from injection site,4,15307,15303,5,1,406527,22.052146637914138
hydralazine,Malignant neoplasm of female breast,1,15307,15306,9,8,406520,3.0621687936466455
hydralazine,Malignant neoplasm of ovary,2,15307,15305,14,12,406516,3.9372847342138417
hydralazine,Malignant neoplasm of stomach,2,15307,15305,6,4,406524,9.187171948165087
hydralazine,Mantle cell lymphoma,8,15307,15299,60,52,406476,3.67583937948014
hydralazine,Mass in breast,3,15307,15304,16,13,406515,5.167999379247256
hydralazine,Meningitis,7,15307,15300,34,27,406501,5.675907343329489
hydralazine,Meniscal degeneration,13,15307,15294,22,9,406519,16.297445819513296
hydralazine,Mental blocking,9,15307,15298,19,10,406518,13.061026209136385
hydralazine,Merkel cell carcinoma,2,15307,15305,17,15,406513,3.242446720602648
hydralazine,Mesenteric arterial occlusion,1,15307,15306,6,5,406523,4.59328585739797
hydralazine,Middle ear effusion,1,15307,15306,5,4,406524,5.511956095648765
hydralazine,Mixed liver injury,2,15307,15305,7,5,406523,7.874700144677275
hydralazine,Motor delay,2,15307,15305,6,4,406524,9.187171948165087
hydralazine,Myeloma kidney,1,15307,15306,9,8,406520,3.0621687936466455
hydralazine,Myeloproliferative disease,8,15307,15299,58,50,406478,3.8026104929102873
hydralazine,Myocardial calcification,3,15307,15304,17,14,406514,4.863987884751392
hydralazine,Nail discomfort,1,15307,15306,8,7,406521,3.4449480595844766
hydralazine,Necrosis of kidney,1,15307,15306,9,8,406520,3.0621687936466455
hydralazine,Necrotising colitis,6,15307,15301,20,14,406514,8.270341807724984
hydralazine,Neoplasm of pericardium,1,15307,15306,6,5,406523,4.59328585739797
hydralazine,Neutropenic colitis,1,15307,15306,6,5,406523,4.59328585739797
hydralazine,Neutrophilic dermatosis,3,15307,15304,9,6,406522,9.18770691758146
hydralazine,Nikolsky sign,3,15307,15304,14,11,406517,5.906313008737212
hydralazine,Noninfectious peritonitis,1,15307,15306,8,7,406521,3.4449480595844766
hydralazine,Normocytic anemia,1,15307,15306,5,4,406524,5.511956095648765
hydralazine,Obesity,5,15307,15302,22,17,406511,6.2649713049987525
hydralazine,Ocular Toxoplasmosis,3,15307,15304,26,23,406505,3.180231915235836
hydralazine,Oestradiol increased,1,15307,15306,8,7,406521,3.4449480595844766
hydralazine,Ophthalmoplegia,2,15307,15305,17,15,406513,3.242446720602648
hydralazine,Oral fibroma,3,15307,15304,23,20,406508,3.595070342507784
hydralazine,Oropharyngeal candidiasis,8,15307,15299,21,13,406515,10.503369345646618
hydralazine,Otitis Externa,2,15307,15305,12,10,406518,4.593520635957748
hydralazine,Pancreatic Insufficiency,4,15307,15303,32,28,406500,3.445427367182905
hydralazine,Pancreatic carcinoma recurrent,1,15307,15306,7,6,406522,3.9370928300759735
hydralazine,Pancreatic duct dilatation,1,15307,15306,5,4,406524,5.511956095648765
hydralazine,Papilledema,2,15307,15305,12,10,406518,4.593520635957748
hydralazine,Paralysed,4,15307,15303,35,31,406497,3.1500826168538385
hydralazine,Parophthalmia,1,15307,15306,6,5,406523,4.59328585739797
hydralazine,Paroxysmal nocturnal hemoglobinuria,1,15307,15306,5,4,406524,5.511956095648765
hydralazine,Patient Non-Compliance,1,15307,15306,7,6,406522,3.9370928300759735
hydralazine,Pelvic Floor Muscle Weakness,2,15307,15305,6,4,406524,9.187171948165087
hydralazine,Pelvic Pain,2,15307,15305,18,16,406512,3.062303531888635
hydralazine,Pemphigus,10,15307,15297,45,35,406493,6.127417866974643
hydralazine,Penile haematoma,2,15307,15305,13,11,406517,4.2401628427110305
hydralazine,Penile swelling,1,15307,15306,6,5,406523,4.59328585739797
hydralazine,Perforation of ileum,3,15307,15304,14,11,406517,5.906313008737212
hydralazine,Peripheral Ischemia,2,15307,15305,13,11,406517,4.2401628427110305
hydralazine,Peritoneal effluent abnormal,2,15307,15305,8,6,406522,6.890346292061418
hydralazine,Pharyngeal lesion,1,15307,15306,9,8,406520,3.0621687936466455
hydralazine,Pharyngeal necrosis,3,15307,15304,6,3,406525,13.78165838996341
hydralazine,Pharyngitis bacterial,1,15307,15306,6,5,406523,4.59328585739797
hydralazine,Pharyngotonsillitis,1,15307,15306,5,4,406524,5.511956095648765
hydralazine,Placenta Disorders,1,15307,15306,6,5,406523,4.59328585739797
hydralazine,Plaque shift,4,15307,15303,7,3,406525,15.751458630894035
hydralazine,Pneumatosis Cystoides Intestinalis,2,15307,15305,7,5,406523,7.874700144677275
hydralazine,Pneumonia due to Klebsiella pneumoniae,2,15307,15305,14,12,406516,3.9372847342138417
hydralazine,"Pneumonia, Viral",2,15307,15305,12,10,406518,4.593520635957748
hydralazine,Pneumonitis,7,15307,15300,55,48,406480,3.508568033273915
hydralazine,Post procedural infection,10,15307,15297,14,4,406524,19.696719244669826
hydralazine,Postoperative retention of urine,1,15307,15306,5,4,406524,5.511956095648765
hydralazine,Postresuscitation encephalopathy,1,15307,15306,6,5,406523,4.59328585739797
hydralazine,Postural dizziness,6,15307,15301,36,30,406498,4.594460057076879
hydralazine,Prescribed underdose,1,15307,15306,5,4,406524,5.511956095648765
hydralazine,Procalcitonin increased,9,15307,15298,48,39,406489,5.169634102497058
hydralazine,Procedural complication,3,15307,15304,17,14,406514,4.863987884751392
hydralazine,Proctitis infectious,4,15307,15303,19,15,406513,5.803003882967564
hydralazine,Product administration error,8,15307,15299,25,17,406511,8.8227465847441
hydralazine,Product barcode issue,3,15307,15304,21,18,406510,3.937476663430662
hydralazine,Product compounding quality issue,1,15307,15306,6,5,406523,4.59328585739797
hydralazine,Product monitoring error,1,15307,15306,9,8,406520,3.0621687936466455
hydralazine,Product physical issue,2,15307,15305,15,13,406515,3.6747903735162804
hydralazine,Proliferative glomerulonephritis,4,15307,15303,6,2,406526,18.376745300485744
hydralazine,Prophylactic treatment,2,15307,15305,9,7,406521,6.124737740026861
hydralazine,Proteinuria,2,15307,15305,6,4,406524,9.187171948165087
hydralazine,Pulmonary Alveolar Hemorrhage,93,15307,15214,126,33,406495,20.458880291961666
hydralazine,Pulmonary renal syndrome,25,15307,15282,65,40,406488,10.615052399504696
hydralazine,Pulmonary sepsis,1,15307,15306,6,5,406523,4.59328585739797
hydralazine,Pulpitis,3,15307,15304,15,12,406516,5.512545739675902
hydralazine,Puncture site haematoma,3,15307,15304,6,3,406525,13.78165838996341
hydralazine,Pupil Disorders,2,15307,15305,9,7,406521,6.124737740026861
hydralazine,Pustular rash,2,15307,15305,13,11,406517,4.2401628427110305
hydralazine,Radiation esophagitis,2,15307,15305,7,5,406523,7.874700144677275
hydralazine,Reaction to colouring,1,15307,15306,7,6,406522,3.9370928300759735
hydralazine,Rectal Prolapse,1,15307,15306,8,7,406521,3.4449480595844766
hydralazine,Rectal hemorrhage,5,15307,15302,43,38,406490,3.2051745781825143
hydralazine,Red blood cells urine positive,15,15307,15292,33,18,406510,12.537809430956175
hydralazine,Reduced fluid intake,1,15307,15306,8,7,406521,3.4449480595844766
hydralazine,Removal of internal fixation device,3,15307,15304,13,10,406518,6.360659857654108
hydralazine,Renal function tests outside reference range,6,15307,15301,33,27,406501,5.012173892377801
hydralazine,Repeat Surgery,4,15307,15303,13,9,406519,8.481434007409307
hydralazine,Replacement of aortic valve (procedure),2,15307,15305,5,3,406525,11.024632473048024
hydralazine,"Respiratory Distress Syndrome, Newborn",1,15307,15306,9,8,406520,3.0621687936466455
hydralazine,Restrictive pulmonary disease,84,15307,15223,263,179,406349,8.844943200565284
hydralazine,Retinal Degeneration,2,15307,15305,5,3,406525,11.024632473048024
hydralazine,Retinal Neovascularization,1,15307,15306,7,6,406522,3.9370928300759735
hydralazine,Retinal artery embolism,4,15307,15303,21,17,406511,5.250311952527204
hydralazine,Retinal migraine,2,15307,15305,7,5,406523,7.874700144677275
hydralazine,Retinoic acid syndrome,1,15307,15306,6,5,406523,4.59328585739797
hydralazine,Retroperitoneal hematoma,2,15307,15305,18,16,406512,3.062303531888635
hydralazine,Rosacea,19,15307,15288,107,88,406440,4.898369987822591
hydralazine,Scleritis,4,15307,15303,19,15,406513,5.803003882967564
hydralazine,Scratch marks,4,15307,15303,8,4,406524,13.782493628700255
hydralazine,Scrotal dermatitis,2,15307,15305,6,4,406524,9.187171948165087
hydralazine,Seborrheic dermatitis of scalp,3,15307,15304,21,18,406510,3.937476663430662
hydralazine,Secondary immune deficiency disorder,1,15307,15306,6,5,406523,4.59328585739797
hydralazine,Sensorimotor neuropathy,70,15307,15237,405,335,406193,4.780452391311922
hydralazine,Silicosis,17,15307,15290,17,0,406528,27.587835186396337
hydralazine,"Sleep Disorders, Circadian Rhythm",2,15307,15305,13,11,406517,4.2401628427110305
hydralazine,Small cell lung cancer extensive stage,1,15307,15306,8,7,406521,3.4449480595844766
hydralazine,Small kidney,4,15307,15303,23,19,406509,4.793740357815603
hydralazine,Solar dermatitis,1,15307,15306,5,4,406524,5.511956095648765
hydralazine,Squamous cell carcinoma of the head and neck,2,15307,15305,15,13,406515,3.6747903735162804
hydralazine,Stage II Rectal Cancer,1,15307,15306,7,6,406522,3.9370928300759735
hydralazine,Stage IV Renal Cell Cancer,1,15307,15306,5,4,406524,5.511956095648765
hydralazine,Stage IVB Vaginal Cancer AJCC v6 and v7,4,15307,15303,6,2,406526,18.376745300485744
hydralazine,Steroid withdrawal syndrome,3,15307,15304,25,22,406506,3.3074490329325665
hydralazine,Stomach Neoplasms,2,15307,15305,11,9,406519,5.01112530070387
hydralazine,Stress Fractures,5,15307,15302,28,23,406505,4.922407435069179
hydralazine,"Stroke, Lacunar",4,15307,15303,10,6,406522,11.025942625628963
hydralazine,Surgical Wound Infection,3,15307,15304,12,9,406519,6.890731181390486
hydralazine,Suture rupture,5,15307,15302,34,29,406499,4.053689636879454
hydralazine,Sweat gland infection,4,15307,15303,6,2,406526,18.376745300485744
hydralazine,"Synovitis, Acne, Pustulosis, Hyperostosis, and Osteitis Syndrome",2,15307,15305,11,9,406519,5.01112530070387
hydralazine,Syringomyelia,4,15307,15303,31,27,406501,3.5565786173067475
hydralazine,Tetralogy of Fallot,1,15307,15306,5,4,406524,5.511956095648765
hydralazine,Therapeutic reaction time decreased,3,15307,15304,8,5,406523,10.336194785676948
hydralazine,Throat clearing,8,15307,15299,9,1,406527,24.508559019834266
hydralazine,Thrombosis of renal artery,5,15307,15302,45,40,406488,3.062707852277843
hydralazine,Tongue erythema,1,15307,15306,5,4,406524,5.511956095648765
hydralazine,Tracheal Diseases,2,15307,15305,16,14,406514,3.445107807905913
hydralazine,Tracheitis,1,15307,15306,5,4,406524,5.511956095648765
hydralazine,Transfusion-Related Acute Lung Injury,4,15307,15303,14,10,406518,7.875598622118911
hydralazine,Traumatic hematoma,177,15307,15130,521,344,406184,9.460247655317383
hydralazine,Umbilical hernia,532,15307,14775,2763,2231,404297,5.461248048756441
hydralazine,Urea renal clearance increased,3,15307,15304,17,14,406514,4.863987884751392
hydralazine,Ureteral obstruction,1,15307,15306,9,8,406520,3.0621687936466455
hydralazine,Urinary casts present,1,15307,15306,6,5,406523,4.59328585739797
hydralazine,Urine sodium abnormal,1,15307,15306,8,7,406521,3.4449480595844766
hydralazine,Urogenital Diseases,812,15307,14495,3361,2549,403979,6.974896657159169
hydralazine,Uterine Cervicitis,2,15307,15305,9,7,406521,6.124737740026861
hydralazine,Uterine Polyp,1,15307,15306,6,5,406523,4.59328585739797
hydralazine,Vaginal abscess,13,15307,15294,56,43,406485,6.402051925124699
hydralazine,Vanishing bile duct syndrome,1,15307,15306,8,7,406521,3.4449480595844766
hydralazine,Vascular Headaches,2,15307,15305,5,3,406525,11.024632473048024
hydralazine,Vascular calcification,1,15307,15306,5,4,406524,5.511956095648765
hydralazine,Vasculitic rash,2,15307,15305,11,9,406519,5.01112530070387
hydralazine,Venous perforation,1,15307,15306,5,4,406524,5.511956095648765
hydralazine,Ventricular arrhythmia,3,15307,15304,16,13,406515,5.167999379247256
hydralazine,Vertigo,22,15307,15285,118,96,406432,5.143945265935918
hydralazine,Virus Diseases,3,15307,15304,20,17,406511,4.134360297961317
hydralazine,Vocal Cord Paralysis,1,15307,15306,8,7,406521,3.4449480595844766
hydralazine,Weaning failure,2,15307,15305,16,14,406514,3.445107807905913
hydralazine,Winged scapula,1,15307,15306,5,4,406524,5.511956095648765
hydralazine,Wound hematoma,1,15307,15306,9,8,406520,3.0621687936466455
hydralazine,Wrong drug administered,3,15307,15304,25,22,406506,3.3074490329325665
hydralazine,amniotic fluid meconium stained,17,15307,15290,31,14,406514,15.128310723854932
hydralazine,colonoscopy,2,15307,15305,7,5,406523,7.874700144677275
hydralazine,nail avulsion injury,5,15307,15302,30,25,406503,4.59422515575306
hydrochlorothiazide,Abdominal symptom,2,8267,8265,9,7,413561,11.341695234254217
hydrochlorothiazide,Abdominal wall haemorrhage,1,8267,8266,8,7,413561,6.3789468908782965
hydrochlorothiazide,Abnormal behavior,6,8267,8261,59,53,413515,5.192164940839025
hydrochlorothiazide,Abnormal breath sounds,3,8267,8264,12,9,413559,12.760860358180057
hydrochlorothiazide,Abnormal mean corpuscular volume,2,8267,8265,14,12,413556,7.291003370495202
hydrochlorothiazide,Abnormal nail growth,1,8267,8266,11,10,413558,4.639201108593802
hydrochlorothiazide,Abscess bacterial,1,8267,8266,6,5,413563,8.50530284700379
hydrochlorothiazide,Abscess of intestine,3,8267,8264,20,17,413551,7.6563710067763795
hydrochlorothiazide,Abscess of limb,2,8267,8265,24,22,413546,4.2529844726759425
hydrochlorothiazide,Absence Epilepsy,1,8267,8266,6,5,413563,8.50530284700379
hydrochlorothiazide,Acquired corneal dystrophy,1,8267,8266,10,9,413559,5.1031333172030005
hydrochlorothiazide,Acrochordon excision,4,8267,8263,47,43,413525,4.344287917684834
hydrochlorothiazide,Acute left ventricular failure,1,8267,8266,10,9,413559,5.1031333172030005
hydrochlorothiazide,Addisonian crisis,3,8267,8264,37,34,413534,4.138412129457628
hydrochlorothiazide,Adjustment Disorders,2,8267,8265,14,12,413556,7.291003370495202
hydrochlorothiazide,Administration of enema,1,8267,8266,10,9,413559,5.1031333172030005
hydrochlorothiazide,Alcohol poisoning,6,8267,8261,94,88,413480,3.2586416048749958
hydrochlorothiazide,"Alcoholic Intoxication, Chronic",1,8267,8266,14,13,413555,3.6450606615740897
hydrochlorothiazide,Allergy to chemicals,2,8267,8265,20,18,413550,5.103629764065336
hydrochlorothiazide,Alopecia Areata,2,8267,8265,6,4,413564,17.012663843516837
hydrochlorothiazide,Altered bowel function,7,8267,8260,104,97,413471,3.4365303129074314
hydrochlorothiazide,Aminoaciduria,1,8267,8266,15,14,413554,3.402048552302605
hydrochlorothiazide,Amputation of toe (procedure),5,8267,8262,54,49,413519,4.726917973407927
hydrochlorothiazide,Anaemia postoperative,3,8267,8264,29,26,413542,5.280143205260874
hydrochlorothiazide,Anal sphincter atony,2,8267,8265,5,3,413565,20.41524500907441
hydrochlorothiazide,Analgesic drug level increased,1,8267,8266,13,12,413556,3.925459249195035
hydrochlorothiazide,Anemia due to blood loss,1,8267,8266,12,11,413557,4.252590934752803
hydrochlorothiazide,Angioplasty renal artery,1,8267,8266,13,12,413556,3.925459249195035
hydrochlorothiazide,Ankylosing spondylitis,2,8267,8265,13,11,413557,7.851868397784914
hydrochlorothiazide,Anosmia,2,8267,8265,13,11,413557,7.851868397784914
hydrochlorothiazide,Antiphospholipid Syndrome,1,8267,8266,17,16,413552,3.001793313502512
hydrochlorothiazide,Antiphospholipid antibodies positive,1,8267,8266,5,4,413564,10.206387611904187
hydrochlorothiazide,Antipsychotic drug level below therapeutic,1,8267,8266,7,6,413562,7.290242300646365
hydrochlorothiazide,Aphakic cystoid macular oedema,1,8267,8266,7,6,413562,7.290242300646365
hydrochlorothiazide,Application of cast,1,8267,8266,9,8,413560,5.670161572169799
hydrochlorothiazide,Application site burn,1,8267,8266,9,8,413560,5.670161572169799
hydrochlorothiazide,Application site reaction,1,8267,8266,16,15,413553,3.1894129566900555
hydrochlorothiazide,Arnold Chiari Malformation,1,8267,8266,17,16,413552,3.001793313502512
hydrochlorothiazide,Arterial hemorrhage,1,8267,8266,7,6,413562,7.290242300646365
hydrochlorothiazide,"Arthritis, Psoriatic",2,8267,8265,7,5,413563,14.582248725261428
hydrochlorothiazide,Arthroplasty of the shoulder (procedure),3,8267,8264,15,12,413556,10.208615682478218
hydrochlorothiazide,Arthropod sting,2,8267,8265,34,32,413536,3.002035514750365
hydrochlorothiazide,Ascorbic Acid Deficiency,1,8267,8266,8,7,413561,6.3789468908782965
hydrochlorothiazide,Asterixis,1,8267,8266,6,5,413563,8.50530284700379
hydrochlorothiazide,Athletic Injuries,1,8267,8266,8,7,413561,6.3789468908782965
hydrochlorothiazide,Atrial Fibrillation,2,8267,8265,18,16,413552,5.670726624991597
hydrochlorothiazide,Atrial standstill,1,8267,8266,6,5,413563,8.50530284700379
hydrochlorothiazide,Atrophy of cerebellum,1,8267,8266,5,4,413564,10.206387611904187
hydrochlorothiazide,Atypical fracture of femur,5,8267,8262,41,36,413532,6.22588872947553
hydrochlorothiazide,Autonomic neuropathy,2,8267,8265,15,13,413555,6.804920346844122
hydrochlorothiazide,Back Injuries,9,8267,8258,153,144,413424,3.003732565925377
hydrochlorothiazide,Bacteremia,2,8267,8265,23,21,413547,4.437907362108419
hydrochlorothiazide,Bacterial peritonitis,1,8267,8266,12,11,413557,4.252590934752803
hydrochlorothiazide,Bacterial sinusitis,1,8267,8266,8,7,413561,6.3789468908782965
hydrochlorothiazide,Basal Ganglia Hemorrhage,3,8267,8264,42,39,413529,3.6457008021020605
hydrochlorothiazide,Benign Prostatic Hyperplasia,2,8267,8265,13,11,413557,7.851868397784914
hydrochlorothiazide,Benign neoplasm of breast,1,8267,8266,6,5,413563,8.50530284700379
hydrochlorothiazide,Biopsy of pancreas,1,8267,8266,9,8,413560,5.670161572169799
hydrochlorothiazide,Biopsy of stomach,1,8267,8266,13,12,413556,3.925459249195035
hydrochlorothiazide,Bladder cancer stage IV,1,8267,8266,14,13,413555,3.6450606615740897
hydrochlorothiazide,Bladder hemorrhage,1,8267,8266,7,6,413562,7.290242300646365
hydrochlorothiazide,Bleeding gastric ulcer,3,8267,8264,51,48,413520,3.002277774614202
hydrochlorothiazide,Blood 25-hydroxycholecalciferol decreased,4,8267,8263,59,55,413513,3.4606054763218514
hydrochlorothiazide,Blood bicarbonate level decreased below normal,1,8267,8266,11,10,413558,4.639201108593802
hydrochlorothiazide,Blood chloride decreased,1,8267,8266,11,10,413558,4.639201108593802
hydrochlorothiazide,Blood folate abnormal,1,8267,8266,5,4,413564,10.206387611904187
hydrochlorothiazide,Blood lactic acid,1,8267,8266,8,7,413561,6.3789468908782965
hydrochlorothiazide,Blood parathyroid hormone decreased,1,8267,8266,5,4,413564,10.206387611904187
hydrochlorothiazide,Blood potassium decreased,9,8267,8258,143,134,413434,3.2138600077568356
hydrochlorothiazide,Blood pressure difference of extremities,1,8267,8266,11,10,413558,4.639201108593802
hydrochlorothiazide,Blood pressure orthostatic increased,1,8267,8266,14,13,413555,3.6450606615740897
hydrochlorothiazide,Blood testosterone free decreased,1,8267,8266,15,14,413554,3.402048552302605
hydrochlorothiazide,Blood testosterone increased,1,8267,8266,17,16,413552,3.001793313502512
hydrochlorothiazide,Blood thyroid stimulating hormone decreased,2,8267,8265,28,26,413542,3.6453806931120902
hydrochlorothiazide,Blood urea nitrogen measurement,1,8267,8266,9,8,413560,5.670161572169799
hydrochlorothiazide,Bone Diseases,4,8267,8263,36,32,413536,5.671857140936168
hydrochlorothiazide,Bone density abnormal,2,8267,8265,16,14,413554,6.379597701149426
hydrochlorothiazide,Bone marrow harvest failure,4,8267,8263,61,57,413511,3.347127130026605
hydrochlorothiazide,Bone marrow toxicity,2,8267,8265,10,8,413560,10.207501512401693
hydrochlorothiazide,Bone trimming,4,8267,8263,14,10,413558,14.58553621133798
hydrochlorothiazide,Breast Cyst,6,8267,8261,68,62,413506,4.504870511332483
hydrochlorothiazide,Bronchial Diseases,1,8267,8266,5,4,413564,10.206387611904187
hydrochlorothiazide,Bronchiectasis,1,8267,8266,5,4,413564,10.206387611904187
hydrochlorothiazide,Bunion,2,8267,8265,19,17,413551,5.3722545929251435
hydrochlorothiazide,CSF test abnormal,1,8267,8266,6,5,413563,8.50530284700379
hydrochlorothiazide,Calciphylaxis,1,8267,8266,5,4,413564,10.206387611904187
hydrochlorothiazide,Calcium deposits in tendon,5,8267,8262,65,60,413508,3.92687559354226
hydrochlorothiazide,Cancer Remission,1,8267,8266,12,11,413557,4.252590934752803
hydrochlorothiazide,Candida test positive,1,8267,8266,15,14,413554,3.402048552302605
hydrochlorothiazide,"Carcinoma, Signet Ring Cell",1,8267,8266,5,4,413564,10.206387611904187
hydrochlorothiazide,Cardiac neoplasm unspecified,2,8267,8265,15,13,413555,6.804920346844122
hydrochlorothiazide,Cardiomyopathies,2,8267,8265,32,30,413538,3.1896778584392016
hydrochlorothiazide,Cardiorespiratory failure,1,8267,8266,12,11,413557,4.252590934752803
hydrochlorothiazide,Carotid Body Paraganglioma,2,8267,8265,11,9,413559,9.279524830885993
hydrochlorothiazide,Carotid artery occlusion,1,8267,8266,7,6,413562,7.290242300646365
hydrochlorothiazide,Cartilage Diseases,2,8267,8265,31,29,413539,3.2925784985266278
hydrochlorothiazide,Cataract operation,4,8267,8263,9,5,413563,22.688880820794168
hydrochlorothiazide,Cervical spinal cord injury,2,8267,8265,17,15,413553,6.0043130137717515
hydrochlorothiazide,Chemical burns of eye,1,8267,8266,10,9,413559,5.1031333172030005
hydrochlorothiazide,Chickenpox,2,8267,8265,27,25,413543,3.7804037552373906
hydrochlorothiazide,Chondromalacia,1,8267,8266,5,4,413564,10.206387611904187
hydrochlorothiazide,Chronic Fatigue Syndrome,7,8267,8260,62,55,413513,5.765076544559869
hydrochlorothiazide,Clostridium difficile sepsis,4,8267,8263,51,47,413521,4.003521486048128
hydrochlorothiazide,Clumsiness,1,8267,8266,10,9,413559,5.1031333172030005
hydrochlorothiazide,Colectomy,7,8267,8260,45,38,413530,7.94331450094162
hydrochlorothiazide,"Colitis, Ischemic",3,8267,8264,51,48,413520,3.002277774614202
hydrochlorothiazide,Collagen-vascular disease,1,8267,8266,7,6,413562,7.290242300646365
hydrochlorothiazide,Colon adenoma,6,8267,8261,84,78,413490,3.6466615940650557
hydrochlorothiazide,Colonic Pseudo-Obstruction,1,8267,8266,15,14,413554,3.402048552302605
hydrochlorothiazide,Colonoscopy abnormal,1,8267,8266,8,7,413561,6.3789468908782965
hydrochlorothiazide,Colorectal Carcinoma,11,8267,8256,159,148,413420,3.533497269757691
hydrochlorothiazide,Colostomy Procedure,1,8267,8266,17,16,413552,3.001793313502512
hydrochlorothiazide,Comatose,1,8267,8266,5,4,413564,10.206387611904187
hydrochlorothiazide,Complex Regional Pain Syndromes,1,8267,8266,9,8,413560,5.670161572169799
hydrochlorothiazide,Compression fracture,2,8267,8265,17,15,413553,6.0043130137717515
hydrochlorothiazide,Compression fracture of vertebral column,1,8267,8266,11,10,413558,4.639201108593802
hydrochlorothiazide,Computerised tomogram thorax abnormal,4,8267,8263,22,18,413550,9.281528830603017
hydrochlorothiazide,Concomitant disease aggravated,1,8267,8266,17,16,413552,3.001793313502512
hydrochlorothiazide,Constriction in throat,2,8267,8265,21,19,413549,4.860588252239794
hydrochlorothiazide,Contusion of eye,1,8267,8266,11,10,413558,4.639201108593802
hydrochlorothiazide,Corneal Scar,1,8267,8266,10,9,413559,5.1031333172030005
hydrochlorothiazide,Coronary Artery Bypass Surgery,1,8267,8266,11,10,413558,4.639201108593802
hydrochlorothiazide,Coronary Occlusion,2,8267,8265,24,22,413546,4.2529844726759425
hydrochlorothiazide,Counterfeit drug administered,2,8267,8265,9,7,413561,11.341695234254217
hydrochlorothiazide,Cyst removal,2,8267,8265,25,23,413545,4.082855414398064
hydrochlorothiazide,Deafness,1,8267,8266,13,12,413556,3.925459249195035
hydrochlorothiazide,Debridement of bone,1,8267,8266,5,4,413564,10.206387611904187
hydrochlorothiazide,Decreased CD4:CD8 ratio,1,8267,8266,8,7,413561,6.3789468908782965
hydrochlorothiazide,Decreased Libido,2,8267,8265,24,22,413546,4.2529844726759425
hydrochlorothiazide,Decreased body weight,1,8267,8266,16,15,413553,3.1894129566900555
hydrochlorothiazide,Decreased mean corpuscular volume,8,8267,8259,74,66,413502,5.520739046347474
hydrochlorothiazide,Decreased systolic arterial pressure,1,8267,8266,9,8,413560,5.670161572169799
hydrochlorothiazide,Decreased therapeutic response,1,8267,8266,8,7,413561,6.3789468908782965
hydrochlorothiazide,Deformity of knee joint,3,8267,8264,41,38,413530,3.7346291880150164
hydrochlorothiazide,Deformity of limb,2,8267,8265,21,19,413549,4.860588252239794
hydrochlorothiazide,Degenerative polyarthritis,3,8267,8264,28,25,413543,5.46873271331766
hydrochlorothiazide,Delayed Ejaculation,3,8267,8264,43,40,413528,3.5609086201850557
hydrochlorothiazide,Dental Fistula,1,8267,8266,8,7,413561,6.3789468908782965
hydrochlorothiazide,Dental Pulp Diseases,2,8267,8265,30,28,413540,3.4023391812865498
hydrochlorothiazide,Dental abscess,2,8267,8265,15,13,413555,6.804920346844122
hydrochlorothiazide,Dental alveolar anomaly,2,8267,8265,7,5,413563,14.582248725261428
hydrochlorothiazide,"Dermatitis, Atopic",3,8267,8264,10,7,413561,15.313105033881897
hydrochlorothiazide,Dermatologic disorders,2,8267,8265,34,32,413536,3.002035514750365
hydrochlorothiazide,Detachment of retinal pigment epithelium,5,8267,8262,11,6,413562,23.20723575625536
hydrochlorothiazide,Device Failure,8,8267,8259,100,92,413476,4.085095047826614
hydrochlorothiazide,"Diabetes Mellitus, Non-Insulin-Dependent",1,8267,8266,8,7,413561,6.3789468908782965
hydrochlorothiazide,Diabetic Neuropathies,1,8267,8266,6,5,413563,8.50530284700379
hydrochlorothiazide,Diabetic ketoacidotic hyperglycaemic coma,1,8267,8266,14,13,413555,3.6450606615740897
hydrochlorothiazide,Difficulty driving a car,3,8267,8264,51,48,413520,3.002277774614202
hydrochlorothiazide,Dilatation of esophagus (disorder),1,8267,8266,8,7,413561,6.3789468908782965
hydrochlorothiazide,Dilatation of the bladder,1,8267,8266,12,11,413557,4.252590934752803
hydrochlorothiazide,Diplopia,1,8267,8266,7,6,413562,7.290242300646365
hydrochlorothiazide,Disorder of ligament,6,8267,8261,93,87,413481,3.2936885716405495
hydrochlorothiazide,Disorder of macula of retina,1,8267,8266,10,9,413559,5.1031333172030005
hydrochlorothiazide,Disorder of palate,1,8267,8266,15,14,413554,3.402048552302605
hydrochlorothiazide,Drug dose omission,2,8267,8265,25,23,413545,4.082855414398064
hydrochlorothiazide,Drug resistance,2,8267,8265,11,9,413559,9.279524830885993
hydrochlorothiazide,Duodenal Obstruction,2,8267,8265,14,12,413556,7.291003370495202
hydrochlorothiazide,Dysgeusia,23,8267,8244,294,271,413297,4.000205880508438
hydrochlorothiazide,Dyslalia,1,8267,8266,12,11,413557,4.252590934752803
hydrochlorothiazide,Ectopic Pregnancy,1,8267,8266,12,11,413557,4.252590934752803
hydrochlorothiazide,Embolic Stroke,1,8267,8266,15,14,413554,3.402048552302605
hydrochlorothiazide,"Encephalopathy, Toxic",1,8267,8266,13,12,413556,3.925459249195035
hydrochlorothiazide,Enchondroma,1,8267,8266,6,5,413563,8.50530284700379
hydrochlorothiazide,Endodontic procedure,6,8267,8261,71,65,413503,4.3144931810935825
hydrochlorothiazide,Endophthalmitis,1,8267,8266,16,15,413553,3.1894129566900555
hydrochlorothiazide,Endoscopy (procedure),1,8267,8266,13,12,413556,3.925459249195035
hydrochlorothiazide,Enteritis,1,8267,8266,8,7,413561,6.3789468908782965
hydrochlorothiazide,Episcleritis,1,8267,8266,9,8,413560,5.670161572169799
hydrochlorothiazide,Erythrocyte sedimentation rate outside reference range,3,8267,8264,11,8,413560,13.920971574408167
hydrochlorothiazide,Erythrocyte sedimentation rate raised,1,8267,8266,6,5,413563,8.50530284700379
hydrochlorothiazide,Excessive tearing,1,8267,8266,15,14,413554,3.402048552302605
hydrochlorothiazide,Exposure via body fluid,1,8267,8266,12,11,413557,4.252590934752803
hydrochlorothiazide,Extrapyramidal Disorders,1,8267,8266,13,12,413556,3.925459249195035
hydrochlorothiazide,Extravasation,3,8267,8264,19,16,413552,8.059357008202985
hydrochlorothiazide,Extrinsic allergic alveolitis,10,8267,8257,166,156,413412,3.0763893651388887
hydrochlorothiazide,Eye Hemorrhage,6,8267,8261,89,83,413485,3.4417521615714284
hydrochlorothiazide,Eye colour change,1,8267,8266,9,8,413560,5.670161572169799
hydrochlorothiazide,Eye oedema,5,8267,8262,48,43,413525,5.3178583676268865
hydrochlorothiazide,Eyelid Diseases,2,8267,8265,12,10,413558,8.506210929622906
hydrochlorothiazide,Facet joint pain,2,8267,8265,24,22,413546,4.2529844726759425
hydrochlorothiazide,Facial Paresis,1,8267,8266,12,11,413557,4.252590934752803
hydrochlorothiazide,Febrile infection,3,8267,8264,16,13,413555,9.570554513552759
hydrochlorothiazide,Fecaloma,3,8267,8264,20,17,413551,7.6563710067763795
hydrochlorothiazide,Feels hot,3,8267,8264,39,36,413532,3.9261672499813836
hydrochlorothiazide,Flattened T wave (finding),1,8267,8266,8,7,413561,6.3789468908782965
hydrochlorothiazide,Flatulence,11,8267,8256,121,110,413458,4.643609055673009
hydrochlorothiazide,Fluid imbalance,3,8267,8264,41,38,413530,3.7346291880150164
hydrochlorothiazide,Focal Infection,1,8267,8266,13,12,413556,3.925459249195035
hydrochlorothiazide,Foetal monitoring abnormal,1,8267,8266,7,6,413562,7.290242300646365
hydrochlorothiazide,"Fracture Fixation, Internal",1,8267,8266,16,15,413553,3.1894129566900555
hydrochlorothiazide,Fracture of patella,1,8267,8266,13,12,413556,3.925459249195035
hydrochlorothiazide,Fracture of sacrum,7,8267,8260,31,24,413544,11.531000546746856
hydrochlorothiazide,"Fractures, Ununited",23,8267,8244,317,294,413274,3.7097677002833147
hydrochlorothiazide,Freckles,1,8267,8266,5,4,413564,10.206387611904187
hydrochlorothiazide,Free thyroxine concentration decreased below normal,1,8267,8266,11,10,413558,4.639201108593802
hydrochlorothiazide,Frontotemporal dementia,2,8267,8265,10,8,413560,10.207501512401693
hydrochlorothiazide,Fungal pneumonia,2,8267,8265,8,6,413562,12.759437386569873
hydrochlorothiazide,Furred tongue,3,8267,8264,49,46,413522,3.1248345417547463
hydrochlorothiazide,Gall Bladder Diseases,4,8267,8263,43,39,413529,4.748452755207439
hydrochlorothiazide,Gangrene,2,8267,8265,13,11,413557,7.851868397784914
hydrochlorothiazide,Gastric mucosal lesion,3,8267,8264,8,5,413563,19.141472047434657
hydrochlorothiazide,Gastric pH decreased,1,8267,8266,5,4,413564,10.206387611904187
hydrochlorothiazide,Gastrointestinal Hemorrhage,4,8267,8263,67,63,413505,3.047341051007819
hydrochlorothiazide,Gastrointestinal Stromal Tumors,1,8267,8266,15,14,413554,3.402048552302605
hydrochlorothiazide,Gastrointestinal oedema,1,8267,8266,15,14,413554,3.402048552302605
hydrochlorothiazide,Gastrointestinal sounds abnormal,4,8267,8263,29,25,413543,7.041042954258076
hydrochlorothiazide,Gastrointestinal stoma complication,1,8267,8266,13,12,413556,3.925459249195035
hydrochlorothiazide,Gastrointestinal tract adenoma,2,8267,8265,14,12,413556,7.291003370495202
hydrochlorothiazide,"Genital Diseases, Male",1,8267,8266,5,4,413564,10.206387611904187
hydrochlorothiazide,Gingival Diseases,1,8267,8266,15,14,413554,3.402048552302605
hydrochlorothiazide,Glioblastoma,1,8267,8266,5,4,413564,10.206387611904187
hydrochlorothiazide,Glycosuria,1,8267,8266,8,7,413561,6.3789468908782965
hydrochlorothiazide,Gout,7,8267,8260,113,106,413462,3.1627568621568924
hydrochlorothiazide,HIV Seropositivity,1,8267,8266,12,11,413557,4.252590934752803
hydrochlorothiazide,Hard stool,1,8267,8266,8,7,413561,6.3789468908782965
hydrochlorothiazide,Heart valve stenosis,1,8267,8266,12,11,413557,4.252590934752803
hydrochlorothiazide,Heat Stroke,3,8267,8264,6,3,413565,25.522083736689257
hydrochlorothiazide,Hemangioma,2,8267,8265,8,6,413562,12.759437386569873
hydrochlorothiazide,Hematocrit decreased,1,8267,8266,5,4,413564,10.206387611904187
hydrochlorothiazide,Hemospermia,1,8267,8266,7,6,413562,7.290242300646365
hydrochlorothiazide,Hepatic calcification,1,8267,8266,9,8,413560,5.670161572169799
hydrochlorothiazide,"Hernia, Inguinal",1,8267,8266,17,16,413552,3.001793313502512
hydrochlorothiazide,High turnover osteopathy,2,8267,8265,5,3,413565,20.41524500907441
hydrochlorothiazide,Hirsutism,1,8267,8266,17,16,413552,3.001793313502512
hydrochlorothiazide,Hodgkin Disease,5,8267,8262,62,57,413511,4.116914985827067
hydrochlorothiazide,Hydrocephalus,1,8267,8266,8,7,413561,6.3789468908782965
hydrochlorothiazide,Hyperammonemic encephalopathy,1,8267,8266,15,14,413554,3.402048552302605
hydrochlorothiazide,Hypergammaglobulinemia,4,8267,8263,63,59,413509,3.2408537580993104
hydrochlorothiazide,Hyperkeratosis,1,8267,8266,16,15,413553,3.1894129566900555
hydrochlorothiazide,Hypermagnesemia,1,8267,8266,7,6,413562,7.290242300646365
hydrochlorothiazide,Hypersomnia,3,8267,8264,42,39,413529,3.6457008021020605
hydrochlorothiazide,Hypertensive cardiomyopathy,1,8267,8266,6,5,413563,8.50530284700379
hydrochlorothiazide,Hypertrophy of adenoids,1,8267,8266,11,10,413558,4.639201108593802
hydrochlorothiazide,Hypocupremia,1,8267,8266,9,8,413560,5.670161572169799
hydrochlorothiazide,Hypoglycemic shock,1,8267,8266,11,10,413558,4.639201108593802
hydrochlorothiazide,Hypomania,2,8267,8265,16,14,413554,6.379597701149426
hydrochlorothiazide,Hyponatremic encephalopathy,1,8267,8266,13,12,413556,3.925459249195035
hydrochlorothiazide,Hypopyon,1,8267,8266,5,4,413564,10.206387611904187
hydrochlorothiazide,Hyporeflexia,1,8267,8266,10,9,413559,5.1031333172030005
hydrochlorothiazide,Hysterectomy,3,8267,8264,17,14,413554,9.007559364500883
hydrochlorothiazide,Iatrogenic injury,1,8267,8266,10,9,413559,5.1031333172030005
hydrochlorothiazide,Ileal Fistula,1,8267,8266,6,5,413563,8.50530284700379
hydrochlorothiazide,Iliotibial Band Syndrome,2,8267,8265,20,18,413550,5.103629764065336
hydrochlorothiazide,Illusions,2,8267,8265,5,3,413565,20.41524500907441
hydrochlorothiazide,Immobile,1,8267,8266,5,4,413564,10.206387611904187
hydrochlorothiazide,Immune System Diseases,1,8267,8266,5,4,413564,10.206387611904187
hydrochlorothiazide,Immunologic Deficiency Syndromes,1,8267,8266,9,8,413560,5.670161572169799
hydrochlorothiazide,Impairment of urinary concentration,1,8267,8266,5,4,413564,10.206387611904187
hydrochlorothiazide,Increased Libido,1,8267,8266,17,16,413552,3.001793313502512
hydrochlorothiazide,Increased therapeutic response,1,8267,8266,11,10,413558,4.639201108593802
hydrochlorothiazide,Infection of kidney,4,8267,8263,63,59,413509,3.2408537580993104
hydrochlorothiazide,Infectious Lung Disorder,3,8267,8264,16,13,413555,9.570554513552759
hydrochlorothiazide,Infectious Mononucleosis,5,8267,8262,53,48,413520,4.816116523478714
hydrochlorothiazide,Infective glossitis,1,8267,8266,11,10,413558,4.639201108593802
hydrochlorothiazide,Infective vaginitis,7,8267,8260,115,108,413460,3.107737656595431
hydrochlorothiazide,Inflammatory marker increased,2,8267,8265,8,6,413562,12.759437386569873
hydrochlorothiazide,Injection site dryness,2,8267,8265,28,26,413542,3.6453806931120902
hydrochlorothiazide,Injection site edema,3,8267,8264,37,34,413534,4.138412129457628
hydrochlorothiazide,Injection site haematoma,1,8267,8266,17,16,413552,3.001793313502512
hydrochlorothiazide,Injection site hypertrophy,4,8267,8263,46,42,413526,4.438739482975444
hydrochlorothiazide,Injection site itching,6,8267,8261,82,76,413492,3.7356222745135086
hydrochlorothiazide,Injury of ear,1,8267,8266,5,4,413564,10.206387611904187
hydrochlorothiazide,Injury of pharynx,1,8267,8266,6,5,413563,8.50530284700379
hydrochlorothiazide,Injury of urethra,1,8267,8266,17,16,413552,3.001793313502512
hydrochlorothiazide,Internal injury,2,8267,8265,5,3,413565,20.41524500907441
hydrochlorothiazide,Interstitial Cystitis,1,8267,8266,5,4,413564,10.206387611904187
hydrochlorothiazide,Intestinal Polyps,13,8267,8254,161,148,413420,4.125055873530921
hydrochlorothiazide,Intra-abdominal hematoma,1,8267,8266,7,6,413562,7.290242300646365
hydrochlorothiazide,Intraductal Proliferative Lesion of the Breast,2,8267,8265,34,32,413536,3.002035514750365
hydrochlorothiazide,Intramedullary rod insertion,2,8267,8265,13,11,413557,7.851868397784914
hydrochlorothiazide,Iron deficiency,1,8267,8266,6,5,413563,8.50530284700379
hydrochlorothiazide,Irritable Bowel Syndrome,2,8267,8265,27,25,413543,3.7804037552373906
hydrochlorothiazide,Ischaemic cerebral infarction,3,8267,8264,16,13,413555,9.570554513552759
hydrochlorothiazide,Ischemic cardiomyopathy,2,8267,8265,14,12,413556,7.291003370495202
hydrochlorothiazide,Itching of eye,5,8267,8262,73,68,413500,3.4964667416095474
hydrochlorothiazide,Keratomileusis,1,8267,8266,6,5,413563,8.50530284700379
hydrochlorothiazide,Knee Replacement Arthroplasty,5,8267,8262,51,46,413522,5.005007570687438
hydrochlorothiazide,Labyrinthitis,6,8267,8261,91,85,413483,3.3660932941891666
hydrochlorothiazide,Lack of libido,3,8267,8264,41,38,413530,3.7346291880150164
hydrochlorothiazide,Laminoplasty,1,8267,8266,5,4,413564,10.206387611904187
hydrochlorothiazide,Laryngeal cleft,1,8267,8266,8,7,413561,6.3789468908782965
hydrochlorothiazide,Leukocytosis,1,8267,8266,6,5,413563,8.50530284700379
hydrochlorothiazide,Libido disorder,1,8267,8266,17,16,413552,3.001793313502512
hydrochlorothiazide,Limb crushing injury,7,8267,8260,36,29,413539,9.929354990583803
hydrochlorothiazide,Limb injury,5,8267,8262,80,75,413493,3.190472948438635
hydrochlorothiazide,Limb prosthesis user,1,8267,8266,11,10,413558,4.639201108593802
hydrochlorothiazide,Limb reconstructive surgery,2,8267,8265,26,24,413544,3.9258132067569456
hydrochlorothiazide,Lipiduria,1,8267,8266,7,6,413562,7.290242300646365
hydrochlorothiazide,Lipodystrophy acquired,1,8267,8266,9,8,413560,5.670161572169799
hydrochlorothiazide,Liver carcinoma,5,8267,8262,68,63,413505,3.753604382929643
hydrochlorothiazide,Liver cyst,2,8267,8265,21,19,413549,4.860588252239794
hydrochlorothiazide,Liver enzymes abnormal,2,8267,8265,13,11,413557,7.851868397784914
hydrochlorothiazide,Liver function tests abnormal,3,8267,8264,49,46,413522,3.1248345417547463
hydrochlorothiazide,Long QT Syndrome,3,8267,8264,10,7,413561,15.313105033881897
hydrochlorothiazide,Lung Abscess,1,8267,8266,6,5,413563,8.50530284700379
hydrochlorothiazide,Lymphedema,34,8267,8233,549,515,413053,3.169023678974636
hydrochlorothiazide,Lymphocyte count increased,2,8267,8265,31,29,413539,3.2925784985266278
hydrochlorothiazide,Lymphoproliferative Disorders,2,8267,8265,23,21,413547,4.437907362108419
hydrochlorothiazide,Lysis of adhesions of intestines,1,8267,8266,6,5,413563,8.50530284700379
hydrochlorothiazide,Macular degeneration,2,8267,8265,26,24,413544,3.9258132067569456
hydrochlorothiazide,Malignant Bone Neoplasm,5,8267,8262,33,28,413540,7.735341798522627
hydrochlorothiazide,Malignant Vaginal Neoplasm,1,8267,8266,8,7,413561,6.3789468908782965
hydrochlorothiazide,Malignant melanoma of retina,1,8267,8266,10,9,413559,5.1031333172030005
hydrochlorothiazide,Malignant neoplasm of kidney,1,8267,8266,5,4,413564,10.206387611904187
hydrochlorothiazide,Malignant neoplasm of stomach,1,8267,8266,6,5,413563,8.50530284700379
hydrochlorothiazide,Malignant urinary tract neoplasm metastatic,14,8267,8253,16,2,413566,44.72211620016964
hydrochlorothiazide,Mantoux: positive,1,8267,8266,13,12,413556,3.925459249195035
hydrochlorothiazide,Mask-like facies,1,8267,8266,11,10,413558,4.639201108593802
hydrochlorothiazide,Mass lesion of brain,1,8267,8266,13,12,413556,3.925459249195035
hydrochlorothiazide,Mass of thyroid gland,3,8267,8264,19,16,413552,8.059357008202985
hydrochlorothiazide,Mastication disorder,11,8267,8256,165,154,413414,3.404958010335917
hydrochlorothiazide,Mastoid effusion,3,8267,8264,8,5,413563,19.141472047434657
hydrochlorothiazide,Medical device removal,2,8267,8265,7,5,413563,14.582248725261428
hydrochlorothiazide,Menorrhagia,2,8267,8265,26,24,413544,3.9258132067569456
hydrochlorothiazide,Menstruation Disturbances,1,8267,8266,10,9,413559,5.1031333172030005
hydrochlorothiazide,Merkel cell carcinoma,1,8267,8266,17,16,413552,3.001793313502512
hydrochlorothiazide,Metabolic Syndrome X,6,8267,8261,31,25,413543,9.882518323564671
hydrochlorothiazide,Metamorphopsia,1,8267,8266,10,9,413559,5.1031333172030005
hydrochlorothiazide,Metastatic malignant neoplasm to bone,2,8267,8265,25,23,413545,4.082855414398064
hydrochlorothiazide,Metastatic malignant neoplasm to liver,10,8267,8257,88,78,413490,5.804262499036629
hydrochlorothiazide,Metrorrhagia,2,8267,8265,20,18,413550,5.103629764065336
hydrochlorothiazide,Mitral Valve Prolapse Syndrome,10,8267,8257,78,68,413500,6.548553985274343
hydrochlorothiazide,Monocyte percentage decreased,2,8267,8265,17,15,413553,6.0043130137717515
hydrochlorothiazide,Monoplegia,2,8267,8265,9,7,413561,11.341695234254217
hydrochlorothiazide,Muscle Fatigue,1,8267,8266,8,7,413561,6.3789468908782965
hydrochlorothiazide,Muscle hemorrhage,3,8267,8264,50,47,413521,3.0623305905130684
hydrochlorothiazide,Musculoskeletal chest pain,2,8267,8265,24,22,413546,4.2529844726759425
hydrochlorothiazide,Mycosis fungoides stage III,2,8267,8265,5,3,413565,20.41524500907441
hydrochlorothiazide,Myelomalacia,4,8267,8263,47,43,413525,4.344287917684834
hydrochlorothiazide,Myocardial fibrosis,2,8267,8265,9,7,413561,11.341695234254217
hydrochlorothiazide,Myocardial oedema,8,8267,8259,130,122,413446,3.1421572736501906
hydrochlorothiazide,Myositis,3,8267,8264,12,9,413559,12.760860358180057
hydrochlorothiazide,Negativism,1,8267,8266,17,16,413552,3.001793313502512
hydrochlorothiazide,Neoplasm Metastasis,1,8267,8266,15,14,413554,3.402048552302605
hydrochlorothiazide,Nerve Root Compression,2,8267,8265,14,12,413556,7.291003370495202
hydrochlorothiazide,Neurostimulator implantation,2,8267,8265,10,8,413560,10.207501512401693
hydrochlorothiazide,Neutrophil percentage increased,1,8267,8266,12,11,413557,4.252590934752803
hydrochlorothiazide,Operation on bone,2,8267,8265,24,22,413546,4.2529844726759425
hydrochlorothiazide,Operation on joint,2,8267,8265,11,9,413559,9.279524830885993
hydrochlorothiazide,Operative procedure on spine,1,8267,8266,17,16,413552,3.001793313502512
hydrochlorothiazide,Oral Surgical Procedures,1,8267,8266,8,7,413561,6.3789468908782965
hydrochlorothiazide,Organizing Pneumonia,1,8267,8266,5,4,413564,10.206387611904187
hydrochlorothiazide,Orthostatic intolerance,1,8267,8266,17,16,413552,3.001793313502512
hydrochlorothiazide,Osteomalacia,2,8267,8265,13,11,413557,7.851868397784914
hydrochlorothiazide,Osteoporosis,9,8267,8258,132,123,413445,3.481772496091944
hydrochlorothiazide,Overactive Bladder,3,8267,8264,13,10,413558,11.779227790602429
hydrochlorothiazide,Pain in penis,7,8267,8260,87,80,413488,4.1082018312877455
hydrochlorothiazide,Pain of lymph node,1,8267,8266,7,6,413562,7.290242300646365
hydrochlorothiazide,Pancreatic carcinoma recurrent,1,8267,8266,7,6,413562,7.290242300646365
hydrochlorothiazide,Pancreatic duct dilatation,1,8267,8266,5,4,413564,10.206387611904187
hydrochlorothiazide,Pancreatic enlargement,1,8267,8266,13,12,413556,3.925459249195035
hydrochlorothiazide,Panic Disorder,1,8267,8266,15,14,413554,3.402048552302605
hydrochlorothiazide,Paranasal sinus discomfort,1,8267,8266,7,6,413562,7.290242300646365
hydrochlorothiazide,Paranasal sinus hypersecretion,1,8267,8266,17,16,413552,3.001793313502512
hydrochlorothiazide,Paronychia (disorder),1,8267,8266,12,11,413557,4.252590934752803
hydrochlorothiazide,Pathological fracture,1,8267,8266,13,12,413556,3.925459249195035
hydrochlorothiazide,Patient Non-Compliance,1,8267,8266,7,6,413562,7.290242300646365
hydrochlorothiazide,Patient-device incompatibility,1,8267,8266,10,9,413559,5.1031333172030005
hydrochlorothiazide,Penile swelling,1,8267,8266,6,5,413563,8.50530284700379
hydrochlorothiazide,Peptostreptococcus infection,1,8267,8266,6,5,413563,8.50530284700379
hydrochlorothiazide,Performance status decreased,2,8267,8265,25,23,413545,4.082855414398064
hydrochlorothiazide,Periodontal Diseases,1,8267,8266,6,5,413563,8.50530284700379
hydrochlorothiazide,Peripheral Ischemia,1,8267,8266,13,12,413556,3.925459249195035
hydrochlorothiazide,Peripheral Vascular Diseases,3,8267,8264,28,25,413543,5.46873271331766
hydrochlorothiazide,Permanent cardiac pacemaker insertion,1,8267,8266,7,6,413562,7.290242300646365
hydrochlorothiazide,Persistent Fetal Circulation Syndrome,1,8267,8266,12,11,413557,4.252590934752803
hydrochlorothiazide,Peyronie Disease,1,8267,8266,6,5,413563,8.50530284700379
hydrochlorothiazide,Pharyngeal Hemorrhage,1,8267,8266,5,4,413564,10.206387611904187
hydrochlorothiazide,Pharyngeal lesion,1,8267,8266,9,8,413560,5.670161572169799
hydrochlorothiazide,Placental Insufficiency,1,8267,8266,15,14,413554,3.402048552302605
hydrochlorothiazide,Pneumococcal sepsis,3,8267,8264,31,28,413540,4.939465384255067
hydrochlorothiazide,Pneumothorax,2,8267,8265,31,29,413539,3.2925784985266278
hydrochlorothiazide,Polycystic liver disease,1,8267,8266,11,10,413558,4.639201108593802
hydrochlorothiazide,Polyp of vocal cord,1,8267,8266,15,14,413554,3.402048552302605
hydrochlorothiazide,Polypharmacy,1,8267,8266,16,15,413553,3.1894129566900555
hydrochlorothiazide,Post-Traumatic Stress Disorder,2,8267,8265,5,3,413565,20.41524500907441
hydrochlorothiazide,Posterior reversible encephalopathy syndrome,1,8267,8266,5,4,413564,10.206387611904187
hydrochlorothiazide,Postmenopausal bleeding,2,8267,8265,6,4,413564,17.012663843516837
hydrochlorothiazide,Postoperative deep vein thrombosis,1,8267,8266,5,4,413564,10.206387611904187
hydrochlorothiazide,Potentiating drug interaction,5,8267,8262,11,6,413562,23.20723575625536
hydrochlorothiazide,Premature Cardiac Complex,1,8267,8266,14,13,413555,3.6450606615740897
hydrochlorothiazide,Prescribed overdose,16,8267,8251,253,237,413331,3.231282541869401
hydrochlorothiazide,Prescribed underdose,1,8267,8266,5,4,413564,10.206387611904187
hydrochlorothiazide,Primary sequestrum,1,8267,8266,17,16,413552,3.001793313502512
hydrochlorothiazide,Procedural complication,1,8267,8266,17,16,413552,3.001793313502512
hydrochlorothiazide,Prostatic cyst,1,8267,8266,6,5,413563,8.50530284700379
hydrochlorothiazide,Protein/Creatinine ratio in urine above normal,1,8267,8266,6,5,413563,8.50530284700379
hydrochlorothiazide,Proteinuria,1,8267,8266,6,5,413563,8.50530284700379
hydrochlorothiazide,Pruritus Ani,5,8267,8262,30,25,413543,8.508936496409262
hydrochlorothiazide,Pruritus allergic,1,8267,8266,6,5,413563,8.50530284700379
hydrochlorothiazide,Pseudodementia,1,8267,8266,7,6,413562,7.290242300646365
hydrochlorothiazide,Pseudolymphoma,1,8267,8266,13,12,413556,3.925459249195035
hydrochlorothiazide,Psychiatric symptom,1,8267,8266,7,6,413562,7.290242300646365
hydrochlorothiazide,Pulmonary Edema,2,8267,8265,15,13,413555,6.804920346844122
hydrochlorothiazide,Pulmonary Fibrosis,2,8267,8265,24,22,413546,4.2529844726759425
hydrochlorothiazide,Pulmonary Fistula,1,8267,8266,14,13,413555,3.6450606615740897
hydrochlorothiazide,Pulmonary Hypertension,9,8267,8258,44,35,413533,10.447497192804773
hydrochlorothiazide,Pulmonary function test decreased,2,8267,8265,22,20,413548,4.639641423307485
hydrochlorothiazide,Pyogenic granuloma,1,8267,8266,5,4,413564,10.206387611904187
hydrochlorothiazide,Pyuria,1,8267,8266,9,8,413560,5.670161572169799
hydrochlorothiazide,Radius Fractures,3,8267,8264,31,28,413540,4.939465384255067
hydrochlorothiazide,Rectal pain,1,8267,8266,13,12,413556,3.925459249195035
hydrochlorothiazide,Red blood cell morphology abnormal,3,8267,8264,32,29,413539,4.78509574661181
hydrochlorothiazide,Reduction of dislocation,1,8267,8266,15,14,413554,3.402048552302605
hydrochlorothiazide,Reflux laryngitis,1,8267,8266,16,15,413553,3.1894129566900555
hydrochlorothiazide,Renal cancer metastatic,5,8267,8262,29,24,413544,8.802368968021437
hydrochlorothiazide,Renal vascular disorder,1,8267,8266,13,12,413556,3.925459249195035
hydrochlorothiazide,Renin increased,1,8267,8266,5,4,413564,10.206387611904187
hydrochlorothiazide,Respiratory tract oedema,1,8267,8266,6,5,413563,8.50530284700379
hydrochlorothiazide,Retinal Diseases,1,8267,8266,13,12,413556,3.925459249195035
hydrochlorothiazide,Retinal Neovascularization,1,8267,8266,7,6,413562,7.290242300646365
hydrochlorothiazide,Retinal Perforations,1,8267,8266,14,13,413555,3.6450606615740897
hydrochlorothiazide,Ruptured cerebral aneurysm,1,8267,8266,17,16,413552,3.001793313502512
hydrochlorothiazide,Sarcopenia,1,8267,8266,16,15,413553,3.1894129566900555
hydrochlorothiazide,Sciatic Neuropathy,1,8267,8266,14,13,413555,3.6450606615740897
hydrochlorothiazide,Scleral Diseases,1,8267,8266,6,5,413563,8.50530284700379
hydrochlorothiazide,Seborrheic dermatitis,3,8267,8264,31,28,413540,4.939465384255067
hydrochlorothiazide,Senile cardiac amyloidosis,3,8267,8264,14,11,413557,10.937828446964456
hydrochlorothiazide,Senile dementia,2,8267,8265,30,28,413540,3.4023391812865498
hydrochlorothiazide,Senile purpura,1,8267,8266,6,5,413563,8.50530284700379
hydrochlorothiazide,Serotonin Syndrome,1,8267,8266,13,12,413556,3.925459249195035
hydrochlorothiazide,Short Bowel Syndrome,2,8267,8265,23,21,413547,4.437907362108419
hydrochlorothiazide,Short stature for age,1,8267,8266,14,13,413555,3.6450606615740897
hydrochlorothiazide,Shortened QT interval,1,8267,8266,6,5,413563,8.50530284700379
hydrochlorothiazide,Sialadenitis,5,8267,8262,70,65,413503,3.6463412525504024
hydrochlorothiazide,Sialolithiasis,1,8267,8266,6,5,413563,8.50530284700379
hydrochlorothiazide,Sinusitis,1,8267,8266,14,13,413555,3.6450606615740897
hydrochlorothiazide,Skin Neoplasms,10,8267,8257,135,125,413443,3.783097618631105
hydrochlorothiazide,Skin Wrinkling,6,8267,8261,81,75,413493,3.78175003474604
hydrochlorothiazide,Skin irritation,1,8267,8266,13,12,413556,3.925459249195035
hydrochlorothiazide,Skin neoplasm excision,2,8267,8265,10,8,413560,10.207501512401693
hydrochlorothiazide,"Skull Fracture, Basilar",1,8267,8266,5,4,413564,10.206387611904187
hydrochlorothiazide,"Sleep Disorders, Circadian Rhythm",1,8267,8266,13,12,413556,3.925459249195035
hydrochlorothiazide,Slow respiration,1,8267,8266,8,7,413561,6.3789468908782965
hydrochlorothiazide,Small bowel obstruction,1,8267,8266,13,12,413556,3.925459249195035
hydrochlorothiazide,Small cell carcinoma of lung,1,8267,8266,13,12,413556,3.925459249195035
hydrochlorothiazide,Small cell lung cancer extensive stage,1,8267,8266,8,7,413561,6.3789468908782965
hydrochlorothiazide,Sopor,1,8267,8266,6,5,413563,8.50530284700379
hydrochlorothiazide,Speech Disorders,1,8267,8266,15,14,413554,3.402048552302605
hydrochlorothiazide,Spermatozoa abnormal,1,8267,8266,6,5,413563,8.50530284700379
hydrochlorothiazide,Spinal Cord Neoplasms,1,8267,8266,8,7,413561,6.3789468908782965
hydrochlorothiazide,Spinal stenosis in cervical region,2,8267,8265,11,9,413559,9.279524830885993
hydrochlorothiazide,Splenic abscess,1,8267,8266,6,5,413563,8.50530284700379
hydrochlorothiazide,Squamous cell carcinoma,6,8267,8261,91,85,413483,3.3660932941891666
hydrochlorothiazide,Staphylococcal Scalded Skin Syndrome,1,8267,8266,14,13,413555,3.6450606615740897
hydrochlorothiazide,Stem cell transplant,1,8267,8266,6,5,413563,8.50530284700379
hydrochlorothiazide,Stenosis of intestine,1,8267,8266,6,5,413563,8.50530284700379
hydrochlorothiazide,Streptococcal pneumonia,2,8267,8265,23,21,413547,4.437907362108419
hydrochlorothiazide,Stupor,1,8267,8266,7,6,413562,7.290242300646365
hydrochlorothiazide,Surgical Wound Infection,1,8267,8266,12,11,413557,4.252590934752803
hydrochlorothiazide,Swallowing painful,5,8267,8262,44,39,413529,5.8013550538060334
hydrochlorothiazide,Swelling,14,8267,8253,185,171,413397,3.8663090571487517
hydrochlorothiazide,"Tachycardia, Ventricular",2,8267,8265,33,31,413537,3.093013620781316
hydrochlorothiazide,Tardive Dyskinesia,1,8267,8266,7,6,413562,7.290242300646365
hydrochlorothiazide,Testicular Hydrocele,1,8267,8266,10,9,413559,5.1031333172030005
hydrochlorothiazide,Therapy change,5,8267,8262,28,23,413545,9.116760901891622
hydrochlorothiazide,Thrombocytosis,1,8267,8266,5,4,413564,10.206387611904187
hydrochlorothiazide,Tongue blistering,2,8267,8265,20,18,413550,5.103629764065336
hydrochlorothiazide,Tooth Infection,5,8267,8262,76,71,413497,3.358424428900865
hydrochlorothiazide,Traumatic amputation of limb,7,8267,8260,24,17,413551,14.894456214689267
hydrochlorothiazide,Traumatic hemorrhage,1,8267,8266,5,4,413564,10.206387611904187
hydrochlorothiazide,Tubular breast cancer stage I,1,8267,8266,8,7,413561,6.3789468908782965
hydrochlorothiazide,Tumor necrosis,1,8267,8266,6,5,413563,8.50530284700379
hydrochlorothiazide,Ulcer of esophagus,1,8267,8266,11,10,413558,4.639201108593802
hydrochlorothiazide,Underweight,2,8267,8265,10,8,413560,10.207501512401693
hydrochlorothiazide,Unilateral deafness,3,8267,8264,23,20,413548,6.657666568458269
hydrochlorothiazide,Upper abdominal pain,2,8267,8265,16,14,413554,6.379597701149426
hydrochlorothiazide,Urgency of micturition,2,8267,8265,29,27,413541,3.519669566305776
hydrochlorothiazide,Uterine Diseases,1,8267,8266,8,7,413561,6.3789468908782965
hydrochlorothiazide,VIIth nerve paralysis,6,8267,8261,88,82,413486,3.4808712350474846
hydrochlorothiazide,Vaginal Hemorrhage,7,8267,8260,51,44,413524,7.008707211698239
hydrochlorothiazide,Vasculitis,10,8267,8257,127,117,413451,4.021479269796374
hydrochlorothiazide,Ventricular arrhythmia,1,8267,8266,16,15,413553,3.1894129566900555
hydrochlorothiazide,Virus Diseases,2,8267,8265,20,18,413550,5.103629764065336
hydrochlorothiazide,Vitamin B12 absorption decreased,3,8267,8264,24,21,413547,6.38024866892546
hydrochlorothiazide,Vulval intraepithelial neoplasia,1,8267,8266,9,8,413560,5.670161572169799
hydrochlorothiazide,Vulvovaginal discomfort,1,8267,8266,17,16,413552,3.001793313502512
hydrochlorothiazide,Winged scapula,1,8267,8266,5,4,413564,10.206387611904187
hydrochlorothiazide,Wrong technique in drug usage process,5,8267,8262,48,43,413525,5.3178583676268865
hydrochlorothiazide,muscle injury,9,8267,8258,106,97,413471,4.336059487198233
hydrochlorothiazide,tissue injury of lip (physical finding),5,8267,8262,82,77,413491,3.112641774565894
indapamide,Abdomen distended,2,806,804,83,81,420948,12.640172630821795
indapamide,Abnormal blood test,1,806,805,99,98,420931,5.291875274483971
indapamide,Acute Coronary Syndrome,1,806,805,11,10,421019,47.63681535855449
indapamide,Adenomatous Polyposis Coli,1,806,805,33,32,420997,15.878110295501601
indapamide,Allergy to chemicals,1,806,805,20,19,421010,26.19968944099379
indapamide,Ankle deformity,1,806,805,67,66,420963,7.819931398906091
indapamide,Apnea,1,806,805,14,13,421016,37.42866015971606
indapamide,Apparent death,1,806,805,53,52,420977,9.88590179303879
indapamide,Application site edema,1,806,805,11,10,421019,47.63681535855449
indapamide,Application site irritation,1,806,805,87,86,420943,6.021960448347254
indapamide,Application site itching,1,806,805,9,8,421021,58.223050379572115
indapamide,Arterial Dissection,1,806,805,59,58,420971,8.880429518896726
indapamide,Ascites,2,806,804,101,99,420930,10.387025269691149
indapamide,Aseptic Meningitis,1,806,805,94,93,420936,5.573424078234439
indapamide,Autonomic nervous system imbalance,3,806,803,35,32,420997,45.024017078811596
indapamide,Axillary vein thrombosis,1,806,805,70,69,420960,7.484738243123336
indapamide,Axonal neuropathy,3,806,803,111,108,420921,14.194204166806907
indapamide,Biliuria,6,806,800,29,23,421006,109.08775862068966
indapamide,Blindness,1,806,805,141,140,420889,3.7152019734813444
indapamide,Blood albumin abnormal,2,806,804,15,13,421016,69.9535655058043
indapamide,Blood creatine phosphokinase MB increased,1,806,805,61,60,420969,8.589227166276347
indapamide,Blunted affect,1,806,805,102,101,420928,5.136195347704299
indapamide,Body weight problem,2,806,804,112,110,420919,9.366626687988628
indapamide,Bone pain,1,806,805,154,153,420876,3.401476163587965
indapamide,Calculus of pancreas,6,806,800,12,6,421023,263.63937500000003
indapamide,Cardiovascular stress testing,1,806,805,76,75,420954,6.893739784243216
indapamide,Cataract due to diabetes mellitus,4,806,802,8,4,421025,262.9844139650873
indapamide,Cerebellar Neoplasms,1,806,805,16,15,421014,32.74992236024845
indapamide,Chest Pain,11,806,795,1357,1346,419683,4.287350472509188
indapamide,Cholelithiasis,2,806,804,153,151,420878,6.8559490131044125
indapamide,Cholestasis,4,806,802,72,68,420961,29.216057079523413
indapamide,Chronic sinusitis,1,806,805,75,74,420955,6.985672877846791
indapamide,Cicatrix,4,806,802,479,475,420554,4.387319800707
indapamide,Coagulation test abnormal,6,806,800,391,385,420644,8.0839641943734
indapamide,Cognitive function: distractibility,1,806,805,46,45,420984,11.390467188765864
indapamide,Congenital inguinal hernia,2,806,804,19,17,421012,55.22597538622676
indapamide,Congestion of nasal sinus (disorder),1,806,805,6,5,421024,87.3351966873706
indapamide,Coronary Arteriosclerosis,1,806,805,88,87,420942,5.953514963297573
indapamide,Cortical cataract,1,806,805,108,107,420922,4.850782148608235
indapamide,Creation of ileostomy,2,806,804,174,172,420857,6.028206667810373
indapamide,Crushing injury,2,806,804,253,251,420778,4.145104516940987
indapamide,Cutaneous plaque,1,806,805,13,12,421017,40.3078834209269
indapamide,Decreased HDL cholesterol concentration,7,806,799,693,686,420343,5.32410462573166
indapamide,Decreased body weight,4,806,802,16,12,421017,131.4897132169576
indapamide,Dengue Fever,1,806,805,66,65,420964,7.938434029738378
indapamide,Device damage,1,806,805,17,16,421013,30.82338326635002
indapamide,Diaphragmalgia,1,806,805,37,36,420993,14.16142353533658
indapamide,Dilatation of aorta,2,806,804,308,306,420723,3.4044630742391937
indapamide,Disorder of mineral metabolism,1,806,805,70,69,420960,7.484738243123336
indapamide,Disorder of palate,2,806,804,15,13,421016,69.9535655058043
indapamide,Dizziness,1,806,805,25,24,421005,20.959503105590063
indapamide,Drug effect delayed,1,806,805,66,65,420964,7.938434029738378
indapamide,Dyskinetic syndrome,2,806,804,218,216,420813,4.811002327810489
indapamide,Dysplastic Nevus,1,806,805,33,32,420997,15.878110295501601
indapamide,Edema of mouth,3,806,803,15,12,421017,105.06102117061022
indapamide,Electric Countershock,1,806,805,124,123,420906,4.224714486074935
indapamide,Emotional disorder,1,806,805,91,90,420939,5.757204286396833
indapamide,Eructation,10,806,796,478,468,420561,11.074120603015075
indapamide,Erythema Nodosum,3,806,803,6,3,421026,262.65815691158156
indapamide,Falls,1,806,805,72,71,420958,7.276794340924775
indapamide,Fecal Incontinence,1,806,805,102,101,420928,5.136195347704299
indapamide,Feeling despair,1,806,805,143,142,420887,3.6632237327889503
indapamide,Fibrosis of urinary bladder,2,806,804,43,41,420988,24.40078676385514
indapamide,Fracture of lower leg,1,806,805,126,125,420904,4.157635807946367
indapamide,Furred tongue,1,806,805,49,48,420981,10.693015591329699
indapamide,Gait abnormality,1,806,805,119,118,420911,4.4022756928858495
indapamide,Gastroenteritis,2,806,804,245,243,420786,4.280536095035029
indapamide,Gingivitis,5,806,801,170,165,420864,15.48303591099361
indapamide,Granulocytopenic disorder,1,806,805,5,4,421025,104.8024844720497
indapamide,Growth of eyelashes,1,806,805,131,130,420899,3.9989000047413588
indapamide,Haematotoxicity,1,806,805,27,26,421003,19.406855302507473
indapamide,Hair color change (finding),1,806,805,166,165,420864,3.1554965202424605
indapamide,Hepatitis C,1,806,805,12,11,421018,43.66697722567287
indapamide,Hyperhidrosis (disorder),1,806,805,168,167,420862,3.117916296953564
indapamide,Hyperlipidemia,3,806,803,159,156,420873,9.908033553419958
indapamide,Hypersomnia,1,806,805,42,41,420988,12.47539189588879
indapamide,Hypokinesia,5,806,801,282,277,420752,9.331265882186274
indapamide,Hypoparathyroidism,6,806,800,262,256,420773,12.067929389312976
indapamide,Hypotension,34,806,772,2116,2082,418947,8.735838222474706
indapamide,"Hypotension, Orthostatic",2,806,804,38,36,420993,27.611743912018852
indapamide,Hypothermia due to exposure,1,806,805,43,42,420987,12.185237613751264
indapamide,Impaired pupillary reflex,1,806,805,109,108,420921,4.806268163428116
indapamide,Increased frequency of micturition,3,806,803,231,228,420801,6.818650838576119
indapamide,Infected dermal cyst,1,806,805,167,166,420863,3.1365938929594233
indapamide,Infusion Site Extravasation,1,806,805,72,71,420958,7.276794340924775
indapamide,Initial insomnia,1,806,805,95,94,420935,5.514743380189604
indapamide,Injection site discolouration,1,806,805,35,34,420995,14.970718722271517
indapamide,Injection site papule,1,806,805,122,121,420908,4.293992465125751
indapamide,Injury of liver,1,806,805,105,104,420925,4.98941141674061
indapamide,Intentional self-injury,1,806,805,136,135,420894,3.851835951772013
indapamide,Intestinal Perforation,1,806,805,77,76,420953,6.804194563200775
indapamide,"Intubation, Intratracheal",3,806,803,6,3,421026,262.65815691158156
indapamide,Itching of eye,1,806,805,73,72,420957,7.177095209733684
indapamide,Ketoacidosis,1,806,805,172,171,420858,3.0453777264191824
indapamide,Kidney Diseases,6,806,800,21,15,421014,150.64785714285713
indapamide,"Kidney Failure, Acute",1,806,805,173,172,420857,3.027767206405055
indapamide,Lacrimation decreased,1,806,805,12,11,421018,43.66697722567287
indapamide,Laryngeal Edema,7,806,799,1208,1201,419828,3.0505733574252583
indapamide,Left Bundle-Branch Block,1,806,805,109,108,420921,4.806268163428116
indapamide,Leukocyte Disorders,2,806,804,61,59,420970,17.199820569284725
indapamide,"Leukoencephalopathy, Progressive Multifocal",5,806,801,219,214,420815,12.017398343394957
indapamide,Limb injury,1,806,805,80,79,420950,6.548990683229814
indapamide,Lipids outside reference range,2,806,804,202,200,420829,5.192268853751046
indapamide,Liver cyst,1,806,805,21,20,421009,24.95202602780242
indapamide,Liver function tests abnormal,1,806,805,49,48,420981,10.693015591329699
indapamide,Low birth weight baby,1,806,805,118,117,420912,4.43959364143594
indapamide,Low density lipoprotein abnormal,2,806,804,249,247,420782,4.211732502147895
indapamide,Lower abdominal pain,1,806,805,22,21,421008,23.81778656126482
indapamide,Lymph Node Tuberculosis,1,806,805,104,103,420926,5.037398471094123
indapamide,Lymphedema,7,806,799,549,542,420487,6.72288903935019
indapamide,Lysis of adhesions of tendon,2,806,804,257,255,420774,4.080550554619897
indapamide,Macular Holes,5,806,801,267,262,420767,9.855844987772775
indapamide,Madarosis of eyelid,8,806,798,88,80,420949,48.045910230120754
indapamide,Malignant neoplasm of breast,1,806,805,24,23,421006,21.832867494824015
indapamide,Malignant neoplasm of prostate,7,806,799,368,361,420668,10.033836453175166
indapamide,Malignant neoplasm progression,3,806,803,160,157,420872,9.84608499377335
indapamide,Mechanical ventilation,3,806,803,14,11,421018,112.56564668208503
indapamide,Meningioma,1,806,805,123,122,420907,4.259071857799324
indapamide,Metastatic malignant neoplasm to pancreas,1,806,805,99,98,420931,5.291875274483971
indapamide,Miliaria,1,806,805,27,26,421003,19.406855302507473
indapamide,Morbilliform rash,4,806,802,385,381,420648,5.459727305113839
indapamide,Mouth Diseases,1,806,805,116,115,420914,4.51615977725423
indapamide,"Multiple Sclerosis, Primary Progressive",1,806,805,19,18,421011,27.5786858450474
indapamide,Muscle Hypertonia,1,806,805,20,19,421010,26.19968944099379
indapamide,Neonatal Abstinence Syndrome,1,806,805,24,23,421006,21.832867494824015
indapamide,Nervousness,3,806,803,246,243,420786,6.4026516417094435
indapamide,Neutrophil count decreased,4,806,802,567,563,420466,3.7056213082813247
indapamide,Occult blood positive,3,806,803,161,158,420871,9.784905981451544
indapamide,Ocular Motility Disorders,1,806,805,13,12,421017,40.3078834209269
indapamide,"Osteoarthritis, Spine",7,806,799,1133,1126,419903,3.2530888677042245
indapamide,Palatal edema,4,806,802,68,64,420965,30.93494205662315
indapamide,Pancreatic Infection,1,806,805,143,142,420887,3.6632237327889503
indapamide,Pancytopenia,5,806,801,233,228,420801,11.294947838806642
indapamide,Panic Disorder,1,806,805,15,14,421015,34.93333333333334
indapamide,Personality Change,1,806,805,56,55,420974,9.35623336291038
indapamide,"Pleural Effusion, Malignant",1,806,805,170,169,420860,3.0812203142126418
indapamide,Portal Hypertension,4,806,802,274,270,420759,7.67353514025156
indapamide,Potentiating drug interaction,1,806,805,11,10,421019,47.63681535855449
indapamide,Pseudoaneurysm,3,806,803,6,3,421026,262.65815691158156
indapamide,Pulmonary function challenge test abnormal,6,806,800,57,51,420978,55.49710526315789
indapamide,Pustular rash,1,806,805,13,12,421017,40.3078834209269
indapamide,Raised jugular venous pressure,1,806,805,51,50,420979,10.273632931433443
indapamide,Removal of ovarian cyst,6,806,800,241,235,420794,13.120145228215767
indapamide,Renal Insufficiency,18,806,788,907,889,420140,10.600999557866341
indapamide,Renal mass,6,806,800,29,23,421006,109.08775862068966
indapamide,Repair of inguinal hernia,1,806,805,132,131,420898,3.9685958968567667
indapamide,Respiratory distress,2,806,804,99,97,420932,10.596914417809941
indapamide,Retinal Perforations,1,806,805,14,13,421016,37.42866015971606
indapamide,Rheumatoid lung disease,1,806,805,85,84,420945,6.163682864450128
indapamide,Salt craving,1,806,805,130,129,420900,4.02967032967033
indapamide,Senile cardiac amyloidosis,1,806,805,14,13,421016,37.42866015971606
indapamide,Septic thrombophlebitis,1,806,805,128,127,420902,4.092653338509317
indapamide,Skin odour abnormal,3,806,803,57,54,420975,27.644884315396208
indapamide,Spinal column stenosis,6,806,800,381,375,420654,8.296338582677166
indapamide,Stage II Rectal Cancer,1,806,805,7,6,421023,74.85856255545696
indapamide,Standard chest X-ray abnormal,2,806,804,137,135,420894,7.656934306569343
indapamide,Starvation,2,806,804,208,206,420823,5.042420110983544
indapamide,Stress,1,806,805,151,150,420879,3.469079840401464
indapamide,Stricture of artery,1,806,805,97,96,420933,5.401011717999616
indapamide,Sudden death,1,806,805,60,59,420970,8.7324016563147
indapamide,Swelling at injection site,1,806,805,40,39,420990,13.099223602484471
indapamide,Tension Headache,4,806,802,447,443,420586,4.701757909476867
indapamide,Thoracic Injuries,4,806,802,303,299,420730,6.938627029785272
indapamide,Thoracic vertebral fracture,4,806,802,550,546,420483,3.8203128542280664
indapamide,Tinnitus,4,806,802,184,180,420849,11.429334273013119
indapamide,Tongue Diseases,5,806,801,428,423,420606,6.146041163498897
indapamide,Toxic nodular goiter,1,806,805,28,27,421002,18.713708961845608
indapamide,Tracheostomy malfunction,1,806,805,24,23,421006,21.832867494824015
indapamide,Trigger Finger Disorder,1,806,805,88,87,420942,5.953514963297573
indapamide,Ultrafiltration failure,2,806,804,182,180,420849,5.763121207151058
indapamide,Upper Respiratory Infections,5,806,801,418,413,420616,6.293224975957087
indapamide,Urinary bladder stone (disorder),2,806,804,198,196,420833,5.297213427810443
indapamide,Vaginal odor,1,806,805,53,52,420977,9.88590179303879
indapamide,Violence-related symptom,2,806,804,296,294,420735,3.5425826946349335
indapamide,Wound healing normal,2,806,804,36,34,420995,29.145867882808183
indapamide,Wound of skin,1,806,805,156,155,420874,3.357851568721134
indapamide,anaphylaxis,2,806,804,168,166,420863,6.2435886045960665
indapamide,hypertensive nephropathy,1,806,805,61,60,420969,8.589227166276347
indapamide,muscle injury,1,806,805,106,105,420924,4.942329778506973
irbesartan,"Abdomen, Acute",2,1015,1013,23,21,420799,36.208592643461095
irbesartan,Abnormal behavior,1,1015,1014,59,58,420762,7.050045130879551
irbesartan,Abscess,3,1015,1012,158,155,420665,7.9115862810827045
irbesartan,Absence Epilepsy,1,1015,1014,6,5,420815,69.33415516107824
irbesartan,Acarodermatitis,1,1015,1014,19,18,420802,21.894321602823627
irbesartan,Acidosis,2,1015,1013,157,155,420665,5.302758408209204
irbesartan,Acne Keloid,2,1015,1013,8,6,420814,104.10340572556763
irbesartan,Acute graft versus host disease in liver,2,1015,1013,7,5,420815,118.9756028768862
irbesartan,Adrenal insufficiency neonatal,1,1015,1014,11,10,420810,37.81818181818182
irbesartan,Agranulocytosis,1,1015,1014,8,7,420813,52.00036982248521
irbesartan,Alcohol poisoning,2,1015,1013,94,92,420728,8.858058011803996
irbesartan,Altered bowel function,7,1015,1008,104,97,420723,28.160456730769226
irbesartan,Amnesia,9,1015,1006,212,203,420617,17.792335608987585
irbesartan,Amylase increased,3,1015,1012,413,410,420410,3.0248782168457926
irbesartan,Ankle Fracture,1,1015,1014,73,72,420748,5.697792548161357
irbesartan,Anti-glomerular basement membrane antibody positive,3,1015,1012,329,326,420494,3.7979444237538598
irbesartan,Apparent life threatening event in infant,1,1015,1014,91,90,420730,4.570561588313068
irbesartan,Arterial Dissection,1,1015,1014,59,58,420762,7.050045130879551
irbesartan,Atrophic condition of skin,8,1015,1007,378,370,420450,8.85772082197107
irbesartan,Avulsion fracture,1,1015,1014,107,106,420714,3.886965658353149
irbesartan,Axonal neuropathy,1,1015,1014,111,110,420710,3.7468592853208236
irbesartan,Bacterial peritonitis,1,1015,1014,12,11,420809,34.66658448389217
irbesartan,Basal Ganglia Hemorrhage,1,1015,1014,42,41,420779,9.904034000187846
irbesartan,Beta globulin above reference range,1,1015,1014,52,51,420769,7.999222424518283
irbesartan,Bladder pain,2,1015,1013,112,110,420710,7.434124241996897
irbesartan,Blepharoptosis,8,1015,1007,199,191,420629,16.832364403946247
irbesartan,Blood blister,1,1015,1014,6,5,420815,69.33415516107824
irbesartan,Blood cholesterol abnormal,1,1015,1014,37,36,420784,11.242550242550243
irbesartan,Blood growth hormone abnormal,1,1015,1014,14,13,420807,29.714074387151307
irbesartan,Blood potassium decreased,5,1015,1010,143,138,420682,14.5984906182926
irbesartan,Blood pressure difference of extremities,1,1015,1014,11,10,420810,37.81818181818182
irbesartan,Blunted affect,2,1015,1013,102,100,420720,8.163153514120356
irbesartan,Bone marrow harvest failure,1,1015,1014,61,60,420760,6.818863775988619
irbesartan,Breast Diseases,1,1015,1014,97,96,420724,4.287785436873462
irbesartan,Bronchial Obstruction,1,1015,1014,137,136,420684,3.0355893404742367
irbesartan,"Bronchitis, Chronic",1,1015,1014,56,55,420765,7.427778951817413
irbesartan,Calciphylaxis,1,1015,1014,5,4,420816,83.20118343195267
irbesartan,Carbohydrate antigen 19-9 increased,10,1015,1005,90,80,420740,46.62741846323936
irbesartan,Cardiac Flutter,1,1015,1014,54,53,420767,7.702918401636349
irbesartan,Carpal Tunnel Syndrome,2,1015,1013,55,53,420767,15.140626402225612
irbesartan,Cerebral Hemorrhage,1,1015,1014,63,62,420758,6.602360602360601
irbesartan,Chest Pain,15,1015,1000,1357,1342,419478,4.647877671333824
irbesartan,"Cholangitis, Sclerosing",1,1015,1014,8,7,420813,52.00036982248521
irbesartan,Cholestasis,1,1015,1014,72,71,420749,5.77694225290379
irbesartan,Closed Fracture Reduction,3,1015,1012,25,22,420798,50.01699604743083
irbesartan,Colon adenoma,5,1015,1010,84,79,420741,24.855669495520978
irbesartan,Complications of Diabetes Mellitus,1,1015,1014,15,14,420806,27.733070348454962
irbesartan,Congenital cystic kidney disease,1,1015,1014,55,54,420766,7.562847409001254
irbesartan,Corneal Diseases,2,1015,1013,251,249,420571,3.316125429181595
irbesartan,Coronary Stenosis,2,1015,1013,161,159,420661,5.17096380592668
irbesartan,Cortical cataract,1,1015,1014,108,107,420713,3.850966104171232
irbesartan,Cystatin C increased,1,1015,1014,29,28,420792,14.34421546623138
irbesartan,Death of relative,1,1015,1014,17,16,420804,24.470240167072745
irbesartan,Difficulty weight-bearing,1,1015,1014,61,60,420760,6.818863775988619
irbesartan,Diffuse alopecia,1,1015,1014,8,7,420813,52.00036982248521
irbesartan,Dilatation of aorta,3,1015,1012,308,305,420515,4.057097299933268
irbesartan,Disease of capillaries,2,1015,1013,42,40,420780,19.827621868095708
irbesartan,Dyskinetic syndrome,2,1015,1013,218,216,420604,3.818406585942382
irbesartan,Dysplasia,2,1015,1013,200,198,420622,4.162240868706811
irbesartan,Eating Disorders,1,1015,1014,54,53,420767,7.702918401636349
irbesartan,Ecchymosis,1,1015,1014,56,55,420765,7.427778951817413
irbesartan,Eczema,2,1015,1013,64,62,420758,13.011198173741363
irbesartan,Edema of scrotum,3,1015,1012,268,265,420555,4.663076662143826
irbesartan,Enteric campylobacteriosis,1,1015,1014,109,108,420712,3.815627092267883
irbesartan,Epstein-Barr virus test positive,3,1015,1012,25,22,420798,50.01699604743083
irbesartan,Eructation,6,1015,1009,478,472,420348,5.241823587710605
irbesartan,Escherichia test positive,1,1015,1014,16,15,420805,25.99969181459566
irbesartan,Esophageal carcinoma,1,1015,1014,79,78,420742,5.264973909569821
irbesartan,Estimated glomerular filtration rate decreased,1,1015,1014,24,23,420797,17.332799145299145
irbesartan,Euphoric mood,1,1015,1014,131,130,420690,3.1746691359139976
irbesartan,Excoriation,13,1015,1002,1205,1192,419628,4.528859293860411
irbesartan,Facial Injuries,5,1015,1010,420,415,420405,4.967173503064592
irbesartan,Falls,2,1015,1013,72,70,420750,11.565290117363167
irbesartan,Febrile infection,1,1015,1014,16,15,420805,25.99969181459566
irbesartan,Feeding tube complication,1,1015,1014,7,6,420814,59.4291349675965
irbesartan,Femoral Neck Fractures,1,1015,1014,137,136,420684,3.0355893404742367
irbesartan,Fibrin D dimer increased,1,1015,1014,31,30,420790,13.418718584971685
irbesartan,Fibromuscular dysplasia of wall of renal artery,1,1015,1014,89,88,420732,4.673292999135696
irbesartan,Fluid imbalance,1,1015,1014,41,40,420780,10.14561985856545
irbesartan,Folliculitis,1,1015,1014,11,10,420810,37.81818181818182
irbesartan,Gastric infection,1,1015,1014,42,41,420779,9.904034000187846
irbesartan,Gastrointestinal inflammation,1,1015,1014,89,88,420732,4.673292999135696
irbesartan,Growth of eyelashes,2,1015,1013,131,129,420691,6.3556061279699785
irbesartan,Haemorrhagic arteriovenous malformation,1,1015,1014,57,56,420764,7.297449738745285
irbesartan,Hay fever,1,1015,1014,22,21,420799,18.908597812443965
irbesartan,"Hearing Loss, Sudden",1,1015,1014,13,12,420808,31.999848277954786
irbesartan,Hemorrhage,9,1015,1006,304,295,420525,12.405105550905095
irbesartan,Hemorrhagic Stroke,1,1015,1014,68,67,420753,6.116820396797772
irbesartan,Hemorrhagic duodenitis,1,1015,1014,43,42,420778,9.67368469336269
irbesartan,Hepatomegaly,4,1015,1011,67,63,420757,24.906210785833444
irbesartan,Hot flushes,2,1015,1013,243,241,420579,3.4253632814562947
irbesartan,Hypercholesterolemia,8,1015,1007,383,375,420445,8.741981067255063
irbesartan,Hypernatremia,1,1015,1014,29,28,420792,14.34421546623138
irbesartan,Hyperpigmentation,1,1015,1014,63,62,420758,6.602360602360601
irbesartan,Hyperthyroidism,1,1015,1014,78,77,420743,5.332486218580893
irbesartan,Hypoglycemic shock,1,1015,1014,11,10,420810,37.81818181818182
irbesartan,Idiopathic erosive/hemorrhagic gastritis,2,1015,1013,98,96,420724,8.496424038519653
irbesartan,Immunologic Deficiency Syndromes,1,1015,1014,9,8,420812,46.22244137628753
irbesartan,Increased bilirubin level (finding),5,1015,1010,173,168,420652,12.066101985921135
irbesartan,Increased frequency of micturition,2,1015,1013,231,229,420591,3.603406793929992
irbesartan,"Infarction, Lacunar",1,1015,1014,18,17,420803,23.11072759149682
irbesartan,Inflammatory disease of mucous membrane,2,1015,1013,140,138,420682,5.9469045268650405
irbesartan,Inflammatory polyposis of intestine,1,1015,1014,5,4,420816,83.20118343195267
irbesartan,Initial insomnia,1,1015,1014,95,94,420726,4.378075365929616
irbesartan,Injection site induration,3,1015,1012,394,391,420429,3.1708909331674726
irbesartan,Injection site itching,2,1015,1013,82,80,420740,10.154648111140538
irbesartan,Injection site nodule,1,1015,1014,70,69,420751,5.942025922795152
irbesartan,Injection site warmth,1,1015,1014,37,36,420784,11.242550242550243
irbesartan,Intraabdominal hemorrhage,1,1015,1014,94,93,420727,4.424661127197951
irbesartan,Iron deficiency anemia,3,1015,1012,64,61,420759,19.536082633399207
irbesartan,Jaw pain,1,1015,1014,80,79,420741,5.199149408284024
irbesartan,Kidney Neoplasm,1,1015,1014,19,18,420802,21.894321602823627
irbesartan,Kidney Transplantation,1,1015,1014,9,8,420812,46.22244137628753
irbesartan,Larynx pain,1,1015,1014,26,25,420795,15.999431042330452
irbesartan,Latent Tuberculosis,1,1015,1014,8,7,420813,52.00036982248521
irbesartan,Lethargy,1,1015,1014,114,113,420707,3.6482317727256994
irbesartan,Liver damage,1,1015,1014,128,127,420693,3.249098557692308
irbesartan,Liver mass,2,1015,1013,67,65,420755,12.428518807738207
irbesartan,Lower abdominal pain,1,1015,1014,22,21,420799,18.908597812443965
irbesartan,Lymph Node Tuberculosis,1,1015,1014,104,103,420717,3.999118115612198
irbesartan,Lymphadenitis,10,1015,1005,28,18,420802,149.8958777540867
irbesartan,"Lymphoma, Non-Hodgkin",1,1015,1014,31,30,420790,13.418718584971685
irbesartan,Macular fibrosis,1,1015,1014,9,8,420812,46.22244137628753
irbesartan,Malnutrition,1,1015,1014,104,103,420717,3.999118115612198
irbesartan,Manic,1,1015,1014,21,20,420800,19.809054193669574
irbesartan,Melanosis,1,1015,1014,105,104,420716,3.961021884098807
irbesartan,Menorrhagia,1,1015,1014,26,25,420795,15.999431042330452
irbesartan,Mental disorder due to a general medical condition,8,1015,1007,338,330,420490,9.906911971230969
irbesartan,Metabolic alkalosis,2,1015,1013,113,111,420709,7.3683180599114175
irbesartan,Miliaria,1,1015,1014,27,26,420794,15.406822996566586
irbesartan,Milk Allergy,1,1015,1014,7,6,420814,59.4291349675965
irbesartan,Muscular Atrophy,2,1015,1013,95,93,420727,8.764794513430664
irbesartan,Musculoskeletal stiffness,7,1015,1008,654,647,420173,4.472275314305131
irbesartan,Myeloproliferative disease,1,1015,1014,58,57,420763,7.171614636468748
irbesartan,Necrosis,1,1015,1014,52,51,420769,7.999222424518283
irbesartan,Neonatal cyanosis,1,1015,1014,36,35,420785,11.554870699101468
irbesartan,Neonatal hypoglycemia,1,1015,1014,25,24,420796,16.639447731755425
irbesartan,Nervousness,2,1015,1013,246,244,420576,3.383566481271921
irbesartan,Occult blood positive,4,1015,1011,161,157,420663,10.362386420185413
irbesartan,Pancreatic carcinoma,1,1015,1014,22,21,420799,18.908597812443965
irbesartan,Parkinsonian Disorders,1,1015,1014,79,78,420742,5.264973909569821
irbesartan,Peptic Ulcer,2,1015,1013,105,103,420717,7.929864147040851
irbesartan,Peripheral artery thrombosis,2,1015,1013,274,272,420548,3.0375988067530857
irbesartan,Personality Change,1,1015,1014,56,55,420765,7.427778951817413
irbesartan,Pharyngitis,1,1015,1014,108,107,420713,3.850966104171232
irbesartan,Pigmentation of eyelids,1,1015,1014,127,126,420694,3.27468977620401
irbesartan,Pneumonia,10,1015,1005,1348,1338,419482,3.103820659314702
irbesartan,Pneumonia and influenza,1,1015,1014,10,9,420811,41.60009861932939
irbesartan,Poisoning,8,1015,1007,331,323,420497,10.116591712993937
irbesartan,Polycystic Ovary Syndrome,1,1015,1014,31,30,420790,13.418718584971685
irbesartan,Polydipsia,2,1015,1013,152,150,420670,5.477256195770769
irbesartan,Prescribed overdose,3,1015,1012,253,250,420570,4.9397194144573415
irbesartan,Product deposit,1,1015,1014,87,86,420734,4.780747693214536
irbesartan,Protein total increased,1,1015,1014,102,101,420719,4.077551533433886
irbesartan,Pseudo-Bartter syndrome,1,1015,1014,42,41,420779,9.904034000187846
irbesartan,Pseudodementia,1,1015,1014,7,6,420814,59.4291349675965
irbesartan,Pulmonary arterial pressure increased,1,1015,1014,120,119,420701,3.46577087442472
irbesartan,Pure Red-Cell Aplasia,1,1015,1014,23,22,420798,18.086441986107538
irbesartan,Refusal of Treatment,1,1015,1014,10,9,420811,41.60009861932939
irbesartan,Renal Insufficiency,16,1015,999,907,891,419929,7.432844089955447
irbesartan,Renal cancer metastatic,1,1015,1014,29,28,420792,14.34421546623138
irbesartan,Renal vascular disorder,1,1015,1014,13,12,420808,31.999848277954786
irbesartan,Respiratory fume inhalation disorder,1,1015,1014,5,4,420816,83.20118343195267
irbesartan,Restless Legs Syndrome,2,1015,1013,173,171,420649,4.812147287573681
irbesartan,Retinal vascular thrombosis,1,1015,1014,8,7,420813,52.00036982248521
irbesartan,Rosacea,1,1015,1014,107,106,420714,3.886965658353149
irbesartan,Ruptured cerebral aneurysm,1,1015,1014,17,16,420804,24.470240167072745
irbesartan,Scleritis,1,1015,1014,19,18,420802,21.894321602823627
irbesartan,Seasonal rhinitis,1,1015,1014,136,135,420685,3.057917101751943
irbesartan,Second Primary Cancers,1,1015,1014,32,31,420789,12.999352810650889
irbesartan,Sensory neuropathy,1,1015,1014,35,34,420786,11.885038038884192
irbesartan,"Shock, Cardiogenic",2,1015,1013,96,94,420726,8.673474004606778
irbesartan,Short stature for age,1,1015,1014,14,13,420807,29.714074387151307
irbesartan,Skin Basal Cell Carcinoma,1,1015,1014,107,106,420714,3.886965658353149
irbesartan,Skin Erosion,1,1015,1014,16,15,420805,25.99969181459566
irbesartan,Skin Ulcer,1,1015,1014,107,106,420714,3.886965658353149
irbesartan,Skin tag,2,1015,1013,110,108,420712,7.569326034281611
irbesartan,Sleeplessness,1,1015,1014,120,119,420701,3.46577087442472
irbesartan,Spirometry abnormal,1,1015,1014,6,5,420815,69.33415516107824
irbesartan,Squamous cell carcinoma of skin,1,1015,1014,42,41,420779,9.904034000187846
irbesartan,Squamous cell carcinoma of tongue,3,1015,1012,407,404,420416,3.0695147177360615
irbesartan,Staphylococcal Scalded Skin Syndrome,1,1015,1014,14,13,420807,29.714074387151307
irbesartan,Status Asthmaticus,3,1015,1012,102,99,420721,12.256829807021624
irbesartan,Substance Abuse Problems,1,1015,1014,123,122,420698,3.38121582399256
irbesartan,Superficial Thrombophlebitis,1,1015,1014,42,41,420779,9.904034000187846
irbesartan,Tablet physical issue,1,1015,1014,13,12,420808,31.999848277954786
irbesartan,Thermal burn,2,1015,1013,174,172,420648,4.784479921934393
irbesartan,Thoracic vertebral fracture,5,1015,1010,550,545,420275,3.791944194419442
irbesartan,Throat irritation,6,1015,1009,132,126,420694,18.99734210289215
irbesartan,Thrombus of cardiac chamber,1,1015,1014,101,100,420720,4.117933095084656
irbesartan,Tinea Pedis,3,1015,1012,359,356,420464,3.4803197287150303
irbesartan,Tobacco Use Disorder,2,1015,1013,30,28,420792,27.759460348798946
irbesartan,Tonsillectomy,1,1015,1014,104,103,420717,3.999118115612198
irbesartan,Torsades de Pointes,1,1015,1014,44,43,420777,9.45380580957504
irbesartan,Ulna Fractures,1,1015,1014,42,41,420779,9.904034000187846
irbesartan,Umbilical hemorrhage,1,1015,1014,91,90,420730,4.570561588313068
irbesartan,Urinary Stress Incontinence,1,1015,1014,127,126,420694,3.27468977620401
irbesartan,Urinary tract infection,1,1015,1014,132,131,420689,3.1506111409957565
irbesartan,Urine sodium abnormal,1,1015,1014,8,7,420813,52.00036982248521
irbesartan,Vaccination site swelling,1,1015,1014,76,75,420745,5.472840755735492
irbesartan,Vascular wall hypertrophy,1,1015,1014,76,75,420745,5.472840755735492
irbesartan,Vasculitis,4,1015,1011,127,123,420697,13.137627826195315
irbesartan,Ventricular Dysfunction,1,1015,1014,121,120,420700,3.4371199895675417
irbesartan,Visual Impairment,4,1015,1011,486,482,420338,3.430161230578859
irbesartan,Warm skin,1,1015,1014,105,104,420716,3.961021884098807
irbesartan,Weight Gain,1,1015,1014,68,67,420753,6.116820396797772
irbesartan,Wound Complication,1,1015,1014,27,26,420794,15.406822996566586
irbesartan,Wound inflammation,1,1015,1014,13,12,420808,31.999848277954786
irbesartan,bite injury,10,1015,1005,1079,1069,419751,3.8800990414009653
irbesartan,upper airway cough syndrome,2,1015,1013,54,52,420768,15.421044934371684
labetalol,5-hydroxyindolacetic acid in urine increased,2,7260,7258,6,4,414571,19.373059612381738
labetalol,ADAMTS13 activity decreased,2,7260,7258,11,9,414566,10.566998171296877
labetalol,Abnormal behavior,4,7260,7256,59,55,414520,3.9408741801057685
labetalol,Abnormal heart beat,11,7260,7249,43,32,414543,14.884850195857009
labetalol,Abnormal histology findings,1,7260,7259,6,5,414570,9.68519538963126
labetalol,Abnormal mean corpuscular volume,1,7260,7259,14,13,414562,4.150719304115088
labetalol,Abnormal thyroxine,1,7260,7259,6,5,414570,9.68519538963126
labetalol,Accessory cardiac pathway,1,7260,7259,8,7,414568,7.263862102217937
labetalol,Acute lymphocytic leukemia,17,7260,7243,64,47,414528,15.467751190804915
labetalol,Adenocarcinoma,1,7260,7259,19,18,414557,3.058388497763212
labetalol,Adrenal Gland Neoplasms,2,7260,7258,13,11,414564,8.941263751404287
labetalol,Agoraphobia,1,7260,7259,15,14,414561,3.87399549983928
labetalol,Alanine Aminotransferase Increased,69,7260,7191,188,119,414456,21.5204311240114
labetalol,Alcohol abuse,1,7260,7259,17,16,414559,3.418215116326183
labetalol,Alopecia totalis,2,7260,7258,9,7,414568,12.915281222252839
labetalol,Ammonia increased,1,7260,7259,10,9,414566,5.81106212976994
labetalol,Androgenetic Alopecia,2,7260,7258,6,4,414571,19.373059612381738
labetalol,Anorexia Nervosa,23,7260,7237,64,41,414534,20.94430746510985
labetalol,Anti-neutrophil cytoplasmic antibody positive vasculitis,1,7260,7259,18,17,414558,3.228306623195726
labetalol,Antibody test positive,1,7260,7259,10,9,414566,5.81106212976994
labetalol,Anticonvulsant drug level decreased,1,7260,7259,9,8,414567,6.456751006413494
labetalol,Antipsychotic drug level below therapeutic,1,7260,7259,7,6,414569,8.301576368252219
labetalol,Anxiety Disorders,1,7260,7259,6,5,414570,9.68519538963126
labetalol,Aortic aneurysm repair,1,7260,7259,18,17,414558,3.228306623195726
labetalol,Aortic bypass,1,7260,7259,12,11,414564,4.84252881480461
labetalol,Appendicitis purulent perforated,1,7260,7259,11,10,414565,5.282771230697943
labetalol,Application of cast,1,7260,7259,9,8,414567,6.456751006413494
labetalol,Application site haemorrhage,2,7260,7258,24,22,414553,4.843058234591714
labetalol,Arterial thrombosis,3,7260,7257,35,32,414543,4.981987834406189
labetalol,"Arthritis, Psoriatic",2,7260,7258,7,5,414570,16.605440302326496
labetalol,Arthroscopy,4,7260,7256,23,19,414556,10.110061837879297
labetalol,Atrial Septal Defects,3,7260,7257,53,50,414525,3.2898515681671046
labetalol,Attention deficit hyperactivity disorder,1,7260,7259,17,16,414559,3.418215116326183
labetalol,Bacterial pyelonephritis,80,7260,7180,1344,1264,413311,3.4859646504841493
labetalol,Balanitis,8,7260,7252,83,75,414500,5.605459898058866
labetalol,Benign neoplasm of skin,1,7260,7259,6,5,414570,9.68519538963126
labetalol,Bile Duct Stenosis,2,7260,7258,23,21,414554,5.053637964704613
labetalol,Bipolar Disorder,1,7260,7259,17,16,414559,3.418215116326183
labetalol,Blast cells present,2,7260,7258,14,12,414563,8.302582372160767
labetalol,Blood calcitonin increased,1,7260,7259,15,14,414561,3.87399549983928
labetalol,Blood creatine phosphokinase abnormal,3,7260,7257,21,18,414557,8.303588653319947
labetalol,Blood growth hormone increased,1,7260,7259,11,10,414565,5.282771230697943
labetalol,Blood lactate dehydrogenase decreased,1,7260,7259,12,11,414564,4.84252881480461
labetalol,Blood magnesium outside reference range,1,7260,7259,18,17,414558,3.228306623195726
labetalol,Blood pH decreased,2,7260,7258,9,7,414568,12.915281222252839
labetalol,Blood parathyroid hormone increased,6,7260,7254,57,51,414524,6.120441716367012
labetalol,Blood testosterone free abnormal,2,7260,7258,26,24,414551,4.470494096699663
labetalol,Blood testosterone increased,1,7260,7259,17,16,414559,3.418215116326183
labetalol,Blood urate above reference range,1,7260,7259,9,8,414567,6.456751006413494
labetalol,Body height below normal,9,7260,7251,131,122,414453,3.9955910266654455
labetalol,Bone Diseases,2,7260,7258,36,34,414541,3.22861363705949
labetalol,Bone Marrow Diseases,3,7260,7257,12,9,414566,14.531590188783243
labetalol,Bone marrow oedema syndrome,1,7260,7259,16,15,414560,3.6318621710979473
labetalol,Bone scan abnormal,6,7260,7254,14,8,414567,24.921481744062387
labetalol,Bradyarrhythmia (disorder),3,7260,7257,28,25,414550,6.227588141498848
labetalol,Brain Edema,5,7260,7255,79,74,414501,3.679313262786904
labetalol,Brain natriuretic peptide decreased,2,7260,7258,22,20,414555,5.283361306645959
labetalol,Breast hyperplasia,2,7260,7258,8,6,414569,14.529725819785064
labetalol,Bronchospasm,2,7260,7258,13,11,414564,8.941263751404287
labetalol,Bullous pemphigoid,3,7260,7257,19,16,414559,9.177694131981461
labetalol,Candida sepsis,1,7260,7259,11,10,414565,5.282771230697943
labetalol,Candida test positive,1,7260,7259,15,14,414561,3.87399549983928
labetalol,Cardiac septal hypertrophy,8,7260,7252,14,6,414569,33.23780631943897
labetalol,Carotid Artery Thrombosis,2,7260,7258,9,7,414568,12.915281222252839
labetalol,Carotid Body Paraganglioma,6,7260,7254,11,5,414570,31.71847507331378
labetalol,Cerebellar ischaemia,4,7260,7256,12,8,414567,19.378123851525174
labetalol,Cerebral Embolism,1,7260,7259,9,8,414567,6.456751006413494
labetalol,Cerebrovascular Insufficiency,2,7260,7258,16,14,414561,7.264725130890052
labetalol,Cervical spinal cord injury,2,7260,7258,17,15,414560,6.8373721491903465
labetalol,Cervical spine flattening,1,7260,7259,8,7,414568,7.263862102217937
labetalol,Cesarean section,1,7260,7259,13,12,414563,4.470016001356407
labetalol,Cholecystitis,1,7260,7259,10,9,414566,5.81106212976994
labetalol,Choroidal Effusions,1,7260,7259,13,12,414563,4.470016001356407
labetalol,Chronic graft-versus-host disease,1,7260,7259,12,11,414564,4.84252881480461
labetalol,Chronic throat clearing,4,7260,7256,33,29,414546,7.046239684607932
labetalol,Circumoral oedema,5,7260,7255,20,15,414560,14.535320468642315
labetalol,Clostridial gastroenteritis,1,7260,7259,7,6,414569,8.301576368252219
labetalol,Colorectal Carcinoma,14,7260,7246,159,145,414430,5.124027656985333
labetalol,Colostomy Procedure,1,7260,7259,17,16,414559,3.418215116326183
labetalol,Completed Suicide,2,7260,7258,37,35,414540,3.1413463615172077
labetalol,Complex Regional Pain Syndromes,1,7260,7259,9,8,414567,6.456751006413494
labetalol,Compression of brain,1,7260,7259,13,12,414563,4.470016001356407
labetalol,Congenital macrognathism,1,7260,7259,6,5,414570,9.68519538963126
labetalol,Congenital tricuspid valve incompetence,1,7260,7259,19,18,414557,3.058388497763212
labetalol,Conjunctival hemorrhage,2,7260,7258,6,4,414571,19.373059612381738
labetalol,Consciousness fluctuating,1,7260,7259,19,18,414557,3.058388497763212
labetalol,Contracture of joint,1,7260,7259,7,6,414569,8.301576368252219
labetalol,Conventional (Clear Cell) Renal Cell Carcinoma,1,7260,7259,6,5,414570,9.68519538963126
labetalol,Coronary Aneurysm,6,7260,7254,11,5,414570,31.71847507331378
labetalol,Coronavirus Infections,2,7260,7258,30,28,414547,3.8743914760723794
labetalol,Costal chondritis,1,7260,7259,13,12,414563,4.470016001356407
labetalol,Cryptococcal fungaemia,2,7260,7258,10,8,414567,11.62372554422706
labetalol,Cutaneous plaque,1,7260,7259,13,12,414563,4.470016001356407
labetalol,Cytokine Release Syndrome,4,7260,7256,8,4,414571,29.067461411245866
labetalol,Decompression of median nerve,1,7260,7259,19,18,414557,3.058388497763212
labetalol,Decreased CD4:CD8 ratio,1,7260,7259,8,7,414568,7.263862102217937
labetalol,Decreased body weight,1,7260,7259,16,15,414560,3.6318621710979473
labetalol,Decreased systolic arterial pressure,1,7260,7259,9,8,414567,6.456751006413494
labetalol,Decreased therapeutic response,1,7260,7259,8,7,414568,7.263862102217937
labetalol,Deformity of spine,2,7260,7258,17,15,414560,6.8373721491903465
labetalol,Dental discomfort,1,7260,7259,7,6,414569,8.301576368252219
labetalol,Dental surgical procedure,1,7260,7259,7,6,414569,8.301576368252219
labetalol,Dermo-hypodermitis,1,7260,7259,10,9,414566,5.81106212976994
labetalol,Device Failure,14,7260,7246,100,86,414489,8.148343913883522
labetalol,Device dislocation,3,7260,7257,57,54,414521,3.058955781350855
labetalol,Device fastener issue,2,7260,7258,31,29,414546,3.7494022169085945
labetalol,Device leakage,2,7260,7258,21,19,414556,5.5349630621055255
labetalol,Device occlusion,2,7260,7258,12,10,414565,9.68639202718839
labetalol,Diabetes mellitus inadequate control,1,7260,7259,8,7,414568,7.263862102217937
labetalol,Diabetic Foot,1,7260,7259,19,18,414557,3.058388497763212
labetalol,Diabetic Nephropathy,4,7260,7256,20,16,414559,11.62665380374862
labetalol,Diabetic Neuropathies,1,7260,7259,6,5,414570,9.68519538963126
labetalol,Diastolic dysfunction,12,7260,7248,109,97,414478,6.405705085363631
labetalol,Dilatation of aorta,29,7260,7231,308,279,414296,5.488760962450631
labetalol,Dilatation of the bladder,4,7260,7256,12,8,414567,19.378123851525174
labetalol,Disease of diaphragm,4,7260,7256,37,33,414542,6.284424446497215
labetalol,Disorder of tendon,5,7260,7255,25,20,414555,11.628118538938663
labetalol,Disseminated Histoplasmosis,1,7260,7259,15,14,414561,3.87399549983928
labetalol,Dissociative disorder,20,7260,7240,101,81,414494,11.534762868552049
labetalol,Disturbance in sexual arousal,1,7260,7259,11,10,414565,5.282771230697943
labetalol,Down Syndrome,1,7260,7259,6,5,414570,9.68519538963126
labetalol,Drug Tolerance,2,7260,7258,11,9,414566,10.566998171296877
labetalol,Drug action increased,3,7260,7257,52,49,414526,3.353125894361942
labetalol,Drug level increased,3,7260,7257,58,55,414520,3.0062080369488675
labetalol,Dry lips (finding),4,7260,7256,19,15,414560,12.23861196541519
labetalol,Dry tongue,2,7260,7258,27,25,414550,4.304910035414306
labetalol,Duodenal ulcer perforation,4,7260,7256,29,25,414550,8.01821085047333
labetalol,Ear tube insertion,1,7260,7259,11,10,414565,5.282771230697943
labetalol,Edema of mouth,2,7260,7258,15,13,414562,7.7490585101497205
labetalol,Elective Surgical Procedures,4,7260,7256,65,61,414514,3.577050292596048
labetalol,Electroencephalogram abnormal,2,7260,7258,6,4,414571,19.373059612381738
labetalol,Electrolyte imbalance,1,7260,7259,19,18,414557,3.058388497763212
labetalol,Elevated circulating hepatic transaminase concentration,11,7260,7249,193,182,414393,3.315134408390795
labetalol,Elevated hemoglobin A1c,15,7260,7245,24,9,414566,36.38811249137336
labetalol,Employment dissatisfaction,1,7260,7259,18,17,414558,3.228306623195726
labetalol,Encephalopathies,1,7260,7259,11,10,414565,5.282771230697943
labetalol,Enthesopathy,1,7260,7259,10,9,414566,5.81106212976994
labetalol,Eosinophilic Pneumonia,2,7260,7258,15,13,414562,7.7490585101497205
labetalol,Epididymal Cyst,2,7260,7258,22,20,414555,5.283361306645959
labetalol,Epididymitis,1,7260,7259,19,18,414557,3.058388497763212
labetalol,Epigastric discomfort,1,7260,7259,18,17,414558,3.228306623195726
labetalol,Epstein-Barr Virus Infections,1,7260,7259,7,6,414569,8.301576368252219
labetalol,Erosive Duodenitis,4,7260,7256,15,11,414564,15.502388827636898
labetalol,Erythrocyte sedimentation rate raised,1,7260,7259,6,5,414570,9.68519538963126
labetalol,Euglycaemic diabetic ketoacidosis,1,7260,7259,8,7,414568,7.263862102217937
labetalol,Evaluation procedure,1,7260,7259,19,18,414557,3.058388497763212
labetalol,Exposure during breast feeding,2,7260,7258,7,5,414570,16.605440302326496
labetalol,Eye Injuries,5,7260,7255,60,55,414520,4.84464736963014
labetalol,Eye irritation,4,7260,7256,11,7,414568,21.139821589656208
labetalol,Eyelid Diseases,2,7260,7258,12,10,414565,9.68639202718839
labetalol,Faecal volume decreased,1,7260,7259,10,9,414566,5.81106212976994
labetalol,Female infertility,1,7260,7259,5,4,414571,11.622262019561923
labetalol,Fine motor delay,4,7260,7256,17,13,414562,13.678513522277708
labetalol,Flattened T wave (finding),1,7260,7259,8,7,414568,7.263862102217937
labetalol,Folliculitis,1,7260,7259,11,10,414565,5.282771230697943
labetalol,"Fracture Fixation, Internal",1,7260,7259,16,15,414560,3.6318621710979473
labetalol,Fracture of patella,1,7260,7259,13,12,414563,4.470016001356407
labetalol,Fracture with displacement,3,7260,7257,13,10,414565,13.413743759341115
labetalol,Furred tongue,8,7260,7252,49,41,414534,9.495728131296644
labetalol,Furunculosis of skin AND/OR subcutaneous tissue,1,7260,7259,16,15,414560,3.6318621710979473
labetalol,Gastroduodenitis,4,7260,7256,13,9,414566,17.88745653464507
labetalol,Gastroenteritis norovirus,15,7260,7245,202,187,414388,4.321515691941865
labetalol,Gastrointestinal carcinoma,117,7260,7143,350,233,414342,19.72510349793004
labetalol,Gastrointestinal tract adenoma,1,7260,7259,14,13,414562,4.150719304115088
labetalol,Gastrointestinal tract mucosal discoloration,1,7260,7259,10,9,414566,5.81106212976994
labetalol,Gaze palsy,3,7260,7257,29,26,414549,6.012829467862183
labetalol,Genital blistering,5,7260,7255,6,1,414574,48.45267631518493
labetalol,Gingiva operations,5,7260,7255,61,56,414519,4.765215622916926
labetalol,Gingival discolouration,42,7260,7218,113,71,414504,21.716019685300022
labetalol,Gingivitis,9,7260,7251,170,161,414414,3.0786706904524324
labetalol,Graft versus host disease in skin,2,7260,7258,16,14,414561,7.264725130890052
labetalol,HELLP Syndrome,107,7260,7153,405,298,414277,15.565604002809836
labetalol,Headache,11,7260,7249,204,193,414382,3.136295337558392
labetalol,Hematological Disease,1,7260,7259,9,8,414567,6.456751006413494
labetalol,Hematoma of kidney,1,7260,7259,17,16,414559,3.418215116326183
labetalol,"Hemianopsia, Homonymous",1,7260,7259,8,7,414568,7.263862102217937
labetalol,Hemoperitoneum,1,7260,7259,14,13,414562,4.150719304115088
labetalol,Hemorrhagic Stroke,5,7260,7255,68,63,414512,4.274607775570601
labetalol,Heparin resistance,1,7260,7259,9,8,414567,6.456751006413494
labetalol,Hepatosplenomegaly,1,7260,7259,5,4,414571,11.622262019561923
labetalol,Hernia of abdominal cavity,2,7260,7258,26,24,414551,4.470494096699663
labetalol,Hernia pain,1,7260,7259,13,12,414563,4.470016001356407
labetalol,Hodgkin Disease,21,7260,7239,62,41,414534,19.73457615336283
labetalol,Hydrops of gallbladder,2,7260,7258,15,13,414562,7.7490585101497205
labetalol,Hyperglycaemic hyperosmolar nonketotic syndrome,1,7260,7259,18,17,414558,3.228306623195726
labetalol,Hypermobility syndrome,3,7260,7257,7,4,414571,24.91159274788874
labetalol,"Hyperparathyroidism, Primary",56,7260,7204,440,384,414191,7.444765534299126
labetalol,Hypertensive Encephalopathy,2,7260,7258,33,31,414544,3.5221490184289856
labetalol,Hypertrophy of adenoids,1,7260,7259,11,10,414565,5.282771230697943
labetalol,Hyphema,1,7260,7259,5,4,414571,11.622262019561923
labetalol,Hyporeflexia,1,7260,7259,10,9,414566,5.81106212976994
labetalol,Hysterectomy,2,7260,7258,17,15,414560,6.8373721491903465
labetalol,Impaired exercise tolerance,12,7260,7248,84,72,414503,8.312657678965625
labetalol,Impairment of urinary concentration,1,7260,7259,5,4,414571,11.622262019561923
labetalol,Inappropriate schedule of product administration,12,7260,7248,231,219,414356,3.0217310283535452
labetalol,Incision site erythema,2,7260,7258,35,33,414542,3.320867614061331
labetalol,Incorrect product storage,1,7260,7259,18,17,414558,3.228306623195726
labetalol,Increased appetite (finding),6,7260,7254,79,73,414502,4.4157845693166236
labetalol,Infection causing abscess of colon,1,7260,7259,7,6,414569,8.301576368252219
labetalol,Infection transmission via personal contact,2,7260,7258,10,8,414567,11.62372554422706
labetalol,Infective vaginitis,9,7260,7251,115,106,414469,4.551672033242792
labetalol,Inflammatory Bowel Diseases,2,7260,7258,10,8,414567,11.62372554422706
labetalol,Influenza A virus test,1,7260,7259,19,18,414557,3.058388497763212
labetalol,Infusion-Related Reaction,2,7260,7258,8,6,414569,14.529725819785064
labetalol,Injected limb mobility decreased,3,7260,7257,27,24,414551,6.458254865034525
labetalol,Injection site cyst,1,7260,7259,8,7,414568,7.263862102217937
labetalol,Injection site haematoma,2,7260,7258,17,15,414560,6.8373721491903465
labetalol,Injury of cornea,1,7260,7259,14,13,414562,4.150719304115088
labetalol,Instillation site pain,2,7260,7258,18,16,414559,6.457502832123939
labetalol,Intelligence increased,1,7260,7259,10,9,414566,5.81106212976994
labetalol,Intentional device misuse,1,7260,7259,14,13,414562,4.150719304115088
labetalol,Intervertebral Disk Displacement,1,7260,7259,18,17,414558,3.228306623195726
labetalol,Intervertebral disc annular tear,1,7260,7259,12,11,414564,4.84252881480461
labetalol,Intervertebral disc compression,2,7260,7258,18,16,414559,6.457502832123939
labetalol,Intestinal Fistula,3,7260,7257,11,8,414567,15.852681423578488
labetalol,Intestinal metastasis,1,7260,7259,7,6,414569,8.301576368252219
labetalol,Intestinal resection,1,7260,7259,8,7,414568,7.263862102217937
labetalol,"Intubation, Intratracheal",1,7260,7259,6,5,414570,9.68519538963126
labetalol,Iron deficiency,1,7260,7259,6,5,414570,9.68519538963126
labetalol,Joint crepitus,1,7260,7259,5,4,414571,11.622262019561923
labetalol,Keratosis pilaris,2,7260,7258,10,8,414567,11.62372554422706
labetalol,Kidney Neoplasm,2,7260,7258,19,17,414558,6.117619758959261
labetalol,Kidney Transplantation,1,7260,7259,9,8,414567,6.456751006413494
labetalol,Large intestinal obstruction reduction,11,7260,7249,98,87,414488,6.530256108513208
labetalol,Large intestine perforation,14,7260,7246,78,64,414511,10.447139712803526
labetalol,Learning Disorders,5,7260,7255,52,47,414528,5.590083761861846
labetalol,Leukaemia recurrent,1,7260,7259,7,6,414569,8.301576368252219
labetalol,Liver Abscess,2,7260,7258,17,15,414560,6.8373721491903465
labetalol,Liver function tests abnormal,4,7260,7256,49,45,414530,4.745246720518416
labetalol,Loss of interest,55,7260,7205,879,824,413751,3.655750375600309
labetalol,Low birth weight baby,16,7260,7244,118,102,414473,7.893700455783395
labetalol,Lower gastrointestinal hemorrhage,14,7260,7246,37,23,414552,22.025840911294956
labetalol,Lumpectomy of breast,3,7260,7257,37,34,414541,4.712668849088858
labetalol,Lymph node excision,2,7260,7258,33,31,414544,3.5221490184289856
labetalol,Lymph nodes scan abnormal,3,7260,7257,27,24,414551,6.458254865034525
labetalol,Lymphadenitis,2,7260,7258,28,26,414549,4.151153407077904
labetalol,Mantle cell lymphoma,6,7260,7254,60,54,414521,5.814378274055694
labetalol,Mass of skin,2,7260,7258,26,24,414551,4.470494096699663
labetalol,Mass of stomach,3,7260,7257,10,7,414568,17.437990905332782
labetalol,Maternal drugs affecting foetus,17,7260,7243,92,75,414500,10.759460408550384
labetalol,Meniscal degeneration,9,7260,7251,22,13,414562,23.79807800804905
labetalol,Mental handicap,2,7260,7258,5,3,414572,23.247726646459082
labetalol,Metastases to abdominal cavity,1,7260,7259,10,9,414566,5.81106212976994
labetalol,Metastatic malignant neoplasm to kidney,1,7260,7259,15,14,414561,3.87399549983928
labetalol,Migration of implanted drug,2,7260,7258,8,6,414569,14.529725819785064
labetalol,Mitochondrial myopathy acquired,1,7260,7259,13,12,414563,4.470016001356407
labetalol,Mixed liver injury,2,7260,7258,7,5,414570,16.605440302326496
labetalol,Monocyte percentage decreased,1,7260,7259,17,16,414559,3.418215116326183
labetalol,Motor delay,4,7260,7256,6,2,414573,38.75679897096655
labetalol,Mucous membrane hyperplasia,1,7260,7259,11,10,414565,5.282771230697943
labetalol,Multiple Trauma,17,7260,7243,148,131,414444,6.687425137411331
labetalol,Muscle hemorrhage,6,7260,7254,50,44,414531,6.977419354838709
labetalol,Muscle tone disorder,1,7260,7259,16,15,414560,3.6318621710979473
labetalol,Myalgia,5,7260,7255,87,82,414493,3.340922233576527
labetalol,Myocardial calcification,2,7260,7258,17,15,414560,6.8373721491903465
labetalol,"Nails, Ingrown",5,7260,7255,34,29,414546,8.549904731017149
labetalol,Nausea,16,7260,7244,287,271,414304,3.2441929594021817
labetalol,Necrotizing fasciitis,10,7260,7250,54,44,414531,10.77346104725415
labetalol,Negative thoughts,5,7260,7255,8,3,414572,36.33933494141971
labetalol,Neonatal cyanosis,2,7260,7258,36,34,414541,3.22861363705949
labetalol,Neonatal hypotension,1,7260,7259,9,8,414567,6.456751006413494
labetalol,Neoplasm of pericardium,2,7260,7258,6,4,414571,19.373059612381738
labetalol,Neuropsychiatric Systemic Lupus Erythematosus,2,7260,7258,15,13,414562,7.7490585101497205
labetalol,Neutropenia,3,7260,7257,21,18,414557,8.303588653319947
labetalol,Nocturnal dyspnea,1,7260,7259,7,6,414569,8.301576368252219
labetalol,Non-infective meningitis,3,7260,7257,26,23,414552,6.706665182688333
labetalol,Normochromic anemia,4,7260,7256,22,18,414557,10.56963516087
labetalol,Obstruction of salivary duct,1,7260,7259,8,7,414568,7.263862102217937
labetalol,Occlusion of inferior vena cava,1,7260,7259,9,8,414567,6.456751006413494
labetalol,Ocular icterus,6,7260,7254,15,9,414566,23.259994485800938
labetalol,Ocular sarcoidosis,2,7260,7258,6,4,414571,19.373059612381738
labetalol,Oestradiol increased,1,7260,7259,8,7,414568,7.263862102217937
labetalol,Operation on joint,1,7260,7259,11,10,414565,5.282771230697943
labetalol,Ophthalmoplegia,2,7260,7258,17,15,414560,6.8373721491903465
labetalol,Oral mucosal blisters,1,7260,7259,15,14,414561,3.87399549983928
labetalol,Oral paresthesia,4,7260,7256,73,69,414506,3.1849843681563486
labetalol,Orthopnea,2,7260,7258,32,30,414545,3.632224786442546
labetalol,Ototoxicity,4,7260,7256,9,5,414570,25.8376822246723
labetalol,Ovarian Cysts,1,7260,7259,7,6,414569,8.301576368252219
labetalol,Ovarian cancer stage IV,5,7260,7255,21,16,414559,13.843129532998589
labetalol,PCO2 decreased,2,7260,7258,14,12,414563,8.302582372160767
labetalol,Pain in penis,5,7260,7255,87,82,414493,3.340922233576527
labetalol,Pain in testicle,4,7260,7256,56,52,414523,4.152021971964088
labetalol,Palatal edema,9,7260,7251,68,59,414516,7.698538538294921
labetalol,Pancreatic enlargement,1,7260,7259,13,12,414563,4.470016001356407
labetalol,Pancreatitis Necrotizing,1,7260,7259,7,6,414569,8.301576368252219
labetalol,Parophthalmia,1,7260,7259,6,5,414570,9.68519538963126
labetalol,Patient Non-Compliance,1,7260,7259,7,6,414569,8.301576368252219
labetalol,Pelvic Floor Muscle Weakness,2,7260,7258,6,4,414571,19.373059612381738
labetalol,Peptic Ulcer Perforation,2,7260,7258,6,4,414571,19.373059612381738
labetalol,Pericardial effusion,3,7260,7257,55,52,414523,3.170205569544139
labetalol,Perineal erythema,2,7260,7258,7,5,414570,16.605440302326496
labetalol,Perineal ulceration,2,7260,7258,5,3,414572,23.247726646459082
labetalol,Peritoneal Dialysis,5,7260,7255,12,7,414568,24.22599356765449
labetalol,Pharyngeal lesion,1,7260,7259,9,8,414567,6.456751006413494
labetalol,Pharyngotonsillitis,2,7260,7258,5,3,414572,23.247726646459082
labetalol,Phobic avoidance - mental defense mechanism,10,7260,7250,99,89,414486,5.875806339254615
labetalol,Pigmentation Disorders,2,7260,7258,37,35,414540,3.1413463615172077
labetalol,Pilonidal Cyst,3,7260,7257,41,38,414537,4.252855947327559
labetalol,Polycystic liver disease,1,7260,7259,11,10,414565,5.282771230697943
labetalol,Polydactyly,79,7260,7181,343,264,414311,13.518776265355248
labetalol,"Polyradiculoneuropathy, Chronic Inflammatory Demyelinating",2,7260,7258,28,26,414549,4.151153407077904
labetalol,Poor quality drug administered,1,7260,7259,18,17,414558,3.228306623195726
labetalol,Positron emission tomogram abnormal,1,7260,7259,9,8,414567,6.456751006413494
labetalol,Post procedural contusion,1,7260,7259,14,13,414562,4.150719304115088
labetalol,Postural dizziness,10,7260,7250,36,26,414549,16.16088122605364
labetalol,Pregnancy associated hypertension,14,7260,7246,52,38,414537,15.671675619439903
labetalol,Premature Birth,8,7260,7252,61,53,414522,7.627499027967413
labetalol,Preterm premature rupture of membranes (disorder),35,7260,7225,163,128,414447,12.531912454624578
labetalol,Procedural complication,1,7260,7259,17,16,414559,3.418215116326183
labetalol,Procedural vomiting,4,7260,7256,24,20,414555,9.688786291804483
labetalol,Proctitis infectious,1,7260,7259,19,18,414557,3.058388497763212
labetalol,Product closure issue,1,7260,7259,7,6,414569,8.301576368252219
labetalol,Product packaging issue,2,7260,7258,18,16,414559,6.457502832123939
labetalol,Product shape issue,2,7260,7258,15,13,414562,7.7490585101497205
labetalol,Product taste abnormal,2,7260,7258,31,29,414546,3.7494022169085945
labetalol,Prostate specific antigen outside reference range,2,7260,7258,27,25,414550,4.304910035414306
labetalol,Protein/Creatinine ratio in urine above normal,1,7260,7259,6,5,414570,9.68519538963126
labetalol,Pruritus,7,7260,7253,99,92,414483,4.111363183747025
labetalol,Pruritus of genital organs,1,7260,7259,14,13,414562,4.150719304115088
labetalol,Pseudo-Bartter syndrome,4,7260,7256,42,38,414537,5.536213051924187
labetalol,Psychomotor Agitation,2,7260,7258,9,7,414568,12.915281222252839
labetalol,Psychotic Disorders,1,7260,7259,19,18,414557,3.058388497763212
labetalol,Ptosis of eyebrow,1,7260,7259,13,12,414563,4.470016001356407
labetalol,Pulpitis,1,7260,7259,15,14,414561,3.87399549983928
labetalol,Pulsus paradoxus,1,7260,7259,16,15,414560,3.6318621710979473
labetalol,Puncture site haematoma,3,7260,7257,6,3,414572,29.06359377153094
labetalol,Pustular acne,1,7260,7259,6,5,414570,9.68519538963126
labetalol,Radiation esophagitis,2,7260,7258,7,5,414570,16.605440302326496
labetalol,Radiation exposure during pregnancy,14,7260,7246,64,50,414525,12.732874171956944
labetalol,Rapid correction of hyponatraemia,2,7260,7258,19,17,414558,6.117619758959261
labetalol,Red man syndrome,2,7260,7258,11,9,414566,10.566998171296877
labetalol,Removal of internal fixation device,1,7260,7259,13,12,414563,4.470016001356407
labetalol,Renal cancer recurrent,1,7260,7259,10,9,414566,5.81106212976994
labetalol,Renal tubular acidosis,5,7260,7255,23,18,414557,12.639319210139933
labetalol,Renal tubular disorder,3,7260,7257,19,16,414559,9.177694131981461
labetalol,Renal tubular necrosis,3,7260,7257,46,43,414532,3.790544062404515
labetalol,Renal venous congestion,5,7260,7255,16,11,414564,18.169322880771883
labetalol,Repeat Surgery,1,7260,7259,13,12,414563,4.470016001356407
labetalol,"Respiratory Distress Syndrome, Newborn",2,7260,7258,9,7,414568,12.915281222252839
labetalol,Retinal Vascular Disorder,2,7260,7258,8,6,414569,14.529725819785064
labetalol,Retrognathia,2,7260,7258,14,12,414563,8.302582372160767
labetalol,Retroperitoneal hematoma,2,7260,7258,18,16,414559,6.457502832123939
labetalol,Rheumatoid Arthritis,5,7260,7255,47,42,414533,6.184846840770122
labetalol,Right Ventricular Dysfunction,11,7260,7249,79,68,414507,8.101188989838843
labetalol,Rocky Mountain Spotted Fever,3,7260,7257,17,14,414561,10.2574714879751
labetalol,Rosacea,12,7260,7248,107,95,414480,6.525468837036578
labetalol,Rupture of liver,7,7260,7253,19,12,414563,21.426429716922943
labetalol,Ruptured cerebral aneurysm,1,7260,7259,17,16,414559,3.418215116326183
labetalol,Scrotal dermatitis,2,7260,7258,6,4,414571,19.373059612381738
labetalol,Secondary malignant neoplasm of ovary,2,7260,7258,9,7,414568,12.915281222252839
labetalol,Sensory disorder of eyelid,1,7260,7259,8,7,414568,7.263862102217937
labetalol,Shone complex,3,7260,7257,11,8,414567,15.852681423578488
labetalol,Shortened therapeutic response,1,7260,7259,7,6,414569,8.301576368252219
labetalol,Shunt stenosis,2,7260,7258,7,5,414570,16.605440302326496
labetalol,Skin odour abnormal,5,7260,7255,57,52,414523,5.099665082762039
labetalol,Skin sensitisation,2,7260,7258,38,36,414539,3.05867210047715
labetalol,Sluggishness,2,7260,7258,21,19,414556,5.5349630621055255
labetalol,Sore to touch,1,7260,7259,12,11,414564,4.84252881480461
labetalol,Splenic Diseases,1,7260,7259,5,4,414571,11.622262019561923
labetalol,Splenic Infection,4,7260,7256,16,12,414563,14.53345507166483
labetalol,Spondylitis,4,7260,7256,72,68,414507,3.2292279186573563
labetalol,Spontaneous penile erection,1,7260,7259,11,10,414565,5.282771230697943
labetalol,Sputum retention,1,7260,7259,8,7,414568,7.263862102217937
labetalol,Stage IVB Vaginal Cancer AJCC v6 and v7,1,7260,7259,6,5,414570,9.68519538963126
labetalol,Stent-graft endoleak,1,7260,7259,6,5,414570,9.68519538963126
labetalol,Stoma site extravasation,2,7260,7258,6,4,414571,19.373059612381738
labetalol,Stomach Neoplasms,1,7260,7259,11,10,414565,5.282771230697943
labetalol,Streptococcus test positive,1,7260,7259,8,7,414568,7.263862102217937
labetalol,Stress at work,1,7260,7259,9,8,414567,6.456751006413494
labetalol,Stricture of artery,6,7260,7254,97,91,414484,3.596207140603549
labetalol,Sudden death,5,7260,7255,60,55,414520,4.84464736963014
labetalol,Sweat Gland Neoplasms,3,7260,7257,12,9,414566,14.531590188783243
labetalol,Swelling of skin,2,7260,7258,26,24,414551,4.470494096699663
labetalol,Syphilis,3,7260,7257,13,10,414565,13.413743759341115
labetalol,Systolic anterior motion of mitral valve,5,7260,7255,5,0,414575,58.143349414197104
labetalol,Therapeutic product ineffective,3,7260,7257,57,54,414521,3.058955781350855
labetalol,Thirst,1,7260,7259,15,14,414561,3.87399549983928
labetalol,Throat clearing,1,7260,7259,9,8,414567,6.456751006413494
labetalol,Thrombophlebitis,2,7260,7258,11,9,414566,10.566998171296877
labetalol,Thyroid hormones decreased,2,7260,7258,21,19,414556,5.5349630621055255
labetalol,Toothache,14,7260,7246,252,238,414337,3.2323044131628174
labetalol,Tracheal Diseases,2,7260,7258,16,14,414561,7.264725130890052
labetalol,Tracheoesophageal Fistula,26,7260,7234,27,1,414574,56.14949979008591
labetalol,Tuberous Sclerosis,2,7260,7258,6,4,414571,19.373059612381738
labetalol,Tumour perforation,3,7260,7257,21,18,414557,8.303588653319947
labetalol,Urea renal clearance increased,1,7260,7259,17,16,414559,3.418215116326183
labetalol,Uremic encephalopathy,1,7260,7259,6,5,414570,9.68519538963126
labetalol,Urinary Incontinence,10,7260,7250,142,132,414443,4.0960951918407
labetalol,Urine alcohol test positive,1,7260,7259,18,17,414558,3.228306623195726
labetalol,Urine calcium increased,1,7260,7259,15,14,414561,3.87399549983928
labetalol,Uterine Neoplasms,2,7260,7258,6,4,414571,19.373059612381738
labetalol,Uterine hemorrhage,19,7260,7241,329,310,414265,3.361730671635557
labetalol,Vaginal Discharge,2,7260,7258,38,36,414539,3.05867210047715
labetalol,Vaginal Hemorrhage,4,7260,7256,51,47,414528,4.559136995481765
labetalol,Vaginal abscess,11,7260,7249,56,45,414530,11.429086277910253
labetalol,Venous perforation,3,7260,7257,5,2,414573,34.87639520463001
labetalol,Very low density lipoprotein decreased,1,7260,7259,13,12,414563,4.470016001356407
labetalol,Victim of sexual abuse,16,7260,7244,284,268,414307,3.278485934935955
labetalol,Violence-related symptom,17,7260,7243,296,279,414296,3.342539021832823
labetalol,Viral Encephalitis,1,7260,7259,11,10,414565,5.282771230697943
labetalol,Weight decrease neonatal,4,7260,7256,10,6,414569,23.253858875413453
labetalol,Withdrawal hypertension,1,7260,7259,18,17,414558,3.228306623195726
labetalol,Wound discharge finding,1,7260,7259,11,10,414565,5.282771230697943
labetalol,amniotic fluid meconium stained,12,7260,7248,31,19,414556,22.527451399273662
labetalol,gallbladder neoplasm,1,7260,7259,10,9,414566,5.81106212976994
lisinopril,"Acidosis, Lactic",39,22774,22735,165,126,398935,4.383877481656237
lisinopril,Actinomycosis,1,22774,22773,5,4,399057,3.704650243709656
lisinopril,Acute graft versus host disease in skin,1,22774,22773,5,4,399057,3.704650243709656
lisinopril,Acute psychosis,1,22774,22773,5,4,399057,3.704650243709656
lisinopril,Acute pulmonary edema,2,22774,22772,12,10,399051,3.0872928742900636
lisinopril,Adenoidal disorder,3,22774,22771,15,12,399049,3.7048877958807256
lisinopril,Adenoma,2,22774,22772,6,4,399057,6.174673575736284
lisinopril,Allergy to arthropod sting,4,22774,22770,20,16,399045,3.7050065876152836
lisinopril,Altered state of consciousness,1,22774,22773,6,5,399056,3.08720121781642
lisinopril,Amebiasis,2,22774,22772,11,9,399052,3.3679638471488116
lisinopril,Ammonia increased,2,22774,22772,10,8,399053,3.704769014579308
lisinopril,Amputation of toe (procedure),15,22774,22759,54,39,399022,5.147914622298383
lisinopril,Anal abscess,8,22774,22766,37,29,399032,4.005954825949555
lisinopril,Anti-neutrophil cytoplasmic antibody positive vasculitis,5,22774,22769,18,13,399048,5.146092884575031
lisinopril,Antiphospholipid antibodies positive,1,22774,22773,5,4,399057,3.704650243709656
lisinopril,Anxiety Disorders,1,22774,22773,6,5,399056,3.08720121781642
lisinopril,Aortic Valve Stenosis,3,22774,22771,8,5,399056,6.946779895481094
lisinopril,Application site dryness,6,22774,22768,21,15,399046,5.293318943881136
lisinopril,Application site hypersensitivity,1,22774,22773,5,4,399057,3.704650243709656
lisinopril,Application site infection,1,22774,22773,5,4,399057,3.704650243709656
lisinopril,Application site irritation,24,22774,22750,87,63,398998,5.1140341038272075
lisinopril,Application site scar,3,22774,22771,15,12,399049,3.7048877958807256
lisinopril,Arnold Chiari Malformation,4,22774,22770,17,13,399048,4.358862280089902
lisinopril,Arthroscopy,5,22774,22769,23,18,399043,4.027329301663016
lisinopril,Ascorbic Acid Deficiency,2,22774,22772,8,6,399055,4.630983225013174
lisinopril,Athletic Injuries,2,22774,22772,8,6,399055,4.630983225013174
lisinopril,Atrial Fibrillation,3,22774,22771,18,15,399046,3.087384538813988
lisinopril,Atrial Premature Complexes,1,22774,22773,5,4,399057,3.704650243709656
lisinopril,Autoimmune thyroiditis,4,22774,22770,10,6,399055,7.410188844971454
lisinopril,Azotemia,2,22774,22772,7,5,399056,5.292564803894507
lisinopril,Bacterial gastroenteritis,13,22774,22761,58,45,399016,4.153430171694171
lisinopril,Bacterial sinusitis,2,22774,22772,8,6,399055,4.630983225013174
lisinopril,Basal Ganglia Hemorrhage,7,22774,22767,42,35,399026,3.0877512774337124
lisinopril,Benign Prostatic Hyperplasia,4,22774,22770,13,9,399052,5.700104726191683
lisinopril,Benign neoplasm of skin,1,22774,22773,6,5,399056,3.08720121781642
lisinopril,Biopsy lymph gland abnormal,2,22774,22772,9,7,399054,4.116419774772138
lisinopril,Biopsy of pancreas,2,22774,22772,9,7,399054,4.116419774772138
lisinopril,Bladder cancer stage IV,3,22774,22771,14,11,399050,3.969532048909327
lisinopril,Bladder prolapse,2,22774,22772,7,5,399056,5.292564803894507
lisinopril,Bleeding ulcer of esophagus,1,22774,22773,5,4,399057,3.704650243709656
lisinopril,Blood HIV RNA increased,1,22774,22773,6,5,399056,3.08720121781642
lisinopril,Blood creatine decreased,2,22774,22772,5,3,399058,7.409625856314773
lisinopril,Blood triglycerides,3,22774,22771,10,7,399054,5.557397567080937
lisinopril,Blood zinc decreased,1,22774,22773,6,5,399056,3.08720121781642
lisinopril,Bone fragmentation,1,22774,22773,6,5,399056,3.08720121781642
lisinopril,Bone marrow harvest failure,11,22774,22763,61,50,399011,3.3412821929173244
lisinopril,Bone trimming,3,22774,22771,14,11,399050,3.969532048909327
lisinopril,Brain stem herniation,4,22774,22770,11,7,399054,6.736519343633968
lisinopril,Bundle-Branch Block,6,22774,22768,23,17,399044,4.833007424608145
lisinopril,Burning feet syndrome,3,22774,22771,12,9,399052,4.6311426814808305
lisinopril,CSF test abnormal,1,22774,22773,6,5,399056,3.08720121781642
lisinopril,CSF white blood cell count increased,1,22774,22773,6,5,399056,3.08720121781642
lisinopril,"Carcinoma, Signet Ring Cell",2,22774,22772,5,3,399058,7.409625856314773
lisinopril,Cardiac Arrest,4,22774,22770,20,16,399045,3.7050065876152836
lisinopril,Cardiac Catheterization Procedures,2,22774,22772,11,9,399052,3.3679638471488116
lisinopril,Cardiomyopathy acute,1,22774,22773,5,4,399057,3.704650243709656
lisinopril,Cardiopulmonary Arrest,1,22774,22773,6,5,399056,3.08720121781642
lisinopril,Cardiovascular Deconditioning,3,22774,22771,12,9,399052,4.6311426814808305
lisinopril,Carotid Artery Thrombosis,2,22774,22772,9,7,399054,4.116419774772138
lisinopril,Carotid Body Paraganglioma,2,22774,22772,11,9,399052,3.3679638471488116
lisinopril,Cataract operation,4,22774,22770,9,5,399056,8.23356267993949
lisinopril,Cataract operation complication,2,22774,22772,12,10,399051,3.0872928742900636
lisinopril,Celiac Disease,1,22774,22773,6,5,399056,3.08720121781642
lisinopril,Cerebral hypoperfusion,2,22774,22772,8,6,399055,4.630983225013174
lisinopril,Chemical burns of eye,4,22774,22770,10,6,399055,7.410188844971454
lisinopril,Cholecystitis,2,22774,22772,10,8,399053,3.704769014579308
lisinopril,Chronic Fatigue Syndrome,12,22774,22762,62,50,399011,3.586393281388619
lisinopril,Circumstance or information capable of leading to medication error,2,22774,22772,12,10,399051,3.0872928742900636
lisinopril,Comatose,1,22774,22773,5,4,399057,3.704650243709656
lisinopril,Compression fracture of vertebral column,2,22774,22772,11,9,399052,3.3679638471488116
lisinopril,Conjunctival hemorrhage,2,22774,22772,6,4,399057,6.174673575736284
lisinopril,Continuous hemodiafiltration,2,22774,22772,7,5,399056,5.292564803894507
lisinopril,Conventional (Clear Cell) Renal Cell Carcinoma,1,22774,22773,6,5,399056,3.08720121781642
lisinopril,Coronary Artery Bypass Surgery,2,22774,22772,11,9,399052,3.3679638471488116
lisinopril,Coronary Occlusion,4,22774,22770,24,20,399041,3.0874762113892547
lisinopril,Creatinine renal clearance increased,1,22774,22773,5,4,399057,3.704650243709656
lisinopril,Cyst of vulva,1,22774,22773,5,4,399057,3.704650243709656
lisinopril,Debridement of bone,1,22774,22773,5,4,399057,3.704650243709656
lisinopril,Dental alveolar anomaly,2,22774,22772,7,5,399056,5.292564803894507
lisinopril,Difficulty driving a car,10,22774,22764,51,41,399020,3.63304977587591
lisinopril,Disorder of bursa,1,22774,22773,5,4,399057,3.704650243709656
lisinopril,Disorder of ligament,20,22774,22754,93,73,398988,3.985989465635724
lisinopril,Disorder of macula of retina,2,22774,22772,10,8,399053,3.704769014579308
lisinopril,Disorder of ocular blood vessel,1,22774,22773,5,4,399057,3.704650243709656
lisinopril,Drug resistance,3,22774,22771,11,8,399053,5.052167629480879
lisinopril,Drug screen false positive,1,22774,22773,5,4,399057,3.704650243709656
lisinopril,Dyschezia,3,22774,22771,13,10,399051,4.274890802403867
lisinopril,Dysgeusia,53,22774,22721,294,241,398820,3.344574844153585
lisinopril,Dyskinetic syndrome,39,22774,22735,218,179,398882,3.317655354977473
lisinopril,Dyspepsia,3,22774,22771,8,5,399056,6.946779895481094
lisinopril,Dyspnea on exertion,3,22774,22771,18,15,399046,3.087384538813988
lisinopril,Ectopic pregnancy with contraceptive device,2,22774,22772,12,10,399051,3.0872928742900636
lisinopril,Electrolyte imbalance,7,22774,22767,19,12,399049,6.82592764689428
lisinopril,Endodontic procedure,13,22774,22761,71,58,399003,3.3928383799568205
lisinopril,Eosinophilic Pneumonia,3,22774,22771,15,12,399049,3.7048877958807256
lisinopril,Erosion of bone,1,22774,22773,6,5,399056,3.08720121781642
lisinopril,Erythrocyte sedimentation rate raised,1,22774,22773,6,5,399056,3.08720121781642
lisinopril,Essential Tremor,4,22774,22770,13,9,399052,5.700104726191683
lisinopril,Eye colour change,2,22774,22772,9,7,399054,4.116419774772138
lisinopril,Eye foreign bodies,1,22774,22773,6,5,399056,3.08720121781642
lisinopril,Eye irritation,2,22774,22772,11,9,399052,3.3679638471488116
lisinopril,Facial Paresis,2,22774,22772,12,10,399051,3.0872928742900636
lisinopril,Fat redistribution,1,22774,22773,5,4,399057,3.704650243709656
lisinopril,First degree atrioventricular block,9,22774,22765,23,14,399047,7.250466486501972
lisinopril,Freckles,1,22774,22773,5,4,399057,3.704650243709656
lisinopril,Gangrene due to diabetes mellitus,1,22774,22773,6,5,399056,3.08720121781642
lisinopril,Gastric pH decreased,1,22774,22773,5,4,399057,3.704650243709656
lisinopril,Gastrointestinal Hemorrhage,15,22774,22759,67,52,399009,4.148937635299927
lisinopril,"Genital Diseases, Male",1,22774,22773,5,4,399057,3.704650243709656
lisinopril,Genitourinary tract gonococcal infection,1,22774,22773,5,4,399057,3.704650243709656
lisinopril,Gingival Hypertrophy,2,22774,22772,10,8,399053,3.704769014579308
lisinopril,Gingival Recession,1,22774,22773,6,5,399056,3.08720121781642
lisinopril,Glioblastoma,1,22774,22773,5,4,399057,3.704650243709656
lisinopril,Granuloma of skin,1,22774,22773,5,4,399057,3.704650243709656
lisinopril,Guilt,1,22774,22773,5,4,399057,3.704650243709656
lisinopril,HIV Seropositivity,3,22774,22771,12,9,399052,4.6311426814808305
lisinopril,Hamman-Rich syndrome,1,22774,22773,6,5,399056,3.08720121781642
lisinopril,Hay fever,4,22774,22770,22,18,399043,3.3681718369465408
lisinopril,Heparin resistance,2,22774,22772,9,7,399054,4.116419774772138
lisinopril,Hepatic Vein Thrombosis,1,22774,22773,5,4,399057,3.704650243709656
lisinopril,Hepatic Veno-Occlusive Disease,2,22774,22772,6,4,399057,6.174673575736284
lisinopril,"Hepatitis, Chronic",2,22774,22772,8,6,399055,4.630983225013174
lisinopril,Hepatosplenomegaly,1,22774,22773,5,4,399057,3.704650243709656
lisinopril,Hypermagnesemia,2,22774,22772,7,5,399056,5.292564803894507
lisinopril,Hypertensive cardiomyopathy,1,22774,22773,6,5,399056,3.08720121781642
lisinopril,Hypertrophy of adenoids,2,22774,22772,11,9,399052,3.3679638471488116
lisinopril,Hypertrophy of tonsils,1,22774,22773,5,4,399057,3.704650243709656
lisinopril,Hyperventilation,5,22774,22769,30,25,399036,3.0875678920169234
lisinopril,Hypocupremia,4,22774,22770,9,5,399056,8.23356267993949
lisinopril,Hypolipidemia,2,22774,22772,12,10,399051,3.0872928742900636
lisinopril,Hypopyon,1,22774,22773,5,4,399057,3.704650243709656
lisinopril,Hypoventilation,4,22774,22770,17,13,399048,4.358862280089902
lisinopril,Ileal Fistula,1,22774,22773,6,5,399056,3.08720121781642
lisinopril,Impaired self-care,2,22774,22772,5,3,399058,7.409625856314773
lisinopril,Inappropriate affect,3,22774,22771,13,10,399051,4.274890802403867
lisinopril,Incorrect dose administered,41,22774,22733,195,154,398907,3.899727832688727
lisinopril,Increased systolic arterial pressure,2,22774,22772,11,9,399052,3.3679638471488116
lisinopril,Infected dermatitis,2,22774,22772,6,4,399057,6.174673575736284
lisinopril,Infectious Mononucleosis,12,22774,22762,53,41,399020,4.195492984832384
lisinopril,Injection site discomfort,7,22774,22767,21,14,399047,6.1758100174228785
lisinopril,Injection site laceration,1,22774,22773,6,5,399056,3.08720121781642
lisinopril,Injection site macule,10,22774,22764,31,21,399040,5.977236270058553
lisinopril,Injury of ear,1,22774,22773,5,4,399057,3.704650243709656
lisinopril,Injury of gallbladder,1,22774,22773,5,4,399057,3.704650243709656
lisinopril,Insulin-like growth factor increased,2,22774,22772,5,3,399058,7.409625856314773
lisinopril,Internal fixation of spine,3,22774,22771,5,2,399059,11.114926880681567
lisinopril,Intertrigo,1,22774,22773,6,5,399056,3.08720121781642
lisinopril,Intestinal gangrene,2,22774,22772,8,6,399055,4.630983225013174
lisinopril,Intestinal infarction,3,22774,22771,13,10,399051,4.274890802403867
lisinopril,Intramedullary rod insertion,4,22774,22770,13,9,399052,5.700104726191683
lisinopril,Inverted T wave,1,22774,22773,5,4,399057,3.704650243709656
lisinopril,Irregular heart beat,4,22774,22770,17,13,399048,4.358862280089902
lisinopril,Itching of ear,1,22774,22773,5,4,399057,3.704650243709656
lisinopril,Itching of eye,14,22774,22760,73,59,399002,3.553860413607145
lisinopril,"Jaundice, Obstructive",2,22774,22772,7,5,399056,5.292564803894507
lisinopril,Jaw Diseases,5,22774,22769,17,12,399049,5.448817148186518
lisinopril,Knee Replacement Arthroplasty,9,22774,22765,51,42,399019,3.269601167943567
lisinopril,Lack of libido,10,22774,22764,41,31,399030,4.519266621237641
lisinopril,Leukocytosis,1,22774,22773,6,5,399056,3.08720121781642
lisinopril,Lichen Sclerosus et Atrophicus,1,22774,22773,6,5,399056,3.08720121781642
lisinopril,Limb prosthesis user,4,22774,22770,11,7,399054,6.736519343633968
lisinopril,Lipodystrophy acquired,2,22774,22772,9,7,399054,4.116419774772138
lisinopril,Localized Edema,11,22774,22763,65,54,399007,3.135635089331878
lisinopril,Loose body in forearm joint,1,22774,22773,6,5,399056,3.08720121781642
lisinopril,Lung Abscess,1,22774,22773,6,5,399056,3.08720121781642
lisinopril,"Lung Diseases, Obstructive",1,22774,22773,6,5,399056,3.08720121781642
lisinopril,Lung diseases,7,22774,22767,36,29,399032,3.6024277340985735
lisinopril,Lysis of adhesions of intestines,1,22774,22773,6,5,399056,3.08720121781642
lisinopril,Macromastia,1,22774,22773,6,5,399056,3.08720121781642
lisinopril,Malignant Vaginal Neoplasm,2,22774,22772,8,6,399055,4.630983225013174
lisinopril,Malignant neoplasm of female breast,2,22774,22772,9,7,399054,4.116419774772138
lisinopril,Malignant neoplasm of skin,4,22774,22770,19,15,399046,3.900016180107713
lisinopril,Mammaplasty,2,22774,22772,9,7,399054,4.116419774772138
lisinopril,Mastoid effusion,3,22774,22771,8,5,399056,6.946779895481094
lisinopril,Medical device removal,2,22774,22772,7,5,399056,5.292564803894507
lisinopril,Mental disorder due to a general medical condition,65,22774,22709,338,273,398788,3.5693828607431146
lisinopril,Metastatic malignant neoplasm to liver,24,22774,22750,88,64,398997,5.055908091908091
lisinopril,Metastatic malignant neoplasm to vertebral column,1,22774,22773,5,4,399057,3.704650243709656
lisinopril,Micturition frequency decreased,2,22774,22772,11,9,399052,3.3679638471488116
lisinopril,Mitral Valve Prolapse Syndrome,19,22774,22755,78,59,399002,4.514861766081278
lisinopril,Monocyte count outside reference range,1,22774,22773,5,4,399057,3.704650243709656
lisinopril,Monoplegia,5,22774,22769,9,4,399057,10.292405365970302
lisinopril,Mucinous carcinoma of breast,1,22774,22773,6,5,399056,3.08720121781642
lisinopril,Mucosal discolouration,7,22774,22767,13,6,399055,9.976497697409544
lisinopril,Multiple Sclerosis,1,22774,22773,5,4,399057,3.704650243709656
lisinopril,Mycosis fungoides stage III,1,22774,22773,5,4,399057,3.704650243709656
lisinopril,Myelitis,1,22774,22773,5,4,399057,3.704650243709656
lisinopril,Myelomalacia,8,22774,22766,47,39,399022,3.1535492457023446
lisinopril,Myoglobin blood increased,8,22774,22766,12,4,399057,12.352426132536824
lisinopril,Nephritis,3,22774,22771,6,3,399058,9.262417109481358
lisinopril,"Nephritis, Tubulointerstitial",2,22774,22772,9,7,399054,4.116419774772138
lisinopril,Oesophageal irritation,3,22774,22771,18,15,399046,3.087384538813988
lisinopril,Open reduction of fracture,3,22774,22771,16,13,399048,3.4733240744806992
lisinopril,Operation on bone,6,22774,22768,24,18,399043,4.6316211349262115
lisinopril,Operation on gallbladder,3,22774,22771,17,14,399047,3.269003143833617
lisinopril,Oral Surgical Procedures,2,22774,22772,8,6,399055,4.630983225013174
lisinopril,Oral administration complication,1,22774,22773,5,4,399057,3.704650243709656
lisinopril,Oropharyngeal swelling,1,22774,22773,5,4,399057,3.704650243709656
lisinopril,Osteitis,3,22774,22771,6,3,399058,9.262417109481358
lisinopril,Pain in coccyx,4,22774,22770,5,1,399060,14.820553359683796
lisinopril,Pain of skin,2,22774,22772,7,5,399056,5.292564803894507
lisinopril,Pancreatectomy,1,22774,22773,6,5,399056,3.08720121781642
lisinopril,Pancreatic Ductal Adenocarcinoma,7,22774,22767,21,14,399047,6.1758100174228785
lisinopril,Pancreatic duct dilatation,1,22774,22773,5,4,399057,3.704650243709656
lisinopril,Pancreaticoduodenectomy,1,22774,22773,5,4,399057,3.704650243709656
lisinopril,Pancreatitis Necrotizing,2,22774,22772,7,5,399056,5.292564803894507
lisinopril,Parainfluenza Virus Infections,2,22774,22772,11,9,399052,3.3679638471488116
lisinopril,Paroxysmal nocturnal hemoglobinuria,1,22774,22773,5,4,399057,3.704650243709656
lisinopril,Partitioning of stomach using band,1,22774,22773,6,5,399056,3.08720121781642
lisinopril,Patient Non-Compliance,2,22774,22772,7,5,399056,5.292564803894507
lisinopril,Pelvic abscess,1,22774,22773,6,5,399056,3.08720121781642
lisinopril,Penile swelling,1,22774,22773,6,5,399056,3.08720121781642
lisinopril,Peptic ulcer helicobacter,1,22774,22773,5,4,399057,3.704650243709656
lisinopril,Perineal infection,3,22774,22771,13,10,399051,4.274890802403867
lisinopril,Peripheral nerve lesion,5,22774,22769,28,23,399038,3.308124141219578
lisinopril,Phonophobia,1,22774,22773,6,5,399056,3.08720121781642
lisinopril,Pili incarnati (disorder),3,22774,22771,18,15,399046,3.087384538813988
lisinopril,Piloerection,7,22774,22767,40,33,399028,3.2421542144331705
lisinopril,Pleural Tuberculosis,1,22774,22773,5,4,399057,3.704650243709656
lisinopril,Polyarthritis,5,22774,22769,25,20,399041,3.705125389784356
lisinopril,Polyp of vocal cord,4,22774,22770,15,11,399050,4.9400673400673405
lisinopril,Post-Traumatic Stress Disorder,1,22774,22773,5,4,399057,3.704650243709656
lisinopril,Postmenopausal bleeding,2,22774,22772,6,4,399057,6.174673575736284
lisinopril,Postoperative retention of urine,1,22774,22773,5,4,399057,3.704650243709656
lisinopril,Prescribed overdose,68,22774,22706,253,185,398876,4.99033634612432
lisinopril,Priapism,2,22774,22772,11,9,399052,3.3679638471488116
lisinopril,Product name confusion,1,22774,22773,6,5,399056,3.08720121781642
lisinopril,Prostate specific antigen above reference range,2,22774,22772,10,8,399053,3.704769014579308
lisinopril,Pruritus allergic,2,22774,22772,6,4,399057,6.174673575736284
lisinopril,Pruritus of genital organs,3,22774,22771,14,11,399050,3.969532048909327
lisinopril,Psychiatric symptom,2,22774,22772,7,5,399056,5.292564803894507
lisinopril,Psychomotor Impairment,5,22774,22769,27,22,399039,3.430655390776608
lisinopril,Psychomotor skills impaired,2,22774,22772,11,9,399052,3.3679638471488116
lisinopril,Pulmonary Edema,3,22774,22771,15,12,399049,3.7048877958807256
lisinopril,Pulmonary Fibrosis,4,22774,22770,24,20,399041,3.0874762113892547
lisinopril,Pulmonary Fistula,3,22774,22771,14,11,399050,3.969532048909327
lisinopril,Pulmonary Hypertension,9,22774,22765,44,35,399026,3.789827885709722
lisinopril,Puncture site induration,4,22774,22770,19,15,399046,3.900016180107713
lisinopril,Reaction to previous exposure to any vaccine,2,22774,22772,5,3,399058,7.409625856314773
lisinopril,Red blood cell morphology abnormal,7,22774,22767,32,25,399036,4.0527696336803265
lisinopril,Reflux laryngitis,3,22774,22771,16,13,399048,3.4733240744806992
lisinopril,Renal cancer metastatic,5,22774,22769,29,24,399037,3.194043322666481
lisinopril,Renin increased,2,22774,22772,5,3,399058,7.409625856314773
lisinopril,Repair of eyelid,4,22774,22770,10,6,399055,7.410188844971454
lisinopril,Respiratory fume inhalation disorder,2,22774,22772,5,3,399058,7.409625856314773
lisinopril,Respiratory tract infection viral,3,22774,22771,6,3,399058,9.262417109481358
lisinopril,Retinal Degeneration,1,22774,22773,5,4,399057,3.704650243709656
lisinopril,Retinal vascular thrombosis,2,22774,22772,8,6,399055,4.630983225013174
lisinopril,Rheumatoid Arthritis,11,22774,22763,47,36,399025,4.336701683676664
lisinopril,Rheumatoid Factor Measurement,1,22774,22773,6,5,399056,3.08720121781642
lisinopril,Rhinalgia,4,22774,22770,23,19,399042,3.221721945351435
lisinopril,Sarcoma,1,22774,22773,5,4,399057,3.704650243709656
lisinopril,Schnitzler Syndrome,1,22774,22773,6,5,399056,3.08720121781642
lisinopril,Secretion discharge,1,22774,22773,5,4,399057,3.704650243709656
lisinopril,Self Medication,1,22774,22773,6,5,399056,3.08720121781642
lisinopril,Senile purpura,1,22774,22773,6,5,399056,3.08720121781642
lisinopril,"Shock, Traumatic",2,22774,22772,6,4,399057,6.174673575736284
lisinopril,Sinoatrial Block,4,22774,22770,19,15,399046,3.900016180107713
lisinopril,Sinus operation,3,22774,22771,9,6,399055,6.174900824147673
lisinopril,Skin discomfort,4,22774,22770,16,12,399049,4.631302151954325
lisinopril,Skin lesion,5,22774,22769,28,23,399038,3.308124141219578
lisinopril,Skin neoplasm bleeding,5,22774,22769,16,11,399050,5.789381944749439
lisinopril,"Skull Fracture, Basilar",1,22774,22773,5,4,399057,3.704650243709656
lisinopril,"Sleep Disorders, Circadian Rhythm",3,22774,22771,13,10,399051,4.274890802403867
lisinopril,Slow respiration,3,22774,22771,8,5,399056,6.946779895481094
lisinopril,Small cell lung cancer extensive stage,2,22774,22772,8,6,399055,4.630983225013174
lisinopril,Somnambulism,3,22774,22771,16,13,399048,3.4733240744806992
lisinopril,Speech Disorders,3,22774,22771,15,12,399049,3.7048877958807256
lisinopril,Spermatozoa abnormal,1,22774,22773,6,5,399056,3.08720121781642
lisinopril,Spinal Cord Neoplasms,4,22774,22770,8,4,399057,9.262779973649538
lisinopril,Spinal stenosis of lumbar region,3,22774,22771,9,6,399055,6.174900824147673
lisinopril,Splenic vein thrombosis,1,22774,22773,6,5,399056,3.08720121781642
lisinopril,Sputum retention,3,22774,22771,8,5,399056,6.946779895481094
lisinopril,Status Epilepticus,3,22774,22771,7,4,399057,7.939195844338349
lisinopril,Stent-graft endoleak,1,22774,22773,6,5,399056,3.08720121781642
lisinopril,Stricture of artery,16,22774,22758,97,81,398980,3.0567286636714583
lisinopril,Sudden onset of sleep,6,22774,22768,29,23,399038,3.8330203310150965
lisinopril,Suicidal behavior,2,22774,22772,7,5,399056,5.292564803894507
lisinopril,Superficial injury of eye,3,22774,22771,17,14,399047,3.269003143833617
lisinopril,Surgical procedure on eye proper,2,22774,22772,12,10,399051,3.0872928742900636
lisinopril,Swelling at injection site,8,22774,22766,40,32,399029,3.705481858912414
lisinopril,Talipes,3,22774,22771,8,5,399056,6.946779895481094
lisinopril,Tenalgia,4,22774,22770,19,15,399046,3.900016180107713
lisinopril,Tendon Injuries,4,22774,22770,19,15,399046,3.900016180107713
lisinopril,Therapeutic response unexpected,1,22774,22773,6,5,399056,3.08720121781642
lisinopril,Tongue Diseases,70,22774,22704,428,358,398703,3.035663566220782
lisinopril,Troponin I increased,7,22774,22767,35,28,399033,3.705363025431546
lisinopril,Tumor necrosis,1,22774,22773,6,5,399056,3.08720121781642
lisinopril,Tumour ulceration,2,22774,22772,7,5,399056,5.292564803894507
lisinopril,Ulcer of esophagus,2,22774,22772,11,9,399052,3.3679638471488116
lisinopril,Ulcer of pharynx,2,22774,22772,11,9,399052,3.3679638471488116
lisinopril,Underweight,2,22774,22772,10,8,399053,3.704769014579308
lisinopril,Unevaluable event,2,22774,22772,10,8,399053,3.704769014579308
lisinopril,Upper abdominal pain,4,22774,22770,16,12,399049,4.631302151954325
lisinopril,Urgency of micturition,6,22774,22768,29,23,399038,3.8330203310150965
lisinopril,Urine alcohol test positive,5,22774,22769,18,13,399048,5.146092884575031
lisinopril,Uterine Cancer,1,22774,22773,5,4,399057,3.704650243709656
lisinopril,Vaginal Hemorrhage,11,22774,22763,51,40,399021,3.996530317086638
lisinopril,Vascular System Injuries,1,22774,22773,5,4,399057,3.704650243709656
lisinopril,Ventricular hypertrophy,7,22774,22767,26,19,399042,4.988095117427045
lisinopril,Vitamin B6 decreased,3,22774,22771,8,5,399056,6.946779895481094
lisinopril,Vocal Cord Paralysis,3,22774,22771,8,5,399056,6.946779895481094
lisinopril,Vulvovaginal pruritus,4,22774,22770,22,18,399043,3.3681718369465408
lisinopril,Walking disability,1,22774,22773,6,5,399056,3.08720121781642
lisinopril,Wide QRS complex,3,22774,22771,15,12,399049,3.7048877958807256
lisinopril,Winged scapula,2,22774,22772,5,3,399058,7.409625856314773
lisinopril,Wound discharge finding,4,22774,22770,11,7,399054,6.736519343633968
lisinopril,X-ray of pelvis and hip abnormal,2,22774,22772,9,7,399054,4.116419774772138
lisinopril,bite injury,329,22774,22445,1079,750,398311,5.715907095317542
lisinopril,c-ANCA positive,5,22774,22769,29,24,399037,3.194043322666481
lisinopril,muscle injury,18,22774,22756,106,88,398973,3.147053897458518
losartan,Abnormal urine,2,17043,17041,11,9,404783,4.5006321652058405
losartan,Abruptio Placentae,2,17043,17041,14,12,404780,3.536185837517919
losartan,Abscess bacterial,1,17043,17042,6,5,404787,4.125386300512459
losartan,Absent response to treatment,1,17043,17042,5,4,404788,4.950475296326723
losartan,Accident while engaged in work-related activity,1,17043,17042,8,7,404785,3.094025055744631
losartan,Achromia of skin,3,17043,17040,23,20,404772,3.2288120024494793
losartan,Acquired hemophilia,1,17043,17042,8,7,404785,3.094025055744631
losartan,Acquired ventricular septal defect,1,17043,17042,5,4,404788,4.950475296326723
losartan,Acrochordon excision,6,17043,17037,47,41,404751,3.160490496903485
losartan,Actinic keratosis,4,17043,17039,22,18,404774,4.501043061639341
losartan,Acute osteomyelitis,1,17043,17042,8,7,404785,3.094025055744631
losartan,"Adenocarcinoma of lung, stage I",1,17043,17042,5,4,404788,4.950475296326723
losartan,Amaurosis,1,17043,17042,5,4,404788,4.950475296326723
losartan,Amputation of hand (procedure),1,17043,17042,6,5,404787,4.125386300512459
losartan,"Angina Pectoris, Variant",4,17043,17039,31,27,404765,3.194220469548985
losartan,Angioplasty renal artery,2,17043,17041,13,11,404781,3.8082091607119484
losartan,Ankylosing spondylitis,3,17043,17040,13,10,404782,5.712648970747562
losartan,Anorectal Diseases,2,17043,17041,13,11,404781,3.8082091607119484
losartan,Appendicitis,15,17043,17028,104,89,404703,3.5721509595056102
losartan,Application site discolouration,2,17043,17041,7,5,404787,7.072489039040297
losartan,Application site edema,2,17043,17041,11,9,404783,4.5006321652058405
losartan,Application site rash,4,17043,17039,28,24,404768,3.5364835293821733
losartan,Application site reaction,2,17043,17041,16,14,404778,3.0941479373276217
losartan,Arnold Chiari Malformation,3,17043,17040,17,14,404778,4.368454846727424
losartan,Arthroscopy,4,17043,17039,23,19,404773,4.305335330456727
losartan,Aspartate aminotransferase abnormal,1,17043,17042,6,5,404787,4.125386300512459
losartan,Atrial Premature Complexes,1,17043,17042,5,4,404788,4.950475296326723
losartan,Benign Prostatic Hyperplasia,2,17043,17041,13,11,404781,3.8082091607119484
losartan,Benign mucous membrane pemphigoid with ocular involvement,2,17043,17041,6,4,404788,8.25125677288109
losartan,Biliary Tract Surgical Procedures,1,17043,17042,5,4,404788,4.950475296326723
losartan,Biopsy lymph gland abnormal,3,17043,17040,9,6,404786,8.251682316118936
losartan,Bladder hemorrhage,2,17043,17041,7,5,404787,7.072489039040297
losartan,Bleeding esophageal varices,1,17043,17042,8,7,404785,3.094025055744631
losartan,Bleeding ulcer,5,17043,17038,30,25,404767,4.126120045388738
losartan,Blood 25-hydroxycholecalciferol decreased,8,17043,17035,59,51,404741,3.3572037629407054
losartan,Blood blister,1,17043,17042,6,5,404787,4.125386300512459
losartan,Blood lactate dehydrogenase increased,3,17043,17040,22,19,404773,3.3755841869398204
losartan,Blood lactic acid,2,17043,17041,8,6,404786,6.188413238659703
losartan,Blood parathyroid hormone decreased,1,17043,17042,5,4,404788,4.950475296326723
losartan,Blood pressure orthostatic decreased,1,17043,17042,5,4,404788,4.950475296326723
losartan,Body fat disorder,1,17043,17042,5,4,404788,4.950475296326723
losartan,Brachial radiculitis,1,17043,17042,8,7,404785,3.094025055744631
losartan,Breast cancer stage III,1,17043,17042,8,7,404785,3.094025055744631
losartan,Breast hyperplasia,1,17043,17042,8,7,404785,3.094025055744631
losartan,Bromhidrosis,1,17043,17042,7,6,404786,3.536037017787986
losartan,Bronchopulmonary disease,1,17043,17042,5,4,404788,4.950475296326723
losartan,Bullous Dermatitis,1,17043,17042,8,7,404785,3.094025055744631
losartan,CSF test abnormal,1,17043,17042,6,5,404787,4.125386300512459
losartan,Candida sepsis,2,17043,17041,11,9,404783,4.5006321652058405
losartan,Carbohydrate antigen 15-3 increased,1,17043,17042,7,6,404786,3.536037017787986
losartan,Cardiac neoplasm unspecified,2,17043,17041,15,13,404779,3.30043229074976
losartan,Carotid artery occlusion,1,17043,17042,7,6,404786,3.536037017787986
losartan,Catheter site mass,5,17043,17038,5,0,404792,24.758187580701957
losartan,Celiac Disease,1,17043,17042,6,5,404787,4.125386300512459
losartan,Cerebral Arteriosclerosis,2,17043,17041,13,11,404781,3.8082091607119484
losartan,Cerebral arterial thrombosis,4,17043,17039,10,6,404786,9.902576442279477
losartan,Cerebral cyst,8,17043,17035,52,44,404748,3.809198256982232
losartan,Cerebral ventricle dilatation,1,17043,17042,6,5,404787,4.125386300512459
losartan,Cerebrovascular Disorders,1,17043,17042,5,4,404788,4.950475296326723
losartan,Cerebrovascular Insufficiency,2,17043,17041,16,14,404778,3.0941479373276217
losartan,Cervical abscess,1,17043,17042,5,4,404788,4.950475296326723
losartan,Cheilitis,6,17043,17037,46,40,404752,3.229204468024836
losartan,Chronic glomerulonephritis,1,17043,17042,7,6,404786,3.536037017787986
losartan,Colonic Neoplasms,3,17043,17040,23,20,404772,3.2288120024494793
losartan,Colonoscopy abnormal,1,17043,17042,8,7,404785,3.094025055744631
losartan,Complex Regional Pain Syndromes,2,17043,17041,9,7,404785,5.500798727252573
losartan,Continuous hemodiafiltration,1,17043,17042,7,6,404786,3.536037017787986
losartan,Contracture,1,17043,17042,6,5,404787,4.125386300512459
losartan,Crystal Arthropathies,3,17043,17040,9,6,404786,8.251682316118936
losartan,Cyanosis,4,17043,17039,11,7,404785,9.002320878839454
losartan,Cyst of thyroid,1,17043,17042,8,7,404785,3.094025055744631
losartan,Cytokine Release Syndrome,1,17043,17042,8,7,404785,3.094025055744631
losartan,Cytokine Storm,1,17043,17042,7,6,404786,3.536037017787986
losartan,Dark circles under eyes,6,17043,17037,24,18,404774,6.189631390503022
losartan,Deafness,2,17043,17041,13,11,404781,3.8082091607119484
losartan,Decreased therapeutic response,1,17043,17042,8,7,404785,3.094025055744631
losartan,Decreased thyroxine level,7,17043,17036,40,33,404759,4.332831944118338
losartan,Deficiency of testosterone biosynthesis,1,17043,17042,5,4,404788,4.950475296326723
losartan,Deformity of knee joint,5,17043,17038,41,36,404756,3.019033494713395
losartan,Dentin Sensitivity,5,17043,17038,28,23,404769,4.420863867321785
losartan,Dermatologic disorders,5,17043,17038,34,29,404763,3.6406596327931338
losartan,Device malfunction,59,17043,16984,428,369,404423,3.4203457294606023
losartan,Diabetes mellitus inadequate control,1,17043,17042,8,7,404785,3.094025055744631
losartan,Diabetic Neuropathies,1,17043,17042,6,5,404787,4.125386300512459
losartan,Dilatation of pulmonary artery (disorder),1,17043,17042,7,6,404786,3.536037017787986
losartan,Diplopia,1,17043,17042,7,6,404786,3.536037017787986
losartan,Discharge from eye,3,17043,17040,24,21,404771,3.0942708333333333
losartan,Disease Progression,8,17043,17035,47,39,404753,4.214482073827976
losartan,Disorder of vein,18,17043,17025,99,81,404711,4.50392203978107
losartan,"Disruptive, Impulse Control, and Conduct Disorders",7,17043,17036,56,49,404743,3.0947625616341865
losartan,Dizziness,6,17043,17037,25,19,404773,5.942032047895756
losartan,Documented hypersensitivity to administered drug,1,17043,17042,5,4,404788,4.950475296326723
losartan,Drug action increased,9,17043,17034,52,43,404749,4.285599615249139
losartan,Drug resistance,3,17043,17040,11,8,404784,6.751344430217669
losartan,Drug screen false positive,1,17043,17042,5,4,404788,4.950475296326723
losartan,Dysesthesia,1,17043,17042,7,6,404786,3.536037017787986
losartan,Dysgraphia,37,17043,17006,248,211,404581,3.6985805294526033
losartan,Dyslipidemias,2,17043,17041,11,9,404783,4.5006321652058405
losartan,Ear discharge,2,17043,17041,16,14,404778,3.0941479373276217
losartan,Edema of eyelid,3,17043,17040,14,11,404781,5.3045900402414485
losartan,Electrocardiogram QT borderline prolonged,1,17043,17042,7,6,404786,3.536037017787986
losartan,Electrocardiogram R on T phenomenon,2,17043,17041,13,11,404781,3.8082091607119484
losartan,Encopresis (finding),2,17043,17041,7,5,404787,7.072489039040297
losartan,Erythema Nodosum,1,17043,17042,6,5,404787,4.125386300512459
losartan,Erythrocyte sedimentation rate raised,2,17043,17041,6,4,404788,8.25125677288109
losartan,Erythropenia,1,17043,17042,8,7,404785,3.094025055744631
losartan,Exfoliative dermatitis,1,17043,17042,5,4,404788,4.950475296326723
losartan,Extraction of wisdom tooth,2,17043,17041,13,11,404781,3.8082091607119484
losartan,Extravasation,3,17043,17040,19,16,404776,3.9085989621942177
losartan,Eye Infection,4,17043,17039,29,25,404767,3.4145277264531066
losartan,Eye allergy,3,17043,17040,11,8,404784,6.751344430217669
losartan,Facet joint pain,3,17043,17040,24,21,404771,3.0942708333333333
losartan,"Fasciitis, Plantar",2,17043,17041,8,6,404786,6.188413238659703
losartan,Febrile infection,2,17043,17041,16,14,404778,3.0941479373276217
losartan,Feeding Disorders,1,17043,17042,5,4,404788,4.950475296326723
losartan,Fetal Growth Retardation,4,17043,17039,13,9,404783,7.617312319700958
losartan,Flail Chest,1,17043,17042,8,7,404785,3.094025055744631
losartan,Flatulence,15,17043,17028,121,106,404686,3.070154747552403
losartan,Foaming at mouth,4,17043,17039,30,26,404766,3.300702310385977
losartan,Focal Infection,3,17043,17040,13,10,404782,5.712648970747562
losartan,Focal glomerulosclerosis,1,17043,17042,7,6,404786,3.536037017787986
losartan,Folic Acid Deficiency,3,17043,17040,15,12,404780,4.950938967136151
losartan,Food intolerance (disorder),12,17043,17031,80,68,404724,3.714593975691386
losartan,"Fracture Fixation, Internal",2,17043,17041,16,14,404778,3.0941479373276217
losartan,Fracture of clavicle,2,17043,17041,9,7,404785,5.500798727252573
losartan,Freckles,1,17043,17042,5,4,404788,4.950475296326723
losartan,Fungal pneumonia,1,17043,17042,8,7,404785,3.094025055744631
losartan,Gastric hypermotility,1,17043,17042,7,6,404786,3.536037017787986
losartan,Gastrointestinal perforation,1,17043,17042,5,4,404788,4.950475296326723
losartan,Gastrooesophageal sphincter insufficiency,3,17043,17040,18,15,404777,4.1257531298904535
losartan,Gingival Diseases,2,17043,17041,15,13,404779,3.30043229074976
losartan,Globulin below reference range,2,17043,17041,9,7,404785,5.500798727252573
losartan,Glycosuria,1,17043,17042,8,7,404785,3.094025055744631
losartan,Good neonatal condition at birth,5,17043,17038,21,16,404776,5.8945829769870155
losartan,Graft versus host disease in liver,1,17043,17042,8,7,404785,3.094025055744631
losartan,Guilt,1,17043,17042,5,4,404788,4.950475296326723
losartan,Haematidrosis,2,17043,17041,11,9,404783,4.5006321652058405
losartan,Hair Diseases,2,17043,17041,10,8,404784,4.9507071181268705
losartan,Heart valve disease,2,17043,17041,9,7,404785,5.500798727252573
losartan,Hematemesis,5,17043,17038,40,35,404757,3.094516668623078
losartan,Hepatectomy,1,17043,17042,7,6,404786,3.536037017787986
losartan,Hepatic Veno-Occlusive Disease,1,17043,17042,6,5,404787,4.125386300512459
losartan,Hepatic calcification,2,17043,17041,9,7,404785,5.500798727252573
losartan,Hepatitis,1,17043,17042,6,5,404787,4.125386300512459
losartan,Hepatorenal Syndrome,2,17043,17041,12,10,404782,4.125569704438315
losartan,Hernia pain,3,17043,17040,13,10,404782,5.712648970747562
losartan,Hyperglycaemic seizure,1,17043,17042,8,7,404785,3.094025055744631
losartan,Hypertrophy of submaxillary gland,1,17043,17042,5,4,404788,4.950475296326723
losartan,Hypocholesterolemia,2,17043,17041,8,6,404786,6.188413238659703
losartan,Hypogammaglobulinemia,1,17043,17042,6,5,404787,4.125386300512459
losartan,Hypoglycemic seizures,1,17043,17042,5,4,404788,4.950475296326723
losartan,Hyporesponsive to stimuli,1,17043,17042,6,5,404787,4.125386300512459
losartan,Ileocolectomy,2,17043,17041,11,9,404783,4.5006321652058405
losartan,Immobile,1,17043,17042,5,4,404788,4.950475296326723
losartan,Impaired self-care,1,17043,17042,5,4,404788,4.950475296326723
losartan,Increased therapeutic response,5,17043,17038,11,6,404786,11.253561557587851
losartan,Infection causing abscess of colon,1,17043,17042,7,6,404786,3.536037017787986
losartan,Infection of uterus,1,17043,17042,5,4,404788,4.950475296326723
losartan,Infectious Lung Disorder,3,17043,17040,16,13,404779,4.641494278169014
losartan,Infiltrating duct carcinoma,1,17043,17042,6,5,404787,4.125386300512459
losartan,Inflammatory polyposis of intestine,1,17043,17042,5,4,404788,4.950475296326723
losartan,Infusion site erythema,2,17043,17041,8,6,404786,6.188413238659703
losartan,Infusion site thrombosis,1,17043,17042,6,5,404787,4.125386300512459
losartan,Inguinal pain,4,17043,17039,19,15,404777,5.211771138039358
losartan,Injury of gallbladder,1,17043,17042,5,4,404788,4.950475296326723
losartan,Injury of pharynx,1,17043,17042,6,5,404787,4.125386300512459
losartan,Insulin-like growth factor increased,1,17043,17042,5,4,404788,4.950475296326723
losartan,Intentional underdose,6,17043,17037,10,4,404788,14.855608381757351
losartan,Intestinal Volvulus,3,17043,17040,24,21,404771,3.0942708333333333
losartan,Intraductal papilloma of breast,1,17043,17042,6,5,404787,4.125386300512459
losartan,Involuntary muscle contraction,7,17043,17036,52,45,404747,3.3328528274965232
losartan,Lacrimation decreased,2,17043,17041,12,10,404782,4.125569704438315
losartan,Legionnaires' Disease,1,17043,17042,7,6,404786,3.536037017787986
losartan,Leukostasis,1,17043,17042,6,5,404787,4.125386300512459
losartan,Lichen Planus,4,17043,17039,21,17,404775,4.715389624363155
losartan,Lip haemorrhage,1,17043,17042,7,6,404786,3.536037017787986
losartan,Lipid above reference range,3,17043,17040,20,17,404775,3.7131602112676054
losartan,Lyme Disease,6,17043,17037,48,42,404750,3.094639607912191
losartan,Malaria,1,17043,17042,6,5,404787,4.125386300512459
losartan,Malignant Bone Neoplasm,6,17043,17037,33,27,404765,4.5014540545443875
losartan,Malignant Vaginal Neoplasm,1,17043,17042,8,7,404785,3.094025055744631
losartan,Malignant neoplasm of female breast,2,17043,17041,9,7,404785,5.500798727252573
losartan,Malignant neoplasm of gallbladder,1,17043,17042,5,4,404788,4.950475296326723
losartan,Malignant neoplasm of kidney,1,17043,17042,5,4,404788,4.950475296326723
losartan,Malignant neoplasm of stomach,1,17043,17042,6,5,404787,4.125386300512459
losartan,Malignant tumor of parathyroid gland,1,17043,17042,7,6,404786,3.536037017787986
losartan,Manipulation of joint - non-surgical,1,17043,17042,7,6,404786,3.536037017787986
losartan,"Mastocytosis, Systemic",1,17043,17042,6,5,404787,4.125386300512459
losartan,Medical device removal,1,17043,17042,7,6,404786,3.536037017787986
losartan,Memory impairment,10,17043,17033,77,67,404725,3.2157439226070705
losartan,Mental status changes postoperative,1,17043,17042,8,7,404785,3.094025055744631
losartan,Mesenteric vascular insufficiency,1,17043,17042,7,6,404786,3.536037017787986
losartan,Metastases to abdominal cavity,2,17043,17041,10,8,404784,4.9507071181268705
losartan,Metastatic malignant neoplasm to bone,5,17043,17038,25,20,404772,4.951402746801268
losartan,Middle insomnia,24,17043,17019,156,132,404660,3.811839256577491
losartan,Mixed liver injury,1,17043,17042,7,6,404786,3.536037017787986
losartan,Mucosal discolouration,2,17043,17041,13,11,404781,3.8082091607119484
losartan,Muscle Fatigue,1,17043,17042,8,7,404785,3.094025055744631
losartan,Mycobacterial peritonitis,2,17043,17041,6,4,404788,8.25125677288109
losartan,Nail discomfort,1,17043,17042,8,7,404785,3.094025055744631
losartan,Nasal Polyp,4,17043,17039,26,22,404770,3.8085387820700927
losartan,Needle issue,11,17043,17032,59,48,404744,4.616968259149278
losartan,Neonatal Abstinence Syndrome,3,17043,17040,24,21,404771,3.0942708333333333
losartan,Nephrotic Syndrome,3,17043,17040,5,2,404790,14.853169014084507
losartan,Nicotine Dependence,3,17043,17040,20,17,404775,3.7131602112676054
losartan,Nocturnal dyspnea,1,17043,17042,7,6,404786,3.536037017787986
losartan,Noncompliance with dietary regimen,1,17043,17042,6,5,404787,4.125386300512459
losartan,Obstruction of salivary duct,1,17043,17042,8,7,404785,3.094025055744631
losartan,Operation on eyelid,1,17043,17042,7,6,404786,3.536037017787986
losartan,Operation on urinary bladder,1,17043,17042,5,4,404788,4.950475296326723
losartan,Optic Atrophy,14,17043,17029,94,80,404712,3.6885600658701114
losartan,Oral infection,7,17043,17036,43,36,404756,4.030512676302441
losartan,Oral mucosal erythema,3,17043,17040,24,21,404771,3.0942708333333333
losartan,Oral pain,5,17043,17038,39,34,404758,3.1738707745281283
losartan,Organizing Pneumonia,1,17043,17042,5,4,404788,4.950475296326723
losartan,Orgasmic Disorder,1,17043,17042,7,6,404786,3.536037017787986
losartan,Pancreatic enlargement,2,17043,17041,13,11,404781,3.8082091607119484
losartan,Papillary thyroid carcinoma,2,17043,17041,15,13,404779,3.30043229074976
losartan,Parainfluenza Virus Infections,3,17043,17040,11,8,404784,6.751344430217669
losartan,Paranasal sinus discomfort,1,17043,17042,7,6,404786,3.536037017787986
losartan,Parasite infestation,1,17043,17042,8,7,404785,3.094025055744631
losartan,Patient Non-Compliance,1,17043,17042,7,6,404786,3.536037017787986
losartan,Peptostreptococcus infection,1,17043,17042,6,5,404787,4.125386300512459
losartan,Percutaneous Coronary Intervention,1,17043,17042,6,5,404787,4.125386300512459
losartan,Performance status decreased,4,17043,17039,25,21,404771,3.960889723575327
losartan,Periodontal Diseases,1,17043,17042,6,5,404787,4.125386300512459
losartan,Peripheral Vascular Diseases,4,17043,17039,28,24,404768,3.5364835293821733
losartan,Peripheral artery restenosis,1,17043,17042,5,4,404788,4.950475296326723
losartan,Placental Insufficiency,2,17043,17041,15,13,404779,3.30043229074976
losartan,Pleural Tuberculosis,1,17043,17042,5,4,404788,4.950475296326723
losartan,Pleural infection bacterial,2,17043,17041,8,6,404786,6.188413238659703
losartan,Polymyalgia Rheumatica,6,17043,17037,43,37,404755,3.4545223733297292
losartan,Polypharmacy,2,17043,17041,16,14,404778,3.0941479373276217
losartan,Post procedural hemorrhage,1,17043,17042,8,7,404785,3.094025055744631
losartan,Post-Concussion Syndrome,4,17043,17039,31,27,404765,3.194220469548985
losartan,Post-traumatic neck syndrome,2,17043,17041,5,3,404789,9.9015316002582
losartan,Potentiating drug interaction,3,17043,17040,11,8,404784,6.751344430217669
losartan,Pre-Eclampsia,1,17043,17042,6,5,404787,4.125386300512459
losartan,Premature Cardiac Complex,3,17043,17040,14,11,404781,5.3045900402414485
losartan,Premature infant,4,17043,17039,20,16,404776,4.951170843359352
losartan,Prosthesis Implantation,1,17043,17042,8,7,404785,3.094025055744631
losartan,Pulmonary function test decreased,3,17043,17040,22,19,404773,3.3755841869398204
losartan,Pulmonary vasculitis,1,17043,17042,5,4,404788,4.950475296326723
losartan,Pupillary light reflex tests abnormal,2,17043,17041,9,7,404785,5.500798727252573
losartan,Pure Red-Cell Aplasia,3,17043,17040,23,20,404772,3.2288120024494793
losartan,Pustular rash,3,17043,17040,13,10,404782,5.712648970747562
losartan,Raised jugular venous pressure,11,17043,17032,51,40,404752,5.341299883034473
losartan,Reaction to colouring,1,17043,17042,7,6,404786,3.536037017787986
losartan,Reduced fluid intake,1,17043,17042,8,7,404785,3.094025055744631
losartan,Reflux laryngitis,4,17043,17039,16,12,404780,6.189022243089383
losartan,Renal dysplasia,1,17043,17042,6,5,404787,4.125386300512459
losartan,Renal transplant rejection,7,17043,17036,55,48,404744,3.1510384426561933
losartan,Respiratory arrest,9,17043,17034,68,59,404733,3.2770989163541433
losartan,Respiratory tract infection bacterial,6,17043,17037,14,8,404784,10.61104822277564
losartan,Reticulocyte count increased,1,17043,17042,6,5,404787,4.125386300512459
losartan,Rheumatoid factor increased,1,17043,17042,7,6,404786,3.536037017787986
losartan,Rheumatoid lung disease,16,17043,17027,85,69,404723,4.66249106091018
losartan,Ridged nails,6,17043,17037,14,8,404784,10.61104822277564
losartan,Ruptured cyst of kidney,1,17043,17042,5,4,404788,4.950475296326723
losartan,Salt craving,17,17043,17026,130,113,404679,3.2389309562750186
losartan,Scratch marks,1,17043,17042,8,7,404785,3.094025055744631
losartan,Secondary hypoparathyroidism,1,17043,17042,8,7,404785,3.094025055744631
losartan,Secretion discharge,1,17043,17042,5,4,404788,4.950475296326723
losartan,Self Medication,1,17043,17042,6,5,404787,4.125386300512459
losartan,Sensory disorder of eyelid,1,17043,17042,8,7,404785,3.094025055744631
losartan,Sialorrhea,1,17043,17042,8,7,404785,3.094025055744631
losartan,Skin Wrinkling,10,17043,17033,81,71,404721,3.056912761212258
losartan,Slow respiration,1,17043,17042,8,7,404785,3.094025055744631
losartan,Sluggishness,3,17043,17040,21,18,404774,3.536334674714956
losartan,Small bowel angioedema,3,17043,17040,21,18,404774,3.536334674714956
losartan,Snoring,2,17043,17041,15,13,404779,3.30043229074976
losartan,Soft stool (finding),2,17043,17041,8,6,404786,6.188413238659703
losartan,Somnambulism,2,17043,17041,16,14,404778,3.0941479373276217
losartan,Spinal cord herniation,11,17043,17032,89,78,404714,3.060469123553285
losartan,Spontaneous pneumothorax,1,17043,17042,6,5,404787,4.125386300512459
losartan,Sprain of ligament,1,17043,17042,8,7,404785,3.094025055744631
losartan,Stage IV Lung Cancer AJCC v7,2,17043,17041,9,7,404785,5.500798727252573
losartan,Stem cell transplant,1,17043,17042,6,5,404787,4.125386300512459
losartan,Stent-graft endoleak,1,17043,17042,6,5,404787,4.125386300512459
losartan,Streptococcal Infections,1,17043,17042,6,5,404787,4.125386300512459
losartan,Suicidal behavior,2,17043,17041,7,5,404787,7.072489039040297
losartan,Suture rupture,6,17043,17037,34,28,404764,4.369047988979005
losartan,Systemic Scleroderma,4,17043,17039,16,12,404780,6.189022243089383
losartan,"Tachycardia, Paroxysmal",3,17043,17040,24,21,404771,3.0942708333333333
losartan,Takotsubo Cardiomyopathy,1,17043,17042,6,5,404787,4.125386300512459
losartan,Tardive Dyskinesia,1,17043,17042,7,6,404786,3.536037017787986
losartan,Testicular Hematocele,2,17043,17041,15,13,404779,3.30043229074976
losartan,Thalamic infarction,1,17043,17042,6,5,404787,4.125386300512459
losartan,Thiamine Deficiency,2,17043,17041,11,9,404783,4.5006321652058405
losartan,Thrombosis of subclavian vein,2,17043,17041,7,5,404787,7.072489039040297
losartan,Tongue swelling,1,17043,17042,7,6,404786,3.536037017787986
losartan,Tonic-Clonic Epilepsy,2,17043,17041,7,5,404787,7.072489039040297
losartan,Tooth Diseases,3,17043,17040,19,16,404776,3.9085989621942177
losartan,Toxic Epidermal Necrolysis,1,17043,17042,8,7,404785,3.094025055744631
losartan,Toxic leukocyte granulations,1,17043,17042,5,4,404788,4.950475296326723
losartan,Toxicity to various agents,1,17043,17042,5,4,404788,4.950475296326723
losartan,Traumatic amputation of limb,6,17043,17037,24,18,404774,6.189631390503022
losartan,Traumatic hemorrhage,1,17043,17042,5,4,404788,4.950475296326723
losartan,Traumatic subcutaneous emphysema,4,17043,17039,8,4,404788,12.37827924173954
losartan,Trichorrhexis,8,17043,17035,33,25,404767,6.002643399062537
losartan,Troponin increased,6,17043,17037,35,29,404763,4.244207984303071
losartan,Tubular breast cancer stage I,1,17043,17042,8,7,404785,3.094025055744631
losartan,Ulcer of pharynx,3,17043,17040,11,8,404784,6.751344430217669
losartan,Ulcerative esophagitis,1,17043,17042,6,5,404787,4.125386300512459
losartan,Ulcerative gingivitis,1,17043,17042,5,4,404788,4.950475296326723
losartan,Ulcerative proctitis (disorder),1,17043,17042,6,5,404787,4.125386300512459
losartan,Upper abdominal pain,2,17043,17041,16,14,404778,3.0941479373276217
losartan,Urgency of micturition,5,17043,17038,29,24,404768,4.268410166321934
losartan,Urinary casts present,2,17043,17041,6,4,404788,8.25125677288109
losartan,Urine albumin/creatinine ratio increased,2,17043,17041,13,11,404781,3.8082091607119484
losartan,Urine alcohol test positive,3,17043,17040,18,15,404777,4.1257531298904535
losartan,Urine ketone body present,1,17043,17042,5,4,404788,4.950475296326723
losartan,Urine output increased,3,17043,17040,13,10,404782,5.712648970747562
losartan,Urologic Diseases,13,17043,17030,96,83,404709,3.353522582697201
losartan,Uterine Diseases,2,17043,17041,8,6,404786,6.188413238659703
losartan,Vaccination site pain,1,17043,17042,6,5,404787,4.125386300512459
losartan,Vaginal Discharge,5,17043,17038,38,33,404759,3.2574014123229187
losartan,Vascular pain,3,17043,17040,11,8,404784,6.751344430217669
losartan,Very low density lipoprotein decreased,2,17043,17041,13,11,404781,3.8082091607119484
losartan,Viral test positive,10,17043,17033,65,55,404737,3.8095281105907537
losartan,Vulvovaginal dryness,5,17043,17038,39,34,404758,3.1738707745281283
losartan,Wrong technique in drug usage process,6,17043,17037,48,42,404750,3.094639607912191
losartan,leukemia,5,17043,17038,41,36,404756,3.019033494713395
methyldopa,Abnormal behavior,1,401,400,59,58,421376,17.87186440677966
methyldopa,Abnormal feces,1,401,400,243,242,421192,4.337366255144033
methyldopa,Abnormal glomerular filtration rate,1,401,400,30,29,421405,35.150416666666665
methyldopa,Abnormal heart beat,2,401,399,43,41,421393,49.168502651978784
methyldopa,Accessory nipple,2,401,399,6,4,421430,352.4051796157059
methyldopa,Acidosis,1,401,400,157,156,421278,6.714617834394905
methyldopa,Acute respiratory failure,1,401,400,20,19,421415,52.726875
methyldopa,Adrenal Cortical Adenoma,1,401,400,35,34,421400,30.128571428571426
methyldopa,Adverse reaction to drug,3,401,398,498,495,420939,6.377323363806987
methyldopa,Age related macular degeneration,3,401,398,915,912,420522,3.4675014416344014
methyldopa,Alanine Aminotransferase Increased,9,401,392,188,179,421255,51.49293041684759
methyldopa,"Anemia, Pernicious",1,401,400,91,90,421344,11.586373626373627
methyldopa,Anti-glomerular basement membrane antibody positive,1,401,400,329,328,421106,3.2029331306990882
methyldopa,Arthralgia,1,401,400,118,117,421317,8.93468220338983
methyldopa,"Arthritis, Psoriatic",1,401,400,7,6,421428,150.65285714285713
methyldopa,Asterixis,1,401,400,6,5,421429,175.76208333333332
methyldopa,Atrophy of cerebellum,1,401,400,5,4,421430,210.915
methyldopa,Axonal neuropathy,1,401,400,111,110,421324,9.498288288288288
methyldopa,Balanitis,4,401,397,83,79,421355,51.19747503869382
methyldopa,Bifascicular block,1,401,400,210,209,421225,5.019345238095238
methyldopa,Bleeding from anus,1,401,400,33,32,421402,31.95469696969697
methyldopa,Blister of lip,1,401,400,22,21,421413,47.93329545454545
methyldopa,Blood Platelet Disorders,1,401,400,40,39,421395,26.3621875
methyldopa,Blood creatine phosphokinase MB increased,1,401,400,61,60,421374,17.285819672131147
methyldopa,Blood sodium decreased,1,401,400,335,334,421100,3.145522388059702
methyldopa,Blunted affect,1,401,400,102,101,421333,10.336593137254903
methyldopa,Carcinoma in situ of rectum,2,401,399,95,93,421341,22.252473288484367
methyldopa,Cardiac septal hypertrophy,2,401,399,14,12,421422,151.0279269602578
methyldopa,Cerebral Thrombosis,1,401,400,325,324,421110,3.2423846153846156
methyldopa,Cerebral venous sinus thrombosis,1,401,400,222,221,421213,4.747894144144144
methyldopa,Chest discomfort,1,401,400,347,346,421088,3.0366570605187317
methyldopa,Cholecystectomy procedure,1,401,400,187,186,421248,5.637005347593583
methyldopa,Colitis,1,401,400,175,174,421260,6.023714285714286
methyldopa,Colorectal Carcinoma,2,401,399,159,157,421277,13.293485285540896
methyldopa,Congenital anomaly of central nervous system,2,401,399,648,646,420788,3.2580448033664404
methyldopa,Congenital atresia of aorta,3,401,398,125,122,421312,25.429748743718594
methyldopa,Congenital choroid plexus cyst,1,401,400,15,14,421420,70.30333333333333
methyldopa,Constipation,1,401,400,178,177,421257,5.922148876404494
methyldopa,Contracture,1,401,400,6,5,421429,175.76208333333332
methyldopa,Coronary Aneurysm,3,401,398,11,8,421426,289.0525354042942
methyldopa,Coronary Artery Vasospasm,2,401,399,14,12,421422,151.0279269602578
methyldopa,Craniocerebral Trauma,1,401,400,305,304,421130,3.4551639344262295
methyldopa,Cyst of tongue,2,401,399,6,4,421430,352.4051796157059
methyldopa,De Quervain Disease,2,401,399,175,173,421261,12.077622627998567
methyldopa,Decreased platelet count,1,401,400,245,244,421190,4.301938775510204
methyldopa,Dengue Fever,1,401,400,66,65,421369,15.976098484848485
methyldopa,Depressed mood,1,401,400,174,173,421261,6.058347701149425
methyldopa,Device difficult to use,1,401,400,56,55,421379,18.829419642857143
methyldopa,Dilatation of aorta,2,401,399,308,306,421128,6.860121081925594
methyldopa,Dislocations,1,401,400,127,126,421308,8.301338582677165
methyldopa,Disorder of vein,1,401,400,99,98,421336,10.649898989898992
methyldopa,Disseminated Intravascular Coagulation,1,401,400,42,41,421393,25.106726190476188
methyldopa,Double kidney (disorder),2,401,399,7,5,421429,302.0608664518439
methyldopa,Down Syndrome,1,401,400,6,5,421429,175.76208333333332
methyldopa,Drug ineffective for unapproved indication,3,401,398,933,930,420504,3.4004588860702225
methyldopa,Dry lips (finding),1,401,400,19,18,421416,55.50210526315789
methyldopa,Dry tongue,1,401,400,27,26,421408,39.056296296296296
methyldopa,"Edema, generalized",1,401,400,307,306,421128,3.4326384364820846
methyldopa,Enuresis,1,401,400,5,4,421430,210.915
methyldopa,Erosive Duodenitis,1,401,400,15,14,421420,70.30333333333333
methyldopa,Excoriation,4,401,397,1205,1201,420233,3.517083520595336
methyldopa,Exposure during breast feeding,3,401,398,7,4,421430,454.22972002871495
methyldopa,Facial Injuries,2,401,399,420,418,421016,5.029418785057883
methyldopa,Furred tongue,4,401,397,49,45,421389,86.72924484655321
methyldopa,Gallstone ileus,1,401,400,88,87,421347,11.981448863636365
methyldopa,Gas retention,1,401,400,9,8,421426,117.17388888888888
methyldopa,Gastritis,1,401,400,202,201,421233,5.2182301980198025
methyldopa,Gastrointestinal carcinoma,8,401,393,350,342,421092,24.513849509269356
methyldopa,Gingival discolouration,4,401,397,113,109,421325,37.60255009919529
methyldopa,HELLP Syndrome,17,401,384,405,388,421046,46.06680812757202
methyldopa,Halitosis,1,401,400,277,276,421158,3.8046750902527076
methyldopa,Hemorrhage of kidney,1,401,400,11,10,421424,95.86909090909091
methyldopa,Hernia of abdominal cavity,1,401,400,26,25,421409,40.558557692307694
methyldopa,Hot flushes,1,401,400,243,242,421192,4.337366255144033
methyldopa,Hydrops Fetalis,1,401,400,6,5,421429,175.76208333333332
methyldopa,Hyperacusis,1,401,400,7,6,421428,150.65285714285713
methyldopa,Hypersensitivity,1,401,400,203,202,421232,5.192512315270936
methyldopa,Hypertensive Retinopathy,1,401,400,5,4,421430,210.915
methyldopa,"Hypertonia, Neonatal",1,401,400,37,36,421398,28.49986486486487
methyldopa,Hypocomplementaemia,1,401,400,24,23,421411,43.93864583333333
methyldopa,Impaired work ability,1,401,400,270,269,421165,3.90337962962963
methyldopa,Increased frequency of micturition,1,401,400,231,230,421204,4.562813852813853
methyldopa,Infarction,1,401,400,54,53,421381,19.526898148148145
methyldopa,Inflammatory pain,1,401,400,32,31,421403,32.953359375
methyldopa,Inhibitory drug interaction,1,401,400,5,4,421430,210.915
methyldopa,Injection site extravasation,1,401,400,323,322,421112,3.2624767801857586
methyldopa,Internal Carotid Artery Stenosis,1,401,400,99,98,421336,10.649898989898992
methyldopa,Intestinal Fistula,2,401,399,11,9,421425,192.2187286397813
methyldopa,Labile blood pressure,1,401,400,86,85,421349,12.26014534883721
methyldopa,Lethargy,1,401,400,114,113,421321,9.248267543859649
methyldopa,"Leukemia, Myelocytic, Acute",1,401,400,48,47,421387,21.968072916666667
methyldopa,Leukocyte Disorders,1,401,400,61,60,421374,17.285819672131147
methyldopa,"Leukoencephalopathy, Progressive Multifocal",1,401,400,219,218,421216,4.81296803652968
methyldopa,Lip swelling,2,401,399,372,370,421064,5.679022825881909
methyldopa,Low density lipoprotein abnormal,1,401,400,249,248,421186,4.232791164658634
methyldopa,Lymphocyte stimulation test positive,1,401,400,76,75,421359,13.873651315789473
methyldopa,Maternal drugs affecting foetus,1,401,400,92,91,421343,11.460407608695652
methyldopa,Maternal exposure during pregnancy,1,401,400,288,287,421147,3.6592621527777776
methyldopa,Maternal hypertension affecting foetus,1,401,400,159,158,421276,6.630125786163522
methyldopa,Medical device complication,1,401,400,63,62,421372,16.736984126984126
methyldopa,Mental disorders,1,401,400,47,46,421388,22.435531914893616
methyldopa,Metabolic alkalosis,1,401,400,113,112,421322,9.330132743362832
methyldopa,Miliaria,1,401,400,27,26,421408,39.056296296296296
methyldopa,Movement Disorders,1,401,400,331,330,421104,3.1835649546827796
methyldopa,Myocardial Ischemia,1,401,400,208,207,421227,5.067632211538462
methyldopa,Nasal discomfort,1,401,400,289,288,421146,3.6465916955017303
methyldopa,Oligohydramnios,1,401,400,8,7,421427,131.82093749999999
methyldopa,Oral mucosal blisters,3,401,398,15,12,421422,211.96984924623118
methyldopa,PO2 increased,1,401,400,27,26,421408,39.056296296296296
methyldopa,Pain in testicle,1,401,400,56,55,421379,18.829419642857143
methyldopa,Paronychia (disorder),1,401,400,12,11,421423,87.87979166666666
methyldopa,Patent ductus arteriosus,1,401,400,10,9,421425,105.45625
methyldopa,Pelvic fluid collection,1,401,400,13,12,421422,81.11961538461539
methyldopa,Pelvic haemorrhage,1,401,400,93,92,421342,11.33715053763441
methyldopa,Pericardial effusion,1,401,400,55,54,421380,19.171818181818182
methyldopa,Peritoneal Dialysis,1,401,400,12,11,421423,87.87979166666666
methyldopa,Persistent Fetal Circulation Syndrome,1,401,400,12,11,421423,87.87979166666666
methyldopa,Pharyngotonsillitis,1,401,400,5,4,421430,210.915
methyldopa,Pigmentation of eyelids,1,401,400,127,126,421308,8.301338582677165
methyldopa,Polydactyly,11,401,390,343,332,421102,34.65957987590641
methyldopa,Post procedural complication,1,401,400,53,52,421382,19.895377358490567
methyldopa,Postural dizziness,7,401,394,36,29,421405,208.16363508178227
methyldopa,Pregnancy associated hypertension,1,401,400,52,51,421383,20.27802884615385
methyldopa,Premature Birth,3,401,398,61,58,421376,52.118049262706975
methyldopa,Preterm premature rupture of membranes (disorder),4,401,397,163,159,421275,26.064934864242556
methyldopa,Procedural hypotension,1,401,400,47,46,421388,22.435531914893616
methyldopa,Purulent discharge,1,401,400,156,155,421279,6.757676282051282
methyldopa,Pyelonephritis,1,401,400,170,169,421265,6.200955882352941
methyldopa,Radiation exposure during pregnancy,7,401,394,64,57,421377,117.08427189086294
methyldopa,Rapid correction of hyponatraemia,1,401,400,19,18,421416,55.50210526315789
methyldopa,Renal Insufficiency,3,401,398,907,904,420530,3.498152282914019
methyldopa,Renal cancer metastatic,1,401,400,29,28,421406,36.36258620689655
methyldopa,Renal failure neonatal,1,401,400,12,11,421423,87.87979166666666
methyldopa,Renal tubular acidosis,1,401,400,23,22,421412,45.84913043478261
methyldopa,Renal tubular necrosis,1,401,400,46,45,421389,22.923315217391302
methyldopa,Repair of hip,1,401,400,184,183,421251,5.728953804347825
methyldopa,"Respiratory Distress Syndrome, Newborn",1,401,400,9,8,421426,117.17388888888888
methyldopa,Respiratory tract congestion,4,401,397,337,333,421101,12.601873098685244
methyldopa,Retrognathia,1,401,400,14,13,421421,75.32517857142857
methyldopa,Rib Fractures,1,401,400,108,107,421327,9.762199074074074
methyldopa,Right Ventricular Dysfunction,1,401,400,79,78,421356,13.346708860759493
methyldopa,Rupture of liver,1,401,400,19,18,421416,55.50210526315789
methyldopa,Sees haloes around lights,2,401,399,300,298,421136,7.043191311612365
methyldopa,Sense of smell altered,1,401,400,71,70,421364,14.850845070422535
methyldopa,Sjogren-Larsson Syndrome,1,401,400,79,78,421356,13.346708860759493
methyldopa,Skeletal injury,1,401,400,51,50,421384,20.675686274509804
methyldopa,Splenic abscess,1,401,400,6,5,421429,175.76208333333332
methyldopa,Spontaneous abortion,1,401,400,174,173,421261,6.058347701149425
methyldopa,Squamous cell carcinoma of lung,1,401,400,123,122,421312,8.571382113821139
methyldopa,Steatohepatitis,1,401,400,79,78,421356,13.346708860759493
methyldopa,Sunburn,1,401,400,180,179,421255,5.856319444444445
methyldopa,Superficial spreading malignant melanoma of skin,1,401,400,104,103,421331,10.137764423076923
methyldopa,Temporomandibular Joint Dysfunction Syndrome,2,401,399,545,543,420891,3.874732703317928
methyldopa,Termination of pregnancy (procedure),1,401,400,39,38,421396,27.038205128205128
methyldopa,Tongue blistering,1,401,400,20,19,421415,52.726875
methyldopa,Tonsillitis,1,401,400,7,6,421428,150.65285714285713
methyldopa,Tracheoesophageal Fistula,1,401,400,27,26,421408,39.056296296296296
methyldopa,Tracheostomy malfunction,1,401,400,24,23,421411,43.93864583333333
methyldopa,Ulcerative Colitis,1,401,400,156,155,421279,6.757676282051282
methyldopa,Ultrasonography of kidney abnormal,1,401,400,62,61,421373,17.00697580645161
methyldopa,Urinary Retention,1,401,400,84,83,421351,12.552113095238095
methyldopa,Vascular occlusion,1,401,400,76,75,421359,13.873651315789473
methyldopa,Ventricular Dysfunction,1,401,400,121,120,421314,8.713099173553719
methyldopa,Viral Encephalitis,1,401,400,11,10,421424,95.86909090909091
methyldopa,Vitamin D Deficiency,1,401,400,189,188,421246,5.577328042328042
methyldopa,Walking disability,1,401,400,6,5,421429,175.76208333333332
methyldopa,Weight decrease neonatal,1,401,400,10,9,421425,105.45625
methyldopa,White matter lesion,1,401,400,91,90,421344,11.586373626373627
methyldopa,Wound infection bacterial,1,401,400,44,43,421391,23.965397727272727
methyldopa,amniotic fluid meconium stained,1,401,400,31,30,421404,34.016451612903225
methyldopa,upper airway cough syndrome,1,401,400,54,53,421381,19.526898148148145
metolazone,Age related macular degeneration,1,44,43,915,914,420877,10.698182742406914
metolazone,Asthenia,1,44,43,1845,1844,419947,5.293880380664271
metolazone,Bile duct calculus,1,44,43,1599,1598,420193,6.111901333682389
metolazone,Biopsy of breast,1,44,43,641,640,421151,15.281137757138193
metolazone,Blood Transfusion,1,44,43,30,29,421762,326.98062015503876
metolazone,Blood glucose outside reference range,1,44,43,668,667,421124,14.662546999025206
metolazone,Blood pressure inadequately controlled,1,44,43,692,691,421100,14.153212797419007
metolazone,Blood testosterone decreased,1,44,43,991,990,420801,9.87595334756999
metolazone,Burning sensation,1,44,43,925,924,420867,10.582275298554368
metolazone,Calcification of pericardium,1,44,43,1590,1589,420202,6.146628638291649
metolazone,Cataract,1,44,43,618,617,421174,15.850718747648077
metolazone,Clostridium difficile infection,1,44,43,1764,1763,420028,5.5380345936824344
metolazone,Connective Tissue Diseases,2,44,42,1120,1118,420673,17.8875425170068
metolazone,Dehydration,1,44,43,1376,1375,420416,7.106189156300704
metolazone,Drug Interactions,1,44,43,442,441,421350,22.1715773966116
metolazone,"Edema, generalized",1,44,43,307,306,421485,31.93152033936823
metolazone,Elective Surgical Procedures,1,44,43,65,64,421727,150.9016100178891
metolazone,Erosion of bone,1,44,43,6,5,421786,1634.9961240310076
metolazone,Foot Deformities,1,44,43,148,147,421644,66.26131363922062
metolazone,Frustration,1,44,43,118,117,421674,83.11332282223098
metolazone,Hyperesthesia,1,44,43,42,41,421750,233.55094130675522
metolazone,Hypoglycemia,1,44,43,1103,1102,420689,8.870775264078938
metolazone,Hyponatremia,1,44,43,941,940,420851,10.401947458171662
metolazone,Hypotension,1,44,43,2116,2115,419676,4.612904998461335
metolazone,Hypothyroidism,2,44,42,2794,2792,418999,7.141851586733476
metolazone,Idiopathic erosive/hemorrhagic gastritis,1,44,43,98,97,421694,100.07997152349311
metolazone,Laryngitis,1,44,43,221,220,421571,44.36641060717669
metolazone,Lymphedema,1,44,43,549,548,421243,17.84580844664718
metolazone,Neuralgia,1,44,43,1085,1084,420707,9.018326010073947
metolazone,Oropharyngeal pain,1,44,43,3244,3243,418548,3.000824420038425
metolazone,Osteonecrosis of Jaw,1,44,43,143,142,421649,68.57895592779313
metolazone,Pain in esophagus (finding),1,44,43,595,594,421197,16.464334571037718
metolazone,Presyncope,1,44,43,2832,2831,418960,3.440768295887531
metolazone,Red blood cell analysis abnormal,1,44,43,130,129,421662,75.4391771019678
metolazone,Renal Insufficiency,2,44,42,907,905,420886,22.099438231742532
metolazone,Skin rash,1,44,43,2510,2509,419282,3.88515704623367
metolazone,Syncope,1,44,43,1527,1526,420265,6.401181827873472
metolazone,White blood cell count decreased,1,44,43,202,201,421590,48.54167626064932
metoprolol,Abdominal symptom,2,22842,22840,9,7,398986,4.104164234286826
metoprolol,Abnormal nail growth,2,22842,22840,11,9,398984,3.3579366342939023
metoprolol,Abnormal ventricular axis,6,22842,22836,27,21,398972,4.104707965979642
metoprolol,Abscess of intestine,4,22842,22838,20,16,398977,3.6939749540239952
metoprolol,Accident while engaged in work-related activity,2,22842,22840,8,6,398987,4.617195709281961
metoprolol,Acute Coronary Syndrome,2,22842,22840,11,9,398984,3.3579366342939023
metoprolol,Acute graft versus host disease in skin,3,22842,22839,5,2,398991,11.081833705503744
metoprolol,Acute psychosis,2,22842,22840,5,3,398990,7.3875656742556925
metoprolol,Acute pulmonary edema,5,22842,22837,12,7,398986,7.696264103574609
metoprolol,Adenocarcinoma of colon,1,22842,22841,6,5,398988,3.078010303109904
metoprolol,Adenoma,2,22842,22840,6,4,398989,6.156290134267366
metoprolol,Adrenal Gland Neoplasms,3,22842,22839,13,10,398983,4.262162899493782
metoprolol,Agnosia,3,22842,22839,11,8,398985,5.037125491085821
metoprolol,Alcohol Withdrawal Delirium,16,22842,22826,42,26,398967,7.0394746174996765
metoprolol,Allergy to arthropod bite,2,22842,22840,5,3,398990,7.3875656742556925
metoprolol,Alopecia totalis,3,22842,22839,9,6,398987,6.156515901163215
metoprolol,Altered state of consciousness,1,22842,22841,6,5,398988,3.078010303109904
metoprolol,Amaurosis,3,22842,22839,5,2,398991,11.081833705503744
metoprolol,Amebiasis,2,22842,22840,11,9,398984,3.3579366342939023
metoprolol,Amenorrhea,9,22842,22833,25,16,398977,6.650532124556563
metoprolol,Anastomotic stenosis,2,22842,22840,8,6,398987,4.617195709281961
metoprolol,Antibiotic therapy,2,22842,22840,8,6,398987,4.617195709281961
metoprolol,Antibody test positive,2,22842,22840,10,8,398985,3.6937390542907185
metoprolol,Antiphospholipid antibodies positive,1,22842,22841,5,4,398989,3.693621119915941
metoprolol,Anxiety Disorders,1,22842,22841,6,5,398988,3.078010303109904
metoprolol,Aortic bypass,8,22842,22834,12,4,398989,12.31564041925783
metoprolol,Aortic coarctation,3,22842,22839,5,2,398991,11.081833705503744
metoprolol,Application site edema,2,22842,22840,11,9,398984,3.3579366342939023
metoprolol,Application site hypersensitivity,2,22842,22840,5,3,398990,7.3875656742556925
metoprolol,Application site infection,1,22842,22841,5,4,398989,3.693621119915941
metoprolol,Application site scar,3,22842,22839,15,12,398981,3.693856998992951
metoprolol,Arnold Chiari Malformation,3,22842,22839,17,14,398979,3.2592701339040806
metoprolol,Arthroplasty of the shoulder (procedure),4,22842,22838,15,11,398982,4.92535832092711
metoprolol,Arthroscopy,4,22842,22838,23,19,398974,3.2121292887140807
metoprolol,Athletic Injuries,2,22842,22840,8,6,398987,4.617195709281961
metoprolol,Atrial standstill,1,22842,22841,6,5,398988,3.078010303109904
metoprolol,Atrophy of cerebellum,2,22842,22840,5,3,398990,7.3875656742556925
metoprolol,Autoimmune hepatitis,1,22842,22841,6,5,398988,3.078010303109904
metoprolol,Bacillus test positive,6,22842,22836,27,21,398972,4.104707965979642
metoprolol,Bacterial sinusitis,2,22842,22840,8,6,398987,4.617195709281961
metoprolol,Benign mucous membrane pemphigoid with ocular involvement,1,22842,22841,6,5,398988,3.078010303109904
metoprolol,Bicytopenia,5,22842,22837,25,20,398973,3.6940929193852083
metoprolol,Bile Duct Stenosis,4,22842,22838,23,19,398974,3.2121292887140807
metoprolol,Biliary Tract Surgical Procedures,1,22842,22841,5,4,398989,3.693621119915941
metoprolol,Biliary sphincterotomy,2,22842,22840,7,5,398988,5.2768076057042785
metoprolol,Biopsy of pancreas,3,22842,22839,9,6,398987,6.156515901163215
metoprolol,Blood chloride decreased,2,22842,22840,11,9,398984,3.3579366342939023
metoprolol,Blood erythropoietin abnormal,5,22842,22837,18,13,398980,5.130769754735249
metoprolol,Blood lactate dehydrogenase increased,4,22842,22838,22,18,398975,3.358143126686782
metoprolol,Blood sodium abnormal,1,22842,22841,6,5,398988,3.078010303109904
metoprolol,Blood sodium increased,4,22842,22838,22,18,398975,3.358143126686782
metoprolol,Blood urine present,1,22842,22841,6,5,398988,3.078010303109904
metoprolol,Blood zinc decreased,1,22842,22841,6,5,398988,3.078010303109904
metoprolol,Body fat disorder,2,22842,22840,5,3,398990,7.3875656742556925
metoprolol,Bone marrow transplant rejection,1,22842,22841,6,5,398988,3.078010303109904
metoprolol,Bronchiectasis,1,22842,22841,5,4,398989,3.693621119915941
metoprolol,Bullous Dermatitis,2,22842,22840,8,6,398987,4.617195709281961
metoprolol,C-reactive protein above reference range,9,22842,22833,46,37,398956,3.6142396874089564
metoprolol,CSF white blood cell count increased,1,22842,22841,6,5,398988,3.078010303109904
metoprolol,Calcification of pleura,1,22842,22841,5,4,398989,3.693621119915941
metoprolol,Campylobacter infection,2,22842,22840,11,9,398984,3.3579366342939023
metoprolol,Cancer of Ear,2,22842,22840,11,9,398984,3.3579366342939023
metoprolol,"Carcinoma, Signet Ring Cell",2,22842,22840,5,3,398990,7.3875656742556925
metoprolol,Cardiac Catheterization Procedures,3,22842,22839,11,8,398985,5.037125491085821
metoprolol,Cardiac asthma,2,22842,22840,5,3,398990,7.3875656742556925
metoprolol,Cardiopulmonary Arrest,1,22842,22841,6,5,398988,3.078010303109904
metoprolol,Cerebellar Neoplasms,3,22842,22839,16,13,398980,3.4629827269144884
metoprolol,Cerebrovascular stenosis,1,22842,22841,6,5,398988,3.078010303109904
metoprolol,Choking sensation,5,22842,22837,14,9,398984,6.596766525500597
metoprolol,Chondromalacia,1,22842,22841,5,4,398989,3.693621119915941
metoprolol,Chylothorax,2,22842,22840,9,7,398986,4.104164234286826
metoprolol,Coital bleeding,3,22842,22839,9,6,398987,6.156515901163215
metoprolol,Complications of Diabetes Mellitus,4,22842,22838,15,11,398982,4.92535832092711
metoprolol,Compression fracture of vertebral column,2,22842,22840,11,9,398984,3.3579366342939023
metoprolol,Congenital absence of bile duct,1,22842,22841,6,5,398988,3.078010303109904
metoprolol,Congenital atresia of aorta,35,22842,22807,125,90,398903,5.177305213311703
metoprolol,Congenital phimosis,1,22842,22841,6,5,398988,3.078010303109904
metoprolol,Congenital stenosis of aortic valve,5,22842,22837,24,19,398974,3.8480225803155697
metoprolol,Conjunctival hyperemia,13,22842,22829,28,15,398978,8.578516986539677
metoprolol,Constriction in throat,9,22842,22833,21,12,398981,7.917375227584135
metoprolol,Contracture,2,22842,22840,6,4,398989,6.156290134267366
metoprolol,Conversion disorder,3,22842,22839,12,9,398984,4.6173540873068
metoprolol,Coronary Artery Vasospasm,5,22842,22837,14,9,398984,6.596766525500597
metoprolol,Coronary Occlusion,6,22842,22836,24,18,398975,4.617829304606761
metoprolol,Creatinine measurement,2,22842,22840,9,7,398986,4.104164234286826
metoprolol,Creatinine renal clearance increased,1,22842,22841,5,4,398989,3.693621119915941
metoprolol,Cyst of skin,1,22842,22841,5,4,398989,3.693621119915941
metoprolol,Cystopexy,1,22842,22841,6,5,398988,3.078010303109904
metoprolol,Day Dreams,1,22842,22841,6,5,398988,3.078010303109904
metoprolol,Death of relative,3,22842,22839,17,14,398979,3.2592701339040806
metoprolol,Decreased Libido,5,22842,22837,24,19,398974,3.8480225803155697
metoprolol,Decreased urine output,6,22842,22836,28,22,398971,3.958101869229037
metoprolol,Deformity of limb,6,22842,22836,21,15,398978,5.277556739984486
metoprolol,Dehydroepiandrosterone decreased,2,22842,22840,5,3,398990,7.3875656742556925
metoprolol,Dental Fistula,2,22842,22840,8,6,398987,4.617195709281961
metoprolol,Desmoplastic melanoma,4,22842,22838,7,3,398990,10.554539426769919
metoprolol,Detachment of retinal pigment epithelium,2,22842,22840,11,9,398984,3.3579366342939023
metoprolol,Device battery issue,2,22842,22840,8,6,398987,4.617195709281961
metoprolol,Diffuse alopecia,2,22842,22840,8,6,398987,4.617195709281961
metoprolol,Dilatation of esophagus (disorder),3,22842,22839,8,5,398988,6.9260968080914225
metoprolol,Discomfort in mouth,5,22842,22837,25,20,398973,3.6940929193852083
metoprolol,Disorder of appendix,2,22842,22840,6,4,398989,6.156290134267366
metoprolol,Diverticulitis,2,22842,22840,10,8,398985,3.6937390542907185
metoprolol,Drooling,6,22842,22836,34,28,398965,3.259566937652623
metoprolol,Drug level changed,1,22842,22841,5,4,398989,3.693621119915941
metoprolol,Dysmorphism,2,22842,22840,5,3,398990,7.3875656742556925
metoprolol,Dyspepsia,2,22842,22840,8,6,398987,4.617195709281961
metoprolol,Dyspnea on exertion,3,22842,22839,18,15,398978,3.0781922734503846
metoprolol,Ectopic pregnancy with contraceptive device,2,22842,22840,12,10,398983,3.0781012842965554
metoprolol,Electroencephalogram abnormal,1,22842,22841,6,5,398988,3.078010303109904
metoprolol,Enamel anomaly,4,22842,22838,20,16,398977,3.6939749540239952
metoprolol,Endoscopy (procedure),4,22842,22838,13,9,398984,5.683132700559796
metoprolol,Enterocolitis viral,11,22842,22831,61,50,398943,3.331330496140206
metoprolol,Enuresis,1,22842,22841,5,4,398989,3.693621119915941
metoprolol,Enzyme abnormality,1,22842,22841,5,4,398989,3.693621119915941
metoprolol,Episcleritis,2,22842,22840,9,7,398986,4.104164234286826
metoprolol,Eye colour change,2,22842,22840,9,7,398986,4.104164234286826
metoprolol,Eye foreign bodies,1,22842,22841,6,5,398988,3.078010303109904
metoprolol,Facet joint pain,6,22842,22836,24,18,398975,4.617829304606761
metoprolol,Febrile Convulsions,1,22842,22841,5,4,398989,3.693621119915941
metoprolol,Female infertility,1,22842,22841,5,4,398989,3.693621119915941
metoprolol,Fetal Death,2,22842,22840,8,6,398987,4.617195709281961
metoprolol,Foetal heart rate deceleration abnormality,15,22842,22827,27,12,398981,10.26581582239356
metoprolol,Fracture of sternum,10,22842,22832,54,44,398949,3.420970243193439
metoprolol,Fracture of wrist,18,22842,22824,96,78,398915,3.464601406414301
metoprolol,Fracture with displacement,3,22842,22839,13,10,398983,4.262162899493782
metoprolol,Gangrene due to diabetes mellitus,1,22842,22841,6,5,398988,3.078010303109904
metoprolol,Gastric Obstruction,2,22842,22840,7,5,398988,5.2768076057042785
metoprolol,Gastric hypermotility,3,22842,22839,7,4,398989,7.915557974141975
metoprolol,Gastric pH decreased,1,22842,22841,5,4,398989,3.693621119915941
metoprolol,Gastric ulcer with perforation,1,22842,22841,5,4,398989,3.693621119915941
metoprolol,Gastrointestinal mucosal disorder,2,22842,22840,11,9,398984,3.3579366342939023
metoprolol,Gastrointestinal stoma complication,3,22842,22839,13,10,398983,4.262162899493782
metoprolol,Genitourinary tract gonococcal infection,1,22842,22841,5,4,398989,3.693621119915941
metoprolol,Glassy eye,2,22842,22840,9,7,398986,4.104164234286826
metoprolol,Glioblastoma,2,22842,22840,5,3,398990,7.3875656742556925
metoprolol,Glycogen Storage Disease Type V,7,22842,22835,19,12,398981,6.8056008205317315
metoprolol,Graft infection,2,22842,22840,12,10,398983,3.0781012842965554
metoprolol,Guilt,1,22842,22841,5,4,398989,3.693621119915941
metoprolol,HIV Seropositivity,2,22842,22840,12,10,398983,3.0781012842965554
metoprolol,Haematidrosis,2,22842,22840,11,9,398984,3.3579366342939023
metoprolol,Hamman-Rich syndrome,1,22842,22841,6,5,398988,3.078010303109904
metoprolol,Hemangioma of liver,1,22842,22841,5,4,398989,3.693621119915941
metoprolol,Hematoma of kidney,4,22842,22838,17,13,398980,4.345883795325644
metoprolol,Hemorrhagic enterocolitis,1,22842,22841,5,4,398989,3.693621119915941
metoprolol,Hepatic Encephalopathy,24,22842,22818,118,94,398899,3.759003819464562
metoprolol,Hepatic Veno-Occlusive Disease,1,22842,22841,6,5,398988,3.078010303109904
metoprolol,Hepatorenal Syndrome,2,22842,22840,12,10,398983,3.0781012842965554
metoprolol,Hepatosplenomegaly,1,22842,22841,5,4,398989,3.693621119915941
metoprolol,Hiccough,10,22842,22832,44,34,398959,4.198563021596483
metoprolol,High turnover osteopathy,1,22842,22841,5,4,398989,3.693621119915941
metoprolol,Hydrops of gallbladder,3,22842,22839,15,12,398981,3.693856998992951
metoprolol,Hyperkeratosis,3,22842,22839,16,13,398980,3.4629827269144884
metoprolol,Hyperlactatemia,5,22842,22837,25,20,398973,3.6940929193852083
metoprolol,Hypertensive Encephalopathy,6,22842,22836,33,27,398966,3.3583496552492873
metoprolol,Hypertensive cardiomyopathy,1,22842,22841,6,5,398988,3.078010303109904
metoprolol,Hypertrophic Cardiomyopathy,4,22842,22838,7,3,398990,10.554539426769919
metoprolol,Hypertrophy of adenoids,2,22842,22840,11,9,398984,3.3579366342939023
metoprolol,Hypertrophy of tonsils,1,22842,22841,5,4,398989,3.693621119915941
metoprolol,Hypocholesterolemia,2,22842,22840,8,6,398987,4.617195709281961
metoprolol,Hypoglycemic shock,2,22842,22840,11,9,398984,3.3579366342939023
metoprolol,Hypopigmentation disorder,2,22842,22840,6,4,398989,6.156290134267366
metoprolol,Ileitis,4,22842,22838,13,9,398984,5.683132700559796
metoprolol,Ileocolectomy,3,22842,22839,11,8,398985,5.037125491085821
metoprolol,Impacted tooth,1,22842,22841,5,4,398989,3.693621119915941
metoprolol,Implant site pain,15,22842,22827,35,20,398973,7.919193436344178
metoprolol,Impulsive Behavior,5,22842,22837,10,5,398988,9.235560712878224
metoprolol,Inappropriate affect,4,22842,22838,13,9,398984,5.683132700559796
metoprolol,Incorrect storage of drug,19,22842,22823,108,89,398904,3.2507870552934746
metoprolol,Increased Libido,3,22842,22839,17,14,398979,3.2592701339040806
metoprolol,Infected dermatitis,1,22842,22841,6,5,398988,3.078010303109904
metoprolol,Infection of uterus,1,22842,22841,5,4,398989,3.693621119915941
metoprolol,Infective glossitis,2,22842,22840,11,9,398984,3.3579366342939023
metoprolol,Infiltrating duct carcinoma,1,22842,22841,6,5,398988,3.078010303109904
metoprolol,Inflammation,2,22842,22840,7,5,398988,5.2768076057042785
metoprolol,Inflammatory Bowel Diseases,2,22842,22840,10,8,398985,3.6937390542907185
metoprolol,Inflammatory marker increased,2,22842,22840,8,6,398987,4.617195709281961
metoprolol,Inflammatory pain,6,22842,22836,32,26,398967,3.4633062926957434
metoprolol,Infusion-Related Reaction,2,22842,22840,8,6,398987,4.617195709281961
metoprolol,Inguinal pain,4,22842,22838,19,15,398978,3.8884039066929077
metoprolol,Injection site laceration,4,22842,22838,6,2,398991,12.313658522345797
metoprolol,Injection site paresthesia,15,22842,22827,53,38,398955,5.229432871202672
metoprolol,Injection site warmth,8,22842,22834,37,29,398964,3.9940250314253998
metoprolol,Injury of ear,1,22842,22841,5,4,398989,3.693621119915941
metoprolol,Injury of gallbladder,1,22842,22841,5,4,398989,3.693621119915941
metoprolol,Intentional product misuse,15,22842,22827,33,18,398975,8.399184378945188
metoprolol,Internal injury,1,22842,22841,5,4,398989,3.693621119915941
metoprolol,International normalised ratio fluctuation,3,22842,22839,12,9,398984,4.6173540873068
metoprolol,Intertrigo,1,22842,22841,6,5,398988,3.078010303109904
metoprolol,Intervertebral Disk Displacement,3,22842,22839,18,15,398978,3.0781922734503846
metoprolol,Intraductal papilloma of breast,3,22842,22839,6,3,398990,9.234839528876046
metoprolol,Iridocyclitis,2,22842,22840,12,10,398983,3.0781012842965554
metoprolol,Itching of ear,1,22842,22841,5,4,398989,3.693621119915941
metoprolol,Keratomileusis,1,22842,22841,6,5,398988,3.078010303109904
metoprolol,Laminoplasty,1,22842,22841,5,4,398989,3.693621119915941
metoprolol,Large for gestational age,8,22842,22834,8,0,398993,18.47363580625383
metoprolol,Leukocytosis,2,22842,22840,6,4,398989,6.156290134267366
metoprolol,Light chain analysis abnormal,1,22842,22841,6,5,398988,3.078010303109904
metoprolol,Liver induration,1,22842,22841,6,5,398988,3.078010303109904
metoprolol,Loose body in forearm joint,2,22842,22840,6,4,398989,6.156290134267366
metoprolol,Loss of proprioception,2,22842,22840,10,8,398985,3.6937390542907185
metoprolol,Lung Abscess,2,22842,22840,6,4,398989,6.156290134267366
metoprolol,Lymphocytosis,1,22842,22841,5,4,398989,3.693621119915941
metoprolol,Lysis of adhesions of intestines,1,22842,22841,6,5,398988,3.078010303109904
metoprolol,Macrophages increased,15,22842,22827,47,32,398961,5.897103933471841
metoprolol,Major Depressive Disorder,2,22842,22840,8,6,398987,4.617195709281961
metoprolol,Malaria,1,22842,22841,6,5,398988,3.078010303109904
metoprolol,Malignant neoplasm of stomach,1,22842,22841,6,5,398988,3.078010303109904
metoprolol,Malignant neoplasm of tonsil,3,22842,22839,11,8,398985,5.037125491085821
metoprolol,Malignant tumor of peritoneum,1,22842,22841,5,4,398989,3.693621119915941
metoprolol,Meningioma,20,22842,22822,123,103,398890,3.0046033174379594
metoprolol,Mental disorders,12,22842,22830,47,35,398958,4.717063214695109
metoprolol,Mesenteric artery embolism,4,22842,22838,21,17,398976,3.518063044466407
metoprolol,Metastasis from malignant neoplasm of colon and/or rectum,2,22842,22840,5,3,398990,7.3875656742556925
metoprolol,Metastatic Carcinoma to the Uterine Cervix,6,22842,22836,14,8,398985,7.916466481495382
metoprolol,Metastatic malignant neoplasm to peritoneum,3,22842,22839,12,9,398984,4.6173540873068
metoprolol,Metrorrhagia,4,22842,22838,20,16,398977,3.6939749540239952
metoprolol,Mitral Valve Prolapse Syndrome,13,22842,22829,78,65,398928,3.0791026034137863
metoprolol,Monoplegia,2,22842,22840,9,7,398986,4.104164234286826
metoprolol,Morton Neuroma,2,22842,22840,9,7,398986,4.104164234286826
metoprolol,Multiple use of single-use product,1,22842,22841,5,4,398989,3.693621119915941
metoprolol,Muscle Hypertonia,4,22842,22838,20,16,398977,3.6939749540239952
metoprolol,Muscle Weakness,8,22842,22834,46,38,398955,3.212516803698527
metoprolol,Myocardial oedema,22,22842,22820,130,108,398885,3.127320838670532
metoprolol,Myocardial strain imaging,4,22842,22838,24,20,398973,3.0782832705724377
metoprolol,Myotonus (finding),2,22842,22840,9,7,398986,4.104164234286826
metoprolol,N-terminal prohormone brain natriuretic peptide increased,4,22842,22838,7,3,398990,10.554539426769919
metoprolol,Neonatal hypotension,2,22842,22840,9,7,398986,4.104164234286826
metoprolol,Neurectomy,2,22842,22840,5,3,398990,7.3875656742556925
metoprolol,Neurological decompensation,1,22842,22841,6,5,398988,3.078010303109904
metoprolol,Noncompliance with dietary regimen,1,22842,22841,6,5,398988,3.078010303109904
metoprolol,Nuchal Rigidity,1,22842,22841,5,4,398989,3.693621119915941
metoprolol,Obstruction of salivary duct,3,22842,22839,8,5,398988,6.9260968080914225
metoprolol,Oesophageal irritation,5,22842,22837,18,13,398980,5.130769754735249
metoprolol,Oligohydramnios,2,22842,22840,8,6,398987,4.617195709281961
metoprolol,Operation on bone,4,22842,22838,24,20,398973,3.0782832705724377
metoprolol,Operation on ligament,5,22842,22837,16,11,398982,5.772143341945089
metoprolol,Oral Ulcer,2,22842,22840,12,10,398983,3.0781012842965554
metoprolol,Oral fibroma,4,22842,22838,23,19,398974,3.2121292887140807
metoprolol,Oral herpes simplex infection,3,22842,22839,9,6,398987,6.156515901163215
metoprolol,Orchitis,2,22842,22840,10,8,398985,3.6937390542907185
metoprolol,Organ Transplantation,2,22842,22840,5,3,398990,7.3875656742556925
metoprolol,Ototoxicity,2,22842,22840,9,7,398986,4.104164234286826
metoprolol,Ovarian enlargement,2,22842,22840,9,7,398986,4.104164234286826
metoprolol,Pain of lymph node,2,22842,22840,7,5,398988,5.2768076057042785
metoprolol,Pallor of skin,5,22842,22837,26,21,398972,3.5520040016033363
metoprolol,Pancreatic carcinoma recurrent,2,22842,22840,7,5,398988,5.2768076057042785
metoprolol,Pancreatic duct dilatation,1,22842,22841,5,4,398989,3.693621119915941
metoprolol,Pancreatitis,5,22842,22837,27,22,398971,3.4204401888423432
metoprolol,Papilledema,2,22842,22840,12,10,398983,3.0781012842965554
metoprolol,Paradoxical drug reaction,1,22842,22841,5,4,398989,3.693621119915941
metoprolol,Paranasal sinus hypersecretion,3,22842,22839,17,14,398979,3.2592701339040806
metoprolol,Parasite infestation,5,22842,22837,8,3,398990,11.544505626833647
metoprolol,Parotitis,2,22842,22840,7,5,398988,5.2768076057042785
metoprolol,Pelvic Pain,3,22842,22839,18,15,398978,3.0781922734503846
metoprolol,Penile swelling,1,22842,22841,6,5,398988,3.078010303109904
metoprolol,Peptic ulcer helicobacter,4,22842,22838,5,1,398992,14.776425256152027
metoprolol,Pericardial effusion,10,22842,22832,55,45,398948,3.358762820921195
metoprolol,Perineal infection,4,22842,22838,13,9,398984,5.683132700559796
metoprolol,Perinuclear antineutrophil cytoplasmic antibody increased,3,22842,22839,7,4,398989,7.915557974141975
metoprolol,Peripheral Vascular Diseases,5,22842,22837,28,23,398970,3.298273791278564
metoprolol,Peripheral embolism,1,22842,22841,5,4,398989,3.693621119915941
metoprolol,Peritoneal cloudy effluent,3,22842,22839,13,10,398983,4.262162899493782
metoprolol,Persistent Fetal Circulation Syndrome,6,22842,22836,12,6,398987,9.235921352250832
metoprolol,Peyronie Disease,2,22842,22840,6,4,398989,6.156290134267366
metoprolol,Pharyngeal Diseases,15,22842,22827,67,52,398941,4.136578246891446
metoprolol,Pharyngeal lesion,2,22842,22840,9,7,398986,4.104164234286826
metoprolol,Pharyngotonsillitis,1,22842,22841,5,4,398989,3.693621119915941
metoprolol,Phobia of driving,14,22842,22828,30,16,398977,8.622846212253958
metoprolol,Phonophobia,1,22842,22841,6,5,398988,3.078010303109904
metoprolol,Plague,4,22842,22838,19,15,398978,3.8884039066929077
metoprolol,Platelet count outside reference range,1,22842,22841,6,5,398988,3.078010303109904
metoprolol,"Pneumonia, Viral",5,22842,22837,12,7,398986,7.696264103574609
metoprolol,Poikilocytosis,1,22842,22841,5,4,398989,3.693621119915941
metoprolol,Polyarteritis Nodosa,2,22842,22840,11,9,398984,3.3579366342939023
metoprolol,Polyp of vocal cord,3,22842,22839,15,12,398981,3.693856998992951
metoprolol,Polypharmacy,4,22842,22838,16,12,398981,4.617512479201332
metoprolol,Post procedural hemorrhage,2,22842,22840,8,6,398987,4.617195709281961
metoprolol,Post-traumatic neck syndrome,3,22842,22839,5,2,398991,11.081833705503744
metoprolol,Postmenopausal bleeding,1,22842,22841,6,5,398988,3.078010303109904
metoprolol,Postoperative retention of urine,2,22842,22840,5,3,398990,7.3875656742556925
metoprolol,Pre-Eclampsia,1,22842,22841,6,5,398988,3.078010303109904
metoprolol,Premature ventricular contractions,3,22842,22839,7,4,398989,7.915557974141975
metoprolol,Procedural complication,3,22842,22839,17,14,398979,3.2592701339040806
metoprolol,Product dropper issue,2,22842,22840,7,5,398988,5.2768076057042785
metoprolol,Product size issue,2,22842,22840,12,10,398983,3.0781012842965554
metoprolol,Prostatectomy,2,22842,22840,6,4,398989,6.156290134267366
metoprolol,Prothrombin consumption time prolonged,3,22842,22839,13,10,398983,4.262162899493782
metoprolol,Pseudoaneurysm,1,22842,22841,6,5,398988,3.078010303109904
metoprolol,Pupillary light reflex tests abnormal,3,22842,22839,9,6,398987,6.156515901163215
metoprolol,Pyeloplasty,2,22842,22840,7,5,398988,5.2768076057042785
metoprolol,Reaction to previous exposure to any vaccine,2,22842,22840,5,3,398990,7.3875656742556925
metoprolol,Red man syndrome,2,22842,22840,11,9,398984,3.3579366342939023
metoprolol,Renal dysplasia,2,22842,22840,6,4,398989,6.156290134267366
metoprolol,Renal vasculitis,11,22842,22831,45,34,398959,4.515974868478044
metoprolol,Respiratory tract infection viral,1,22842,22841,6,5,398988,3.078010303109904
metoprolol,Retinal Degeneration,1,22842,22841,5,4,398989,3.693621119915941
metoprolol,Retinal Perforations,3,22842,22839,14,11,398982,3.9577133099397646
metoprolol,Retinal aneurysm,2,22842,22840,5,3,398990,7.3875656742556925
metoprolol,Retinal depigmentation,8,22842,22834,17,9,398984,8.693290191613125
metoprolol,Retrognathia,3,22842,22839,14,11,398982,3.9577133099397646
metoprolol,Scleral Diseases,1,22842,22841,6,5,398988,3.078010303109904
metoprolol,Secondary hypoparathyroidism,2,22842,22840,8,6,398987,4.617195709281961
metoprolol,Secretion discharge,1,22842,22841,5,4,398989,3.693621119915941
metoprolol,Self Medication,2,22842,22840,6,4,398989,6.156290134267366
metoprolol,Senile purpura,1,22842,22841,6,5,398988,3.078010303109904
metoprolol,Short stature for age,3,22842,22839,14,11,398982,3.9577133099397646
metoprolol,Sinus operation,2,22842,22840,9,7,398986,4.104164234286826
metoprolol,Skin neoplasm bleeding,3,22842,22839,16,13,398980,3.4629827269144884
metoprolol,Small cell lung cancer extensive stage,3,22842,22839,8,5,398988,6.9260968080914225
metoprolol,Soft Tissue Neoplasms,1,22842,22841,5,4,398989,3.693621119915941
metoprolol,Solar dermatitis,1,22842,22841,5,4,398989,3.693621119915941
metoprolol,Sperm concentration decreased,1,22842,22841,6,5,398988,3.078010303109904
metoprolol,Spermatozoa abnormal,3,22842,22839,6,3,398990,9.234839528876046
metoprolol,Spider Veins,1,22842,22841,5,4,398989,3.693621119915941
metoprolol,Splenic vein thrombosis,1,22842,22841,6,5,398988,3.078010303109904
metoprolol,Spontaneous pneumothorax,2,22842,22840,6,4,398989,6.156290134267366
metoprolol,Subarachnoid Hemorrhage,3,22842,22839,15,12,398981,3.693856998992951
metoprolol,Suicidal behavior,2,22842,22840,7,5,398988,5.2768076057042785
metoprolol,Superficial Thrombophlebitis,8,22842,22834,42,34,398959,3.5185041521206886
metoprolol,Swelling of structure of eye,2,22842,22840,6,4,398989,6.156290134267366
metoprolol,Systemic Scleroderma,3,22842,22839,16,13,398980,3.4629827269144884
metoprolol,Talipes,2,22842,22840,8,6,398987,4.617195709281961
metoprolol,Tardive Dyskinesia,2,22842,22840,7,5,398988,5.2768076057042785
metoprolol,Temperature regulation disorder,9,22842,22833,21,12,398981,7.917375227584135
metoprolol,Tenalgia,4,22842,22838,19,15,398978,3.8884039066929077
metoprolol,Therapeutic response unexpected,4,22842,22838,6,2,398991,12.313658522345797
metoprolol,Thiamine Deficiency,2,22842,22840,11,9,398984,3.3579366342939023
metoprolol,Thoracentesis,1,22842,22841,6,5,398988,3.078010303109904
metoprolol,Tonic-Clonic Epilepsy,2,22842,22840,7,5,398988,5.2768076057042785
metoprolol,Tooth Avulsion,7,22842,22835,37,30,398963,3.4946188579645994
metoprolol,Toxic leukocyte granulations,2,22842,22840,5,3,398990,7.3875656742556925
metoprolol,Tracheitis,1,22842,22841,5,4,398989,3.693621119915941
metoprolol,Transcription medication error,4,22842,22838,8,4,398989,9.23520010508801
metoprolol,Traumatic amputation of limb,6,22842,22836,24,18,398975,4.617829304606761
metoprolol,Traumatic injury of visual pathways,1,22842,22841,6,5,398988,3.078010303109904
metoprolol,Tumor Cell Invasion,1,22842,22841,6,5,398988,3.078010303109904
metoprolol,Ubiquinone decreased,2,22842,22840,10,8,398985,3.6937390542907185
metoprolol,Ulceration of intestine,1,22842,22841,5,4,398989,3.693621119915941
metoprolol,Ulcerative proctitis (disorder),1,22842,22841,6,5,398988,3.078010303109904
metoprolol,Unspecified Abortion,16,22842,22826,33,17,398976,8.95952250092266
metoprolol,Upper respiratory tract irritation,1,22842,22841,5,4,398989,3.693621119915941
metoprolol,Uterine Cancer,1,22842,22841,5,4,398989,3.693621119915941
metoprolol,Uterine Cervicitis,3,22842,22839,9,6,398987,6.156515901163215
metoprolol,Uterine Neoplasms,1,22842,22841,6,5,398988,3.078010303109904
metoprolol,Uterine Perforation,4,22842,22838,5,1,398992,14.776425256152027
metoprolol,Vascular Headaches,2,22842,22840,5,3,398990,7.3875656742556925
metoprolol,Vascular System Injuries,2,22842,22840,5,3,398990,7.3875656742556925
metoprolol,Vascular stenosis,4,22842,22838,18,14,398979,4.104436076325033
metoprolol,Venous Insufficiency,3,22842,22839,17,14,398979,3.2592701339040806
metoprolol,Ventricular Fibrillation,1,22842,22841,6,5,398988,3.078010303109904
metoprolol,Viral gastroenteritis,5,22842,22837,23,18,398975,4.015337429152919
metoprolol,Virus Diseases,4,22842,22838,20,16,398977,3.6939749540239952
metoprolol,Vitreous floaters,3,22842,22839,13,10,398983,4.262162899493782
metoprolol,Vocal Cord Paralysis,2,22842,22840,8,6,398987,4.617195709281961
metoprolol,Vomiting fecal matter,1,22842,22841,6,5,398988,3.078010303109904
metoprolol,Waist circumference increased,3,22842,22839,16,13,398980,3.4629827269144884
metoprolol,Weight decrease neonatal,3,22842,22839,10,7,398986,5.540851175620649
metoprolol,Wound evisceration,16,22842,22826,78,62,398931,3.790162814783861
metoprolol,Wound hematoma,2,22842,22840,9,7,398986,4.104164234286826
metoprolol,Wound infection bacterial,12,22842,22830,44,32,398961,5.038716999163779
metoprolol,effusion,1,22842,22841,5,4,398989,3.693621119915941
metoprolol,polyps,7,22842,22835,34,27,398966,3.8029946289880083
metoprolol,stage IV pancreatic cancer,1,22842,22841,5,4,398989,3.693621119915941
minoxidil,Adverse event,2,166,164,707,705,420964,7.264083899679166
minoxidil,Anemia of chronic disease,1,166,165,189,188,421481,13.520795254128586
minoxidil,Appetite Disorders,1,166,165,79,78,421591,32.35565784426544
minoxidil,Arterial Injury,1,166,165,29,28,421641,88.15172413793103
minoxidil,Arteriovenous fistula,1,166,165,58,57,421612,44.07283176593521
minoxidil,Atelectasis,1,166,165,423,422,421247,6.037853714449459
minoxidil,Blood parathyroid hormone increased,1,166,165,57,56,421613,44.8461456671983
minoxidil,Brain Death,2,166,164,221,219,421450,23.265312879373138
minoxidil,Breast Diseases,1,166,165,97,96,421573,26.350390502967823
minoxidil,Bullous pemphigoid,1,166,165,19,18,421651,134.5505582137161
minoxidil,Calcification of pericardium,3,166,163,1590,1587,420082,4.864509781224679
minoxidil,Calcium pyrophosphate deposition disease,1,166,165,43,42,421627,59.449189570119806
minoxidil,Candidiasis,1,166,165,103,102,421567,24.815063253898206
minoxidil,Carpal Tunnel Syndrome,1,166,165,55,54,421615,46.47713498622589
minoxidil,Cataract,1,166,165,618,617,421052,4.130793370599196
minoxidil,Catatonia,1,166,165,100,99,421570,25.55969696969697
minoxidil,Cervical spinal cord injury,1,166,165,17,16,421653,150.3807486631016
minoxidil,Cervix carcinoma,1,166,165,124,123,421546,20.611485826001957
minoxidil,Cholecystectomy procedure,1,166,165,187,186,421483,13.665467509317775
minoxidil,Colectomy,1,166,165,45,44,421625,56.80673400673401
minoxidil,Confusion,2,166,164,1333,1331,420338,3.8470166322068327
minoxidil,Constipation,4,166,162,178,174,421495,58.49035927313081
minoxidil,Cutaneous plaque,1,166,165,13,12,421657,196.65361305361307
minoxidil,Decreased Libido,1,166,165,24,23,421646,106.51792929292928
minoxidil,Dehydration,3,166,163,1376,1373,420296,5.623916571550863
minoxidil,Device leakage,1,166,165,21,20,421649,121.73564213564214
minoxidil,Device malfunction,1,166,165,428,427,421242,5.967247238742566
minoxidil,Diffuse Large B-Cell Lymphoma,1,166,165,58,57,421612,44.07283176593521
minoxidil,Disease recurrence,1,166,165,59,58,421611,43.32573189522342
minoxidil,Dissociation,2,166,164,221,219,421450,23.265312879373138
minoxidil,Drug Allergy,1,166,165,223,222,421447,11.458404674548172
minoxidil,Drug abuse,1,166,165,725,724,420945,3.5202507836990593
minoxidil,Drug action decreased,1,166,165,349,348,421321,7.319371364070504
minoxidil,Dysgraphia,1,166,165,248,247,421422,10.302712609970673
minoxidil,Dyspnea,1,166,165,191,190,421479,13.379152784388388
minoxidil,Emotional distress,1,166,165,483,482,421187,5.2870569044482085
minoxidil,"Encephalopathy, Toxic",1,166,165,13,12,421657,196.65361305361307
minoxidil,Endodontic procedure,1,166,165,71,70,421599,36.00204865556979
minoxidil,Epiphyseal fracture of bone,1,166,165,51,50,421619,50.122875816993464
minoxidil,Eye sensation abnormal,1,166,165,36,35,421634,71.00993265993266
minoxidil,Facial Injuries,1,166,165,420,419,421250,6.081024531024531
minoxidil,Facial swelling (finding),1,166,165,385,384,421285,6.63439590712318
minoxidil,Feeling suicidal (finding),2,166,164,1364,1362,420307,3.759307274157786
minoxidil,Fissure in skin,1,166,165,401,400,421269,6.369440036272954
minoxidil,Flatulence,1,166,165,121,120,421549,21.12266466316053
minoxidil,Foot Deformities,1,166,165,148,147,421522,17.268099918099917
minoxidil,Fracture of acetabulum,1,166,165,8,7,421662,319.5659090909091
minoxidil,"Fractures, Ununited",1,166,165,317,316,421353,8.058847146544307
minoxidil,Gamma-Glutamyltransferase Increased,1,166,165,362,361,421308,7.056303365143144
minoxidil,Gastrointestinal tract mucosal discoloration,1,166,165,10,9,421660,255.65151515151516
minoxidil,Generalized erythema,1,166,165,491,490,421179,5.20081466395112
minoxidil,Genital rash,3,166,163,210,207,421462,36.952234881682735
minoxidil,Hemiplegia,1,166,165,124,123,421546,20.611485826001957
minoxidil,Hernia of abdominal cavity,1,166,165,26,25,421644,98.32377622377622
minoxidil,Hypersomnia,1,166,165,42,41,421628,60.86479076479076
minoxidil,Impetigo,1,166,165,51,50,421619,50.122875816993464
minoxidil,Infective vaginitis,1,166,165,115,114,421555,22.225032938076417
minoxidil,Inflammatory disease of mucous membrane,1,166,165,140,139,421530,18.255194805194805
minoxidil,Internal Carotid Artery Stenosis,1,166,165,99,98,421571,25.817936945209674
minoxidil,Liquid product physical issue,1,166,165,99,98,421571,25.817936945209674
minoxidil,Lymphedema,1,166,165,549,548,421121,4.650725837611083
minoxidil,Madarosis of eyelid,1,166,165,88,87,421582,29.04593663911846
minoxidil,Manic,1,166,165,21,20,421649,121.73564213564214
minoxidil,Metabolic Syndrome X,1,166,165,31,30,421639,82.46412512218964
minoxidil,Metastatic malignant neoplasm to liver,1,166,165,88,87,421582,29.04593663911846
minoxidil,Musculoskeletal stiffness,1,166,165,654,653,421016,3.9030766379390234
minoxidil,Myocardial oedema,1,166,165,130,129,421540,19.65990675990676
minoxidil,Nail Loss,1,166,165,299,298,421371,8.544359987838249
minoxidil,Nasal obstruction present (finding),1,166,165,457,456,421213,5.58819706915987
minoxidil,Neonatal hypotension,1,166,165,9,8,421661,284.05791245791244
minoxidil,Neurodermatitis,1,166,165,69,68,421601,37.0457619675011
minoxidil,Neutrophil count decreased,1,166,165,567,566,421103,4.502891347335791
minoxidil,Obstruction of esophagus,1,166,165,83,82,421587,30.7960569550931
minoxidil,Pain of skin,1,166,165,7,6,421663,365.21904761904756
minoxidil,Peripheral Vascular Diseases,1,166,165,28,27,421642,91.30021645021645
minoxidil,Peripheral edema,1,166,165,553,552,421117,4.617042029700257
minoxidil,Petechiae of skin,1,166,165,417,416,421253,6.124816510428021
minoxidil,Piloerection,1,166,165,40,39,421630,63.90833333333333
minoxidil,Portal Hypertension,1,166,165,274,273,421396,9.324507852245079
minoxidil,Prescribed overdose,1,166,165,253,252,421417,10.098981914001676
minoxidil,Product formulation issue,1,166,165,24,23,421646,106.51792929292928
minoxidil,Product substitution issue,1,166,165,104,103,421566,24.5763986013986
minoxidil,Pseudodementia,1,166,165,7,6,421663,365.21904761904756
minoxidil,Pus in stool,1,166,165,91,90,421579,28.088178488178492
minoxidil,Renal aneurysm,1,166,165,9,8,421661,284.05791245791244
minoxidil,Renin increased,1,166,165,5,4,421665,511.3090909090909
minoxidil,Rotator cuff syndrome,1,166,165,188,187,421482,13.59274661508704
minoxidil,Skin Ulcer,1,166,165,107,106,421563,23.88717077315208
minoxidil,Skin hemorrhages,1,166,165,106,105,421564,24.112578616352202
minoxidil,Skin neoplasm excision,1,166,165,10,9,421660,255.65151515151516
minoxidil,Staphylococcal sepsis,1,166,165,146,145,421524,17.504732254047322
minoxidil,Swelling,1,166,165,185,184,421485,13.813267813267814
minoxidil,Tension,1,166,165,51,50,421619,50.122875816993464
minoxidil,Thoracic Injuries,1,166,165,303,302,421367,8.43148314831483
minoxidil,Thyroid Diseases,1,166,165,155,154,421515,16.487976539589443
minoxidil,Tooth Infection,1,166,165,76,75,421594,33.633094098883575
minoxidil,Tooth Loss,1,166,165,151,150,421519,16.924904675898052
minoxidil,Unconscious State,7,166,159,3942,3935,417734,4.667124564040218
minoxidil,Uterine hemorrhage,1,166,165,329,328,421341,7.764686377452335
minoxidil,Vasculitis,1,166,165,127,126,421543,20.124457170126462
minoxidil,Visual Impairment,1,166,165,486,485,421184,5.254383339568525
minoxidil,Withdrawal hypertension,1,166,165,18,17,421652,142.02592592592592
minoxidil,Wound infection staphylococcal,1,166,165,61,60,421609,41.9050173869846
minoxidil,Xerostomia,1,166,165,768,767,420902,3.3228140782828284
minoxidil,post laminectomy syndrome,1,166,165,105,104,421565,24.342279942279944
nebivolol,Abdominal Neoplasms,1,973,972,21,20,420842,20.665000979815794
nebivolol,Abnormal feces,3,973,970,243,240,420622,5.365813923889525
nebivolol,Abscess of tongue,1,973,972,69,68,420794,6.288632432754816
nebivolol,Activation syndrome,1,973,972,80,79,420783,5.42380401234568
nebivolol,Activities of daily living impaired,1,973,972,114,113,420749,3.8058714172261925
nebivolol,Adams-Stokes Syndrome,1,973,972,25,24,420838,17.35843621399177
nebivolol,Adenomatous Polyposis Coli,1,973,972,33,32,420830,13.150081057488466
nebivolol,Adrenal Gland Neoplasms,2,973,971,13,11,420851,66.83387467321556
nebivolol,Adverse reactions,3,973,970,284,281,420581,4.5907252795121245
nebivolol,Age related macular degeneration,7,973,966,915,908,419954,3.3334917240833137
nebivolol,Agnosia,1,973,972,11,10,420852,39.452300785634115
nebivolol,Amnesia,2,973,971,212,210,420652,4.096370207722053
nebivolol,Analgesic drug level increased,1,973,972,13,12,420850,33.38255777144666
nebivolol,"Anemia, Hemolytic",1,973,972,25,24,420838,17.35843621399177
nebivolol,"Anemia, Pernicious",1,973,972,91,90,420772,4.768054990277213
nebivolol,Aneurysm,1,973,972,10,9,420853,43.397633744855966
nebivolol,"Angina Pectoris, Variant",1,973,972,31,30,420832,13.998539758396388
nebivolol,"Angina, Unstable",1,973,972,46,45,420817,9.433463052424406
nebivolol,Anhedonia,4,973,969,522,518,420344,3.331735920825277
nebivolol,Anuria,3,973,970,93,90,420772,14.025340871300298
nebivolol,Aortic Valve Stenosis,1,973,972,8,7,420855,54.247299382716044
nebivolol,Aortic valve sclerosis,1,973,972,53,52,420810,8.187398089913813
nebivolol,Apathy,1,973,972,97,96,420766,4.473060116244538
nebivolol,Application site rash,3,973,970,28,25,420837,46.59134756995582
nebivolol,Arrested labor,1,973,972,23,22,420840,18.867954911433173
nebivolol,Arteritis,1,973,972,5,4,420858,86.7962962962963
nebivolol,"Arthritis, Gouty",1,973,972,44,43,420819,9.862303591470258
nebivolol,Asthenopia,1,973,972,34,33,420829,12.763283708545146
nebivolol,Ataxia,1,973,972,40,39,420823,10.848636831275721
nebivolol,Atrophy of pancreas,1,973,972,54,53,420809,8.035760554793475
nebivolol,BK virus infection,1,973,972,29,28,420834,14.96402724563644
nebivolol,Benign Neoplasm,1,973,972,10,9,420853,43.397633744855966
nebivolol,Beta globulin above reference range,1,973,972,52,51,420811,8.344867837923394
nebivolol,Biliary Tract Surgical Procedures,1,973,972,5,4,420858,86.7962962962963
nebivolol,Bladder pain,1,973,972,112,111,420751,3.873851778365667
nebivolol,Blepharitis,1,973,972,58,57,420805,7.4814992195260395
nebivolol,Blood 25-hydroxycholecalciferol decreased,1,973,972,59,58,420804,7.354676710608914
nebivolol,Blood Platelet Disorders,1,973,972,40,39,420823,10.848636831275721
nebivolol,Blood count abnormal,1,973,972,27,26,420836,16.072549916171315
nebivolol,Blood glucose outside reference range,5,973,968,668,663,420199,3.2566607487504333
nebivolol,Blood magnesium decreased,1,973,972,37,36,420826,11.728339450561673
nebivolol,Blood potassium decreased,2,973,971,143,141,420721,6.0739343046243155
nebivolol,Body weight problem,2,973,971,112,110,420752,7.755682654112108
nebivolol,Brain Edema,1,973,972,79,78,420784,5.492472782205553
nebivolol,Carbohydrate antigen 19-9 increased,1,973,972,90,89,420773,4.821044810242341
nebivolol,Cardiac Hypertrophy,1,973,972,92,91,420771,4.716217122920021
nebivolol,Cardiomyopathies,1,973,972,32,31,420831,13.56105324074074
nebivolol,Catheter site infection,2,973,971,131,129,420733,6.630513911054158
nebivolol,Cerebral Hemorrhage,1,973,972,63,62,420800,6.887647788882357
nebivolol,Cervix carcinoma,1,973,972,124,123,420739,3.4988633346608253
nebivolol,Chapping of lips,1,973,972,131,130,420732,3.3118461973423803
nebivolol,Chickenpox,1,973,972,27,26,420836,16.072549916171315
nebivolol,Clostridium difficile colitis,1,973,972,29,28,420834,14.96402724563644
nebivolol,Cold Sensation,1,973,972,92,91,420771,4.716217122920021
nebivolol,"Colitis, Ischemic",1,973,972,51,50,420812,8.508512870168643
nebivolol,Complication of transplanted lung,1,973,972,48,47,420815,9.040359224965705
nebivolol,Compression of brain,1,973,972,13,12,420850,33.38255777144666
nebivolol,Connective Tissue Diseases,9,973,964,1120,1111,419751,3.506997443687018
nebivolol,Contrast media allergy,1,973,972,141,140,420722,3.076890523305023
nebivolol,Coronary revascularisation,1,973,972,68,67,420795,6.381127450980392
nebivolol,Death (finding),1,973,972,69,68,420794,6.288632432754816
nebivolol,Decreased mean corpuscular volume,1,973,972,74,73,420789,5.863655321988656
nebivolol,Decreased peak expiratory flow rate,1,973,972,6,5,420857,72.33007544581618
nebivolol,Deficiency of testosterone biosynthesis,1,973,972,5,4,420858,86.7962962962963
nebivolol,Deformity,3,973,970,398,395,420467,3.2749080453815465
nebivolol,Detachment of retinal pigment epithelium,1,973,972,11,10,420852,39.452300785634115
nebivolol,Diastolic dysfunction,2,973,971,109,107,420755,7.969198499607896
nebivolol,Discharge from eye,1,973,972,24,23,420839,18.081747256515776
nebivolol,Dislocation of joint of spine,1,973,972,6,5,420857,72.33007544581618
nebivolol,Disturbance in thinking,2,973,971,113,111,420751,7.687030066622312
nebivolol,Drug clearance decreased,1,973,972,36,35,420827,12.054155235482396
nebivolol,Drug prescribing error,2,973,971,289,287,420575,3.0044009849653803
nebivolol,Drug withdrawal syndrome,1,973,972,134,133,420729,3.2376773539708865
nebivolol,Dry Eye Syndromes,1,973,972,79,78,420784,5.492472782205553
nebivolol,Dwarfism,1,973,972,35,34,420828,12.398589065255731
nebivolol,Dyschezia,1,973,972,13,12,420850,33.38255777144666
nebivolol,EKG: P wave abnormal,1,973,972,50,49,420813,8.678703703703704
nebivolol,Eczema,1,973,972,64,63,420799,6.7800122170781885
nebivolol,Emotional disorder,1,973,972,91,90,420772,4.768054990277213
nebivolol,Endometriosis,1,973,972,67,66,420796,6.476383514526135
nebivolol,Enthesopathy,1,973,972,10,9,420853,43.397633744855966
nebivolol,Eosinophilic pneumonia acute,1,973,972,65,64,420798,6.675688509021843
nebivolol,Epigastric discomfort,1,973,972,18,17,420845,24.109339277549154
nebivolol,Epiglottitis,1,973,972,27,26,420836,16.072549916171315
nebivolol,Epilepsy,1,973,972,101,100,420762,4.295868475736462
nebivolol,Equilibration disorder,9,973,964,928,919,419943,4.2345147285019324
nebivolol,Erythrodermic psoriasis,1,973,972,94,93,420769,4.615850188249715
nebivolol,Euphoric mood,1,973,972,131,130,420732,3.3118461973423803
nebivolol,Extrapyramidal Disorders,1,973,972,13,12,420850,33.38255777144666
nebivolol,Eye Infection,1,973,972,29,28,420834,14.96402724563644
nebivolol,Faecal volume decreased,1,973,972,10,9,420853,43.397633744855966
nebivolol,Falls,1,973,972,72,71,420791,6.026563214449016
nebivolol,Fear (Mental Process),1,973,972,118,117,420745,3.676823952012276
nebivolol,Fracture of wrist,1,973,972,96,95,420767,4.519665209190672
nebivolol,Furred tongue,1,973,972,49,48,420814,8.855841101872848
nebivolol,Gastrointestinal angiodysplasia,1,973,972,83,82,420780,5.227725717685558
nebivolol,Gastrointestinal ulcer,2,973,971,120,118,420744,7.238499828355646
nebivolol,General physical condition abnormal,1,973,972,78,77,420785,5.562902289754141
nebivolol,General symptom,1,973,972,31,30,420832,13.998539758396388
nebivolol,"Heart Failure, Right-Sided",1,973,972,116,115,420747,3.740235206470839
nebivolol,Heart murmur,7,973,966,626,619,420243,4.875781358522017
nebivolol,"Hepatitis, Toxic",2,973,971,81,79,420783,10.724695172343644
nebivolol,"Hernia, Inguinal",1,973,972,17,16,420846,25.527596223674657
nebivolol,Heterophoria,2,973,971,134,132,420730,6.48202345635366
nebivolol,Hiccough,1,973,972,44,43,420819,9.862303591470258
nebivolol,Histoplasmosis,2,973,971,37,35,420827,23.48083613995046
nebivolol,Hyperesthesia,1,973,972,42,41,420821,10.331986086615716
nebivolol,Hyperthyroidism,1,973,972,78,77,420785,5.562902289754141
nebivolol,Hypertrophy,7,973,966,122,115,420747,25.048289379900215
nebivolol,Hypoglycaemic unconsciousness,1,973,972,14,13,420849,30.99801587301587
nebivolol,"Hypotension, Orthostatic",2,973,971,38,36,420826,22.862865195945577
nebivolol,Impaired work ability,4,973,969,270,266,420596,6.445208882773382
nebivolol,Inappropriate schedule of drug administration,1,973,972,139,138,420724,3.1211771323681794
nebivolol,Increased energy,3,973,970,214,211,420651,6.093376047788805
nebivolol,Increased upper airway secretion,8,973,965,352,344,420518,9.926589731512012
nebivolol,Infection of peripheral nerve,2,973,971,192,190,420672,4.523289993134226
nebivolol,Inflammatory disease of mucous membrane,1,973,972,140,139,420723,3.098875661375661
nebivolol,Injection site infection,1,973,972,6,5,420857,72.33007544581618
nebivolol,Injection site nodule,1,973,972,70,69,420793,6.198780129335685
nebivolol,Injection site warmth,1,973,972,37,36,420826,11.728339450561673
nebivolol,Injury of mouth,1,973,972,21,20,420842,20.665000979815794
nebivolol,Intercepted drug administration error,1,973,972,5,4,420858,86.7962962962963
nebivolol,Intraductal Proliferative Lesion of the Breast,2,973,971,34,32,420830,25.5528563639668
nebivolol,Klebsiella bacteraemia,1,973,972,75,74,420788,5.785459533607683
nebivolol,Labile blood pressure,1,973,972,86,85,420777,5.045327304048235
nebivolol,Learning Disorders,1,973,972,52,51,420811,8.344867837923394
nebivolol,Leiomyosarcoma of uterus,2,973,971,73,71,420791,11.900229956407037
nebivolol,Leukocytes in urine (finding),1,973,972,96,95,420767,4.519665209190672
nebivolol,Liver Failure,5,973,968,606,601,420261,3.5903789242560613
nebivolol,Liver function tests abnormal,1,973,972,49,48,420814,8.855841101872848
nebivolol,Liver tender,1,973,972,32,31,420831,13.56105324074074
nebivolol,Loose tooth,1,973,972,41,40,420822,10.584010840108402
nebivolol,Lumbosacral radiculitis,4,973,969,61,57,420805,28.542117105686106
nebivolol,Lymphadenopathy,6,973,967,389,383,420479,6.72228794432201
nebivolol,Lysis of adhesions of tendon,3,973,970,257,254,420608,5.073344297805768
nebivolol,Macrophages increased,1,973,972,47,46,420816,9.232729183083793
nebivolol,Macular Holes,2,973,971,267,265,420597,3.2521243399406767
nebivolol,Macular rash,1,973,972,126,125,420737,3.443309491148997
nebivolol,Madarosis of eyelid,1,973,972,88,87,420775,4.930637392442948
nebivolol,Malignant melanoma in situ,2,973,971,53,51,420811,16.39166002759264
nebivolol,Malignant neoplasm of parietal pleura,2,973,971,10,8,420854,86.88465499485068
nebivolol,Mass of pancreas,1,973,972,44,43,420819,9.862303591470258
nebivolol,Mass of thyroid gland,1,973,972,19,18,420844,22.840372536278966
nebivolol,Mastication disorder,2,973,971,165,163,420699,5.263801766376432
nebivolol,Medical device complication,1,973,972,63,62,420800,6.887647788882357
nebivolol,Meningioma,1,973,972,123,122,420740,3.527317742313226
nebivolol,Metabolic acidosis,1,973,972,25,24,420838,17.35843621399177
nebivolol,Metastatic malignant neoplasm to pancreas,1,973,972,99,98,420764,4.3826744814399134
nebivolol,Metastatic malignant neoplasm to spleen,1,973,972,24,23,420839,18.081747256515776
nebivolol,Migraine Aura without Headache,1,973,972,66,65,420797,6.574526125452051
nebivolol,Miosis disorder,5,973,968,185,180,420682,11.77267143176234
nebivolol,Mitral Valve Insufficiency,1,973,972,84,83,420779,5.165478640015677
nebivolol,Mood Disorders,1,973,972,18,17,420845,24.109339277549154
nebivolol,Myeloproliferative disease,1,973,972,58,57,420805,7.4814992195260395
nebivolol,Myocardial Infarction,4,973,969,150,146,420716,11.6046783625731
nebivolol,Myocardial oedema,1,973,972,130,129,420733,3.3373298512187404
nebivolol,"Nails, Ingrown",1,973,972,34,33,420829,12.763283708545146
nebivolol,Nasal Polyp,1,973,972,26,25,420837,16.69076448243115
nebivolol,Nephrogenic Systemic Fibrosis,1,973,972,62,61,420801,6.998755475906012
nebivolol,Neurologic Deficits,4,973,969,537,533,420329,3.2385553653000945
nebivolol,No adverse event,1,973,972,132,131,420731,3.2867486594338446
nebivolol,Nuclear magnetic resonance imaging spinal abnormal,1,973,972,88,87,420775,4.930637392442948
nebivolol,Operative procedure on foot,1,973,972,18,17,420845,24.109339277549154
nebivolol,Osteochondrosis,6,973,967,10,4,420858,261.73216132368145
nebivolol,Pancreatic Enzymes Decreased,1,973,972,9,8,420854,48.219707361682666
nebivolol,Paranasal sinus hypersecretion,1,973,972,17,16,420846,25.527596223674657
nebivolol,Paronychia (disorder),1,973,972,12,11,420851,36.16452331961591
nebivolol,Percutaneous Coronary Intervention,1,973,972,6,5,420857,72.33007544581618
nebivolol,Perforation of small intestine,1,973,972,127,126,420736,3.416188717151097
nebivolol,Pericarditis,1,973,972,42,41,420821,10.331986086615716
nebivolol,Periorbital edema,1,973,972,46,45,420817,9.433463052424406
nebivolol,Peripheral arterial occlusive disease,3,973,970,147,144,420718,8.872038712392172
nebivolol,Peritonitis,1,973,972,70,69,420793,6.198780129335685
nebivolol,Petechiae of skin,3,973,970,417,414,420448,3.125550693465846
nebivolol,Pharyngitis,2,973,971,108,106,420756,8.043006446199032
nebivolol,Pigmentation of eyelids,1,973,972,127,126,420736,3.416188717151097
nebivolol,"Pneumonia, Bacterial",1,973,972,79,78,420784,5.492472782205553
nebivolol,Polyp of esophagus,1,973,972,25,24,420838,17.35843621399177
nebivolol,Postoperative adhesion,1,973,972,55,54,420808,7.889637111859334
nebivolol,Premature Obstetric Labor,1,973,972,44,43,420819,9.862303591470258
nebivolol,Product deposit,1,973,972,87,86,420776,4.987323210822573
nebivolol,Prostatic Diseases,2,973,971,213,211,420651,4.077128752604884
nebivolol,Protein total decreased,1,973,972,44,43,420819,9.862303591470258
nebivolol,Protein total increased,2,973,971,102,100,420762,8.516245633165727
nebivolol,Proteus Infections,1,973,972,23,22,420840,18.867954911433173
nebivolol,Pseudo-Bartter syndrome,1,973,972,42,41,420821,10.331986086615716
nebivolol,Psychomotor Impairment,1,973,972,27,26,420836,16.072549916171315
nebivolol,Pulmonary Embolism,1,973,972,113,112,420750,3.8395607997377907
nebivolol,Pulmonary artery stenosis,1,973,972,11,10,420852,39.452300785634115
nebivolol,Pulmonary vascular disorder,6,973,967,517,511,420351,5.056432884811947
nebivolol,Purulent discharge,4,973,969,156,152,420710,11.158185811436585
nebivolol,Pyloric Stenosis,1,973,972,28,27,420835,15.498493533215756
nebivolol,Rales,9,973,964,375,366,420496,10.492780082987553
nebivolol,Rapid correction of hyponatraemia,1,973,972,19,18,420844,22.840372536278966
nebivolol,Reading disorder,1,973,972,78,77,420785,5.562902289754141
nebivolol,Renal Insufficiency,8,973,965,907,899,419963,3.8473633398266793
nebivolol,Repair of inguinal hernia,1,973,972,132,131,420731,3.2867486594338446
nebivolol,Respiratory Failure,2,973,971,45,43,420819,19.30609909600641
nebivolol,Respiratory distress,1,973,972,99,98,420764,4.3826744814399134
nebivolol,Retinal Degeneration,1,973,972,5,4,420858,86.7962962962963
nebivolol,Retinal artery embolism,1,973,972,21,20,420842,20.665000979815794
nebivolol,Retinal pigment epitheliopathy,2,973,971,19,17,420845,45.72779012412596
nebivolol,Saliva altered,1,973,972,49,48,420814,8.855841101872848
nebivolol,Short Bowel Syndrome,1,973,972,23,22,420840,18.867954911433173
nebivolol,Sinus bradycardia,1,973,972,142,141,420721,3.0552150350663654
nebivolol,Skin Erosion,1,973,972,16,15,420847,27.123135288065846
nebivolol,Spinal Fractures,1,973,972,104,103,420759,4.171919515669516
nebivolol,Sputum retention,1,973,972,8,7,420855,54.247299382716044
nebivolol,Squamous cell carcinoma of tongue,11,973,962,407,396,420466,11.839860650671463
nebivolol,Staghorn Calculi,1,973,972,108,107,420755,4.0173658741045575
nebivolol,Status Asthmaticus,2,973,971,102,100,420762,8.516245633165727
nebivolol,Strabismus,7,973,966,804,797,420065,3.7947130290576103
nebivolol,Subarachnoid Hemorrhage,1,973,972,15,14,420848,28.93141289437586
nebivolol,Subclavian artery embolism,1,973,972,39,38,420824,11.126833386092644
nebivolol,Substance Withdrawal Syndrome,2,973,971,255,253,420609,3.405262413925405
nebivolol,Sudden death,1,973,972,60,59,420803,7.232081618655693
nebivolol,Sudden onset of sleep,1,973,972,29,28,420834,14.96402724563644
nebivolol,Superior vena cava stenosis,1,973,972,28,27,420835,15.498493533215756
nebivolol,Swelling of skeletal muscle,3,973,970,27,24,420838,48.31706758304696
nebivolol,Synovial Cyst,1,973,972,84,83,420779,5.165478640015677
nebivolol,T-Lymphocytopenia,1,973,972,48,47,420815,9.040359224965705
nebivolol,Tenosynovitis,2,973,971,38,36,420826,22.862865195945577
nebivolol,Thermal burn,2,973,971,174,172,420690,4.9914296198965395
nebivolol,Throat irritation,2,973,971,132,130,420732,6.580267141029243
nebivolol,Tibial Fractures,1,973,972,22,21,420841,19.72563598952488
nebivolol,Trismus,1,973,972,14,13,420849,30.99801587301587
nebivolol,Tumor pain,1,973,972,13,12,420850,33.38255777144666
nebivolol,Ulcer of pharynx,1,973,972,11,10,420852,39.452300785634115
nebivolol,Ulceration of gingivae,10,973,963,1062,1052,419810,4.114310466546592
nebivolol,Ultrasonography of kidney abnormal,1,973,972,62,61,420801,6.998755475906012
nebivolol,Uremic encephalopathy,1,973,972,6,5,420857,72.33007544581618
nebivolol,Urine albumin/creatinine ratio increased,1,973,972,13,12,420850,33.38255777144666
nebivolol,Urinoma,1,973,972,18,17,420845,24.109339277549154
nebivolol,Vaccination site swelling,1,973,972,76,75,420787,5.709321529131471
nebivolol,Vascular occlusion,1,973,972,76,75,420787,5.709321529131471
nebivolol,Vitamin D Deficiency,2,973,971,189,187,420675,4.595120941155956
nebivolol,Weaning failure,1,973,972,16,15,420847,27.123135288065846
nebivolol,Wheelchair user,1,973,972,13,12,420850,33.38255777144666
nebivolol,Withdrawal hypertension,1,973,972,18,17,420845,24.109339277549154
nebivolol,Withdrawal of life support,1,973,972,16,15,420847,27.123135288065846
nebivolol,Wound of skin,3,973,970,156,153,420709,8.360011895321174
nebivolol,Wrong drug administered,1,973,972,25,24,420838,17.35843621399177
nicardipine,ADAMTS13 activity decreased,3,1574,1571,11,8,420253,73.22909553845264
nicardipine,Abnormal breathing,3,1574,1571,5,2,420259,161.10630171865054
nicardipine,Abnormal feces,8,1574,1566,243,235,420026,8.8630728074463
nicardipine,Abnormal heart beat,19,1574,1555,43,24,420237,119.8541538921708
nicardipine,Abnormal mean corpuscular volume,1,1574,1573,14,13,420248,19.154527290890925
nicardipine,Activities of daily living impaired,2,1574,1572,114,112,420149,4.70649747779117
nicardipine,Acute Promyelocytic Leukemia,6,1574,1568,17,11,420250,94.94702881152462
nicardipine,Acute lymphocytic leukemia,4,1574,1570,64,60,420201,16.790246815286626
nicardipine,Acute pyelonephritis,2,1574,1572,133,131,420130,4.033958943159425
nicardipine,Adrenal Cortical Adenoma,1,1574,1573,35,34,420227,7.661429479611297
nicardipine,Alanine Aminotransferase Increased,36,1574,1538,188,152,420109,52.49734388401627
nicardipine,Amputation,2,1574,1572,24,22,420239,22.36063401187447
nicardipine,Anaphylactic shock,1,1574,1573,79,78,420183,3.393950123524347
nicardipine,"Anemia, Hemolytic",1,1574,1573,25,24,420237,10.7262555626192
nicardipine,Anorectal swelling,1,1574,1573,5,4,420257,53.633820724729816
nicardipine,Antipsychotic drug level increased,7,1574,1567,293,286,419975,6.426910838083249
nicardipine,Anuria,2,1574,1572,93,91,420170,5.769542258338122
nicardipine,Aortic surgery,1,1574,1573,10,9,420252,26.81659249841068
nicardipine,Apallic syndrome,6,1574,1568,198,192,420069,8.148519635126778
nicardipine,Ascites,5,1574,1569,101,96,420165,13.306514207826137
nicardipine,Ataxia,5,1574,1569,40,35,420226,33.603808158062456
nicardipine,Bacterial test,1,1574,1573,42,41,420220,6.384418611691339
nicardipine,Balanitis,4,1574,1570,83,79,420182,12.946113114879902
nicardipine,Benign neoplasm of pericardium,3,1574,1571,57,54,420207,14.130389627793225
nicardipine,Bilirubin conjugated increased,5,1574,1569,426,421,419840,3.1523996325520574
nicardipine,Blindness,2,1574,1572,141,139,420122,3.8050096547741505
nicardipine,Blood Platelet Disorders,3,1574,1571,40,37,420224,20.136616804583067
nicardipine,Blood albumin increased,1,1574,1573,13,12,420249,20.62800136926011
nicardipine,Blood growth hormone increased,2,1574,1572,11,9,420252,48.788341429562806
nicardipine,Blood pressure fluctuation,3,1574,1571,204,201,420060,3.9468210581495486
nicardipine,Blood testosterone free abnormal,3,1574,1571,26,23,420238,30.980438721049797
nicardipine,Blood uric acid abnormal,1,1574,1573,10,9,420252,26.81659249841068
nicardipine,Blurred vision,3,1574,1571,218,215,420046,3.6932328499932843
nicardipine,Brain Concussion,2,1574,1572,163,161,420100,3.291278352768541
nicardipine,Brain Death,3,1574,1571,221,218,420043,3.643072545083254
nicardipine,Brain Edema,3,1574,1571,79,76,420185,10.194812624386628
nicardipine,Brain natriuretic peptide decreased,3,1574,1571,22,19,420242,36.61359296337017
nicardipine,Bronchopneumonia,1,1574,1573,57,56,420205,4.70414115390192
nicardipine,Brucellosis,2,1574,1572,69,67,420194,7.7767820924143525
nicardipine,CNS metastases,3,1574,1571,91,88,420173,8.850189911934024
nicardipine,Calcium deposits in tendon,1,1574,1573,65,64,420197,4.125091691525259
nicardipine,Candida infection of genital region,3,1574,1571,6,3,420258,134.25493316359007
nicardipine,Carbon monoxide diffusing capacity measurement,2,1574,1572,31,29,420232,17.31117130427645
nicardipine,Cardiovascular stress testing,1,1574,1573,76,75,420186,3.5279469334493254
nicardipine,Catatonia,4,1574,1570,100,96,420165,10.74484076433121
nicardipine,Cerebral Thrombosis,7,1574,1567,325,318,419943,5.7936674684600655
nicardipine,Cerebrospinal fluid leak,1,1574,1573,70,69,420192,3.830396875851421
nicardipine,Chemical peritonitis,2,1574,1572,84,82,420179,6.387843814370531
nicardipine,Chills,10,1574,1564,670,660,419601,4.019210214910104
nicardipine,Chondroplasty,1,1574,1573,87,86,420175,3.0818042981052387
nicardipine,Chronic Fatigue Syndrome,1,1574,1573,62,61,420200,4.324723663433341
nicardipine,Chronic throat clearing,18,1574,1556,33,15,420246,147.86235101659264
nicardipine,Chvostek sign,4,1574,1570,8,4,420257,134.33980891719744
nicardipine,Cleft upper lip,1,1574,1573,11,10,420251,24.378662659654395
nicardipine,Clostridial gastroenteritis,3,1574,1571,7,4,420257,115.07538419568974
nicardipine,Clostridium difficile colitis,1,1574,1573,29,28,420233,9.246684350132625
nicardipine,Cognition Disorders,1,1574,1573,13,12,420249,20.62800136926011
nicardipine,Colitis,2,1574,1572,175,173,420088,3.065503453289713
nicardipine,Connective Tissue Diseases,21,1574,1553,1120,1099,419162,5.079463135866066
nicardipine,Contrast media allergy,5,1574,1569,141,136,420125,9.53071251960638
nicardipine,Contusion of liver,1,1574,1573,14,13,420248,19.154527290890925
nicardipine,Corneal dystrophy,1,1574,1573,50,49,420212,5.362809917355372
nicardipine,Cortical cataract,3,1574,1571,108,105,420156,7.456803875804512
nicardipine,Coughing,2,1574,1572,145,143,420118,3.700008774238835
nicardipine,Cushingoid,1,1574,1573,45,44,420217,5.958748322384686
nicardipine,De Quervain Disease,2,1574,1572,175,173,420088,3.065503453289713
nicardipine,Decreased platelet count,3,1574,1571,245,242,420019,3.2860130684992006
nicardipine,Deformity of spine,3,1574,1571,17,14,420247,47.38285842662973
nicardipine,Dependent edema,3,1574,1571,72,69,420192,11.18616061956291
nicardipine,Diabetic metabolic decompensation,1,1574,1573,6,5,420256,44.6947446492901
nicardipine,Disease of mucous membrane,1,1574,1573,29,28,420233,9.246684350132625
nicardipine,Disease recurrence,1,1574,1573,59,58,420203,4.544657191806652
nicardipine,Disorder of middle ear,6,1574,1568,18,12,420249,89.671981292517
nicardipine,Disseminated Intravascular Coagulation,1,1574,1573,42,41,420220,6.384418611691339
nicardipine,Disturbance in sexual arousal,1,1574,1573,11,10,420251,24.378662659654395
nicardipine,Down Syndrome,2,1574,1572,6,4,420257,89.446352841391
nicardipine,Drug prescribing error,8,1574,1566,289,281,419980,7.4515283688413385
nicardipine,Duodenal ulcer perforation,8,1574,1566,29,21,420240,74.3041352886775
nicardipine,Dysfunction of urinary bladder,2,1574,1572,9,7,420254,59.63047780605032
nicardipine,Edema of esophagus,6,1574,1568,325,319,419942,4.962833594976453
nicardipine,Edema of mouth,3,1574,1571,15,12,420249,53.70082749840866
nicardipine,Elective Surgical Procedures,1,1574,1573,65,64,420197,4.125091691525259
nicardipine,Electrocardiogram QT borderline prolonged,1,1574,1573,7,6,420255,38.3096903096903
nicardipine,Electrocardiogram repolarisation abnormality,2,1574,1572,35,33,420228,15.332606324972737
nicardipine,Elevated circulating hepatic transaminase concentration,4,1574,1570,193,189,420072,5.5660473251707865
nicardipine,Elevated hemoglobin A1c,2,1574,1572,24,22,420239,22.36063401187447
nicardipine,Enamel anomaly,1,1574,1573,20,19,420242,13.407978385251115
nicardipine,Enterococcal infection,1,1574,1573,31,30,420231,8.650083054775136
nicardipine,Eosinophilic pneumonia acute,1,1574,1573,65,64,420197,4.125091691525259
nicardipine,Epididymal Cyst,13,1574,1561,22,9,420252,159.6752955564615
nicardipine,Eructation,10,1574,1564,478,468,419793,5.63618925831202
nicardipine,Erythrocyanosis,4,1574,1570,245,241,420020,4.384141427271546
nicardipine,Erythropenia,1,1574,1573,8,7,420254,33.520899554990464
nicardipine,Escherichia test positive,1,1574,1573,16,15,420246,16.760131913541006
nicardipine,Esophageal Diseases,3,1574,1571,150,147,420114,5.368364099299809
nicardipine,Esophageal carcinoma,1,1574,1573,79,78,420183,3.393950123524347
nicardipine,Eye pain,1,1574,1573,70,69,420192,3.830396875851421
nicardipine,Factor VIII Deficiency,3,1574,1571,144,141,420120,5.592125503925312
nicardipine,Fear (Mental Process),3,1574,1571,118,115,420146,6.824709512455632
nicardipine,Feeling intoxicated,7,1574,1567,101,94,420167,18.65289668724371
nicardipine,Femoral Fractures,1,1574,1573,77,76,420185,3.4821211846005236
nicardipine,Femoral artery embolus,2,1574,1572,20,18,420243,26.833015267175576
nicardipine,Flatulence,2,1574,1572,121,119,420142,4.434147162113852
nicardipine,Foetal exposure during pregnancy,3,1574,1571,152,149,420112,5.297702603102281
nicardipine,Food craving,6,1574,1568,369,363,419898,4.3706031192965
nicardipine,Food intolerance (disorder),1,1574,1573,80,79,420182,3.351517800381437
nicardipine,Functional Gastrointestinal Disorders,1,1574,1573,43,42,420219,6.235928975886693
nicardipine,Furunculosis of skin AND/OR subcutaneous tissue,1,1574,1573,16,15,420246,16.760131913541006
nicardipine,Fusariosis,2,1574,1572,115,113,420148,4.665560349596195
nicardipine,Gallstone ileus,3,1574,1571,88,85,420176,9.15196603205833
nicardipine,Gastroenteritis norovirus,9,1574,1565,202,193,420068,12.003596621642995
nicardipine,Gastrointestinal carcinoma,38,1574,1536,350,312,419949,29.792466517857143
nicardipine,Gastrointestinal inflammation,2,1574,1572,89,87,420174,6.028904708808645
nicardipine,Gingival discolouration,4,1574,1570,113,109,420152,9.508415534637281
nicardipine,Graft versus host disease in skin,1,1574,1573,16,15,420246,16.760131913541006
nicardipine,HELLP Syndrome,27,1574,1547,405,378,419883,18.16117216117216
nicardipine,Haematotoxicity,1,1574,1573,27,26,420235,9.931671022580113
nicardipine,Hand deformities,1,1574,1573,65,64,420197,4.125091691525259
nicardipine,"Heart Failure, Right-Sided",6,1574,1568,116,110,420151,13.91138502814919
nicardipine,Heart failure,3,1574,1571,187,184,420077,4.305796573591534
nicardipine,Heart murmur,9,1574,1565,626,617,419644,3.869469934366993
nicardipine,"Hemianopsia, Homonymous",1,1574,1573,8,7,420254,33.520899554990464
nicardipine,Hemorrhagic cerebral infarction,1,1574,1573,14,13,420248,19.154527290890925
nicardipine,Humeral Fractures,1,1574,1573,71,70,420191,3.7764386701646626
nicardipine,Hypertensive Retinopathy,3,1574,1571,5,2,420259,161.10630171865054
nicardipine,Hypertensive heart disease,5,1574,1569,122,117,420144,11.015500109707551
nicardipine,Hypervolemia (finding),2,1574,1572,117,115,420146,4.585785433113678
nicardipine,Hypoparathyroidism,3,1574,1571,262,259,420002,3.072674573981662
nicardipine,Hyporeflexia,3,1574,1571,10,7,420254,80.55219605346913
nicardipine,Hypovolemia,2,1574,1572,59,57,420204,9.095096390218657
nicardipine,Impaired judgement,1,1574,1573,38,37,420224,7.056529594807106
nicardipine,Impaired work ability,6,1574,1568,270,264,419997,5.974560657596372
nicardipine,Incision site vesicles,1,1574,1573,8,7,420254,33.520899554990464
nicardipine,Incorrect dose administered,3,1574,1571,195,192,420069,4.129070165989326
nicardipine,Increased anteroposterior chest diameter,1,1574,1573,45,44,420217,5.958748322384686
nicardipine,Increased appetite (finding),1,1574,1573,79,78,420183,3.393950123524347
nicardipine,Increased fibrinolysis (finding),1,1574,1573,24,23,420238,11.173209366391184
nicardipine,Infection of kidney,1,1574,1573,63,62,420199,4.256067165158074
nicardipine,Infective vaginitis,4,1574,1570,115,111,420150,9.343007477153144
nicardipine,Infusion site induration,5,1574,1569,6,1,420260,224.04344593159126
nicardipine,Injection site cyst,1,1574,1573,8,7,420254,33.520899554990464
nicardipine,Injection site indentation,1,1574,1573,17,16,420245,15.774204405220448
nicardipine,Injection site warmth,2,1574,1572,37,35,420226,14.503748022831994
nicardipine,Intentional drug misuse,1,1574,1573,26,25,420236,10.313682820675828
nicardipine,Intestinal metaplasia,1,1574,1573,71,70,420191,3.7764386701646626
nicardipine,Intraocular haematoma,2,1574,1572,5,3,420258,107.33587786259542
nicardipine,Involuntary muscle contraction,7,1574,1567,52,45,420216,36.233874134799464
nicardipine,Keratosis pilaris,3,1574,1571,10,7,420254,80.55219605346913
nicardipine,Klebsiella bacteraemia,1,1574,1573,75,74,420187,3.5749947022674298
nicardipine,Kyphosis deformity of spine,1,1574,1573,42,41,420220,6.384418611691339
nicardipine,"Leukoencephalopathy, Progressive Multifocal",5,1574,1569,219,214,420047,6.135077165748477
nicardipine,Ligament rupture,1,1574,1573,84,83,420178,3.1918914418914417
nicardipine,Limb operation,3,1574,1571,138,135,420126,5.8353444219965125
nicardipine,Lip swelling,6,1574,1568,372,366,419895,4.335325460829493
nicardipine,Lipids outside reference range,12,1574,1562,202,190,420071,16.03553453936943
nicardipine,Liver function tests abnormal,3,1574,1571,49,46,420215,16.437703789345147
nicardipine,Liver tender,1,1574,1573,32,31,420230,8.379748092816275
nicardipine,Lumpectomy of breast,3,1574,1571,37,34,420227,21.769470297796207
nicardipine,Lymph node excision,3,1574,1571,33,30,420231,24.40842543834269
nicardipine,Lymphadenitis,2,1574,1572,28,26,420235,19.166075972373683
nicardipine,Malignant tumor of nasal sinuses,1,1574,1573,14,13,420248,19.154527290890925
nicardipine,Maternal drugs affecting foetus,22,1574,1552,92,70,420191,64.98169262662483
nicardipine,Mean cell haemoglobin increased,3,1574,1571,159,156,420105,5.0643863420727095
nicardipine,Mental disorder due to a general medical condition,4,1574,1570,338,334,419927,3.177152979308785
nicardipine,Metabolic alkalosis,3,1574,1571,113,110,420151,7.126772305560406
nicardipine,Metastatic malignant neoplasm to spleen,4,1574,1570,24,20,420241,44.77823779193206
nicardipine,Middle insomnia,3,1574,1571,156,153,420108,5.161815110414729
nicardipine,Miosis disorder,7,1574,1567,185,178,420083,10.181445005950431
nicardipine,Mole excision,3,1574,1571,82,79,420182,9.821761810870813
nicardipine,Monocyte percentage increased,1,1574,1573,28,27,420234,9.576945781491236
nicardipine,Multiple Organ Failure,1,1574,1573,80,79,420182,3.351517800381437
nicardipine,Multiple allergies,3,1574,1571,99,96,420165,8.13486873830604
nicardipine,Myelofibrosis,2,1574,1572,57,55,420206,9.414267220213382
nicardipine,Necrosis of kidney,1,1574,1573,9,8,420253,29.796284523557247
nicardipine,Neglected appearance,1,1574,1573,7,6,420255,38.3096903096903
nicardipine,Neonatal hypoglycemia,3,1574,1571,25,22,420239,32.21973265436028
nicardipine,Neutropenia,1,1574,1573,21,20,420241,12.769472951291132
nicardipine,Oligohydramnios,3,1574,1571,8,5,420256,100.69072246976448
nicardipine,Operation on gallbladder,1,1574,1573,17,16,420245,15.774204405220448
nicardipine,Orbital swelling,3,1574,1571,158,155,420106,5.096451506337171
nicardipine,Ovarian cancer stage IV,3,1574,1571,21,18,420243,38.35718832408838
nicardipine,Palatal edema,1,1574,1573,68,67,420194,3.943074305373771
nicardipine,Pancreatic carcinoma stage III,1,1574,1573,6,5,420256,44.6947446492901
nicardipine,Pelvic haemorrhage,2,1574,1572,93,91,420170,5.769542258338122
nicardipine,Peptostreptococcus infection,1,1574,1573,6,5,420256,44.6947446492901
nicardipine,Perforation of nasal septum,3,1574,1571,186,183,420078,4.32895628426521
nicardipine,Perforation of small intestine,3,1574,1571,127,124,420137,6.340933354050031
nicardipine,Performance status decreased,1,1574,1573,25,24,420237,10.7262555626192
nicardipine,Periarthritis,2,1574,1572,52,50,420211,10.31960755529458
nicardipine,Peripheral embolism,1,1574,1573,5,4,420257,53.633820724729816
nicardipine,Peritoneal Dialysis,1,1574,1573,12,11,420250,22.347054460690824
nicardipine,Pilonidal Cyst,1,1574,1573,41,40,420221,6.540151644364506
nicardipine,Pneumococcal sepsis,2,1574,1572,31,29,420232,17.31117130427645
nicardipine,Pneumonitis,3,1574,1571,55,52,420209,14.644291418320698
nicardipine,Poisoning by parasympathomimetic drug,5,1574,1569,184,179,420082,7.302681713636489
nicardipine,Polydactyly,31,1574,1543,343,312,419949,24.688288499364194
nicardipine,"Polyradiculoneuropathy, Chronic Inflammatory Demyelinating",3,1574,1571,28,25,420236,28.767413840138218
nicardipine,Positron emission tomogram abnormal,1,1574,1573,9,8,420253,29.796284523557247
nicardipine,Post procedural hematoma,4,1574,1570,15,11,420250,71.64670912951168
nicardipine,Postural dizziness,1,1574,1573,36,35,420226,7.448594334957971
nicardipine,Pre-existing condition improved,1,1574,1573,12,11,420250,22.347054460690824
nicardipine,Precancerous cells present,4,1574,1570,123,119,420142,8.735166485422818
nicardipine,Pregnancy associated hypertension,2,1574,1572,52,50,420211,10.31960755529458
nicardipine,Pregnancy on oral contraceptive,1,1574,1573,6,5,420256,44.6947446492901
nicardipine,Premature Birth,4,1574,1570,61,57,420204,17.616121958859768
nicardipine,Preterm premature rupture of membranes (disorder),26,1574,1548,163,137,420124,43.44997701368082
nicardipine,Procedural vomiting,4,1574,1570,24,20,420241,44.77823779193206
nicardipine,Product availability issue,3,1574,1571,146,143,420118,5.515494885902879
nicardipine,Prostate examination abnormal,7,1574,1567,15,8,420253,125.62178259944693
nicardipine,Protein total decreased,1,1574,1573,44,43,420218,6.094188868982258
nicardipine,Pulpitis,1,1574,1573,15,14,420247,17.877516422970967
nicardipine,Pyoderma,1,1574,1573,10,9,420252,26.81659249841068
nicardipine,Reading disorder,2,1574,1572,78,76,420185,6.879314281986038
nicardipine,Red blood cell analysis abnormal,2,1574,1572,130,128,420133,4.127079663339205
nicardipine,Reflux gastritis,2,1574,1572,25,23,420238,21.46615776081425
nicardipine,Renal Osteodystrophy,5,1574,1569,37,32,420229,36.32869963653903
nicardipine,Respiratory tract congestion,4,1574,1570,337,333,419928,3.186588293107033
nicardipine,Retrognathia,2,1574,1572,14,12,420249,38.33342420937841
nicardipine,Retroperitoneal hematoma,1,1574,1573,18,17,420244,14.897824397824397
nicardipine,"Sarcoidosis, Pulmonary",2,1574,1572,9,7,420254,59.63047780605032
nicardipine,Secondary malignant neoplasm of ovary,3,1574,1571,9,6,420255,89.50265223848928
nicardipine,Septic Shock,3,1574,1571,226,223,420038,3.5624313469240603
nicardipine,"Shock, Hemorrhagic",1,1574,1573,11,10,420251,24.378662659654395
nicardipine,Shone complex,3,1574,1571,11,8,420253,73.22909553845264
nicardipine,Shortened QT interval,1,1574,1573,6,5,420256,44.6947446492901
nicardipine,Shortened therapeutic response,2,1574,1572,7,5,420256,76.66812068338785
nicardipine,Skin sensitisation,3,1574,1571,38,35,420226,21.196539247545978
nicardipine,Skin tightness,18,1574,1556,174,156,420105,28.033485506604027
nicardipine,Splenic cyst,1,1574,1573,20,19,420242,13.407978385251115
nicardipine,Splenic hematoma,4,1574,1570,9,5,420256,119.41288039631988
nicardipine,Stage I Renal Cell Carcinoma,1,1574,1573,19,18,420243,14.113694917522666
nicardipine,Stage IVB Vaginal Cancer AJCC v6 and v7,1,1574,1573,6,5,420256,44.6947446492901
nicardipine,Staphylococcal Infections,36,1574,1538,2882,2846,417415,3.4026516768354584
nicardipine,Stenotrophomonas test positive,4,1574,1570,6,2,420259,179.12059447983015
nicardipine,Substance Abuse Problems,2,1574,1572,123,121,420140,4.36202652102857
nicardipine,Superficial phlebitis,3,1574,1571,92,89,420172,8.753971438850911
nicardipine,Surgical Wound Infection,2,1574,1572,12,10,420251,44.72254028837998
nicardipine,Swelling,3,1574,1571,185,182,420079,4.352366370189413
nicardipine,Tenderness of gums,1,1574,1573,31,30,420231,8.650083054775136
nicardipine,Therapeutic product ineffective,3,1574,1571,57,54,420207,14.130389627793225
nicardipine,Thermal burn,2,1574,1572,174,172,420089,3.083128601093855
nicardipine,Thrombosis,1,1574,1573,26,25,420236,10.313682820675828
nicardipine,Tooth Fractures,3,1574,1571,98,95,420166,8.21789708881643
nicardipine,Tracheal oedema,8,1574,1566,684,676,419585,3.1454295594243162
nicardipine,Traumatic skin ulcer,3,1574,1571,37,34,420227,21.769470297796207
nicardipine,Tumor Progression,4,1574,1570,35,31,420230,30.70427661510464
nicardipine,Ulcerative Colitis,2,1574,1572,156,154,420107,3.4390210086774973
nicardipine,Ultrasound Doppler abnormal,1,1574,1573,15,14,420247,17.877516422970967
nicardipine,Urine calcium increased,1,1574,1573,15,14,420247,17.877516422970967
nicardipine,Urine osmolarity decreased,7,1574,1567,20,13,420248,94.21522016592215
nicardipine,Uveitis,2,1574,1572,92,90,420171,5.832268503153004
nicardipine,Venoocclusive disease,3,1574,1571,47,44,420217,17.137261806411416
nicardipine,Verbal repetition,3,1574,1571,35,32,420229,23.01354914976812
nicardipine,Visual field defects,2,1574,1572,28,26,420235,19.166075972373683
nicardipine,Vulvovaginal rash,1,1574,1573,25,24,420237,10.7262555626192
nicardipine,Wound of skin,12,1574,1562,156,144,420117,20.766226731015465
nicardipine,prostatitis,5,1574,1569,150,145,420116,8.958678563841088
nifedipine,Abdomen distended,1,1410,1409,83,82,420343,3.6063515951670415
nifedipine,Abnormal blood pressure,1,1410,1409,29,28,420397,10.322948532830818
nifedipine,Abnormal glomerular filtration rate,1,1410,1409,30,29,420396,9.978826590962857
nifedipine,Abnormal hair growth,1,1410,1409,23,22,420403,13.016076773536582
nifedipine,Abnormal heart beat,1,1410,1409,43,42,420383,6.961757472725171
nifedipine,Absent response to treatment,1,1410,1409,5,4,420421,59.87650816181689
nifedipine,Accessory nipple,1,1410,1409,6,5,420420,49.896971847646086
nifedipine,Acidosis,4,1410,1406,157,153,420272,7.641101376267317
nifedipine,Adenoidal disorder,1,1410,1409,15,14,420411,19.958362905133665
nifedipine,Alanine Aminotransferase Increased,5,1410,1405,188,183,420242,7.981506019535095
nifedipine,Alcohol poisoning,1,1410,1409,94,93,420332,3.1842486749316703
nifedipine,"Alzheimer Disease, Late Onset",1,1410,1409,80,79,420346,3.741616394606104
nifedipine,Anaemia postoperative,1,1410,1409,29,28,420397,10.322948532830818
nifedipine,Anemia due to blood loss,1,1410,1409,12,11,420414,24.948131062219066
nifedipine,"Angioedemas, Hereditary",1,1410,1409,22,21,420404,13.607748887024968
nifedipine,Angiogram peripheral abnormal,1,1410,1409,10,9,420416,29.937899219304473
nifedipine,Anorectal cellulitis,1,1410,1409,32,31,420394,9.355105571327183
nifedipine,Anti-DNA antibodies positive,1,1410,1409,5,4,420421,59.87650816181689
nifedipine,Anti-nuclear factor positive,1,1410,1409,12,11,420414,24.948131062219066
nifedipine,Anuria,2,1410,1408,93,91,420334,6.4415628054740965
nifedipine,Appetite Disorders,1,1410,1409,79,78,420347,3.788987611287294
nifedipine,Application site burn,1,1410,1409,9,8,420417,33.26441132402807
nifedipine,Application site hypersensitivity,1,1410,1409,5,4,420421,59.87650816181689
nifedipine,Apraxias,1,1410,1409,39,38,420387,7.675856672308056
nifedipine,Arterial Dissection,1,1410,1409,59,58,420367,5.07363077552297
nifedipine,"Arthritis, Psoriatic",1,1410,1409,7,6,420419,42.76873162323837
nifedipine,Arthropod bite,1,1410,1409,48,47,420378,6.236500473148805
nifedipine,Aseptic Meningitis,1,1410,1409,94,93,420332,3.1842486749316703
nifedipine,Aspartate aminotransferase abnormal,1,1410,1409,6,5,420420,49.896971847646086
nifedipine,Aspiration Pneumonia,1,1410,1409,29,28,420397,10.322948532830818
nifedipine,Atrial Fibrillation,1,1410,1409,18,17,420408,16.63185080041006
nifedipine,Atypical fracture of femur,1,1410,1409,41,40,420385,7.3013900188682515
nifedipine,B-Cell Lymphomas,1,1410,1409,15,14,420411,19.958362905133665
nifedipine,Bacteremia,1,1410,1409,23,22,420403,13.016076773536582
nifedipine,Bacterial gastroenteritis,1,1410,1409,58,57,420368,5.1611194048114335
nifedipine,Balanitis,3,1410,1407,83,80,420345,10.834433683561539
nifedipine,Benign Meningioma,1,1410,1409,90,89,420336,3.325802381515653
nifedipine,Blister of lip,1,1410,1409,22,21,420404,13.607748887024968
nifedipine,Blood 25-hydroxycholecalciferol decreased,1,1410,1409,59,58,420367,5.07363077552297
nifedipine,Blood Platelet Disorders,1,1410,1409,40,39,420386,7.483942512420157
nifedipine,Blood count abnormal,1,1410,1409,27,26,420399,11.08766395920406
nifedipine,Blood creatine phosphokinase MB increased,2,1410,1408,61,59,420366,9.821488450074517
nifedipine,Blood parathyroid hormone increased,1,1410,1409,57,56,420369,5.25167781056616
nifedipine,Blood potassium increased,1,1410,1409,46,45,420380,6.507683525164317
nifedipine,Blood sodium decreased,4,1410,1406,335,331,420094,3.5795418356298168
nifedipine,Blood sodium increased,1,1410,1409,22,21,420404,13.607748887024968
nifedipine,Blood testosterone increased,1,1410,1409,17,16,420409,17.610236713564063
nifedipine,Blood triglycerides abnormal,1,1410,1409,88,87,420338,3.4014049293502806
nifedipine,Blood urea nitrogen/creatinine ratio increased,1,1410,1409,10,9,420416,29.937899219304473
nifedipine,Bone Transplantation,1,1410,1409,31,30,420395,9.656906064699283
nifedipine,Bone necrosis,1,1410,1409,56,55,420370,5.34547044509784
nifedipine,Brain Concussion,4,1410,1406,163,159,420266,7.35972911885085
nifedipine,Brain Edema,1,1410,1409,79,78,420347,3.788987611287294
nifedipine,Brain natriuretic peptide increased,1,1410,1409,44,43,420382,6.803519581908511
nifedipine,Bronchial Diseases,1,1410,1409,5,4,420421,59.87650816181689
nifedipine,Bronchial aspiration procedure,1,1410,1409,7,6,420419,42.76873162323837
nifedipine,Bullous pemphigoid,1,1410,1409,19,18,420407,15.756452878114375
nifedipine,Burning Mouth Syndrome,1,1410,1409,25,24,420401,11.97473385379702
nifedipine,Calcified lymph nodes,1,1410,1409,27,26,420399,11.08766395920406
nifedipine,Candiduria,2,1410,1408,80,78,420347,7.488547585227273
nifedipine,Cardiac Flutter,1,1410,1409,54,53,420372,5.543477117998054
nifedipine,Cartilage Diseases,2,1410,1408,31,29,420396,19.327529325513197
nifedipine,Cartilage atrophy,1,1410,1409,17,16,420409,17.610236713564063
nifedipine,Cataract operation complication,1,1410,1409,12,11,420414,24.948131062219066
nifedipine,Cerebellar ischaemia,1,1410,1409,12,11,420414,24.948131062219066
nifedipine,Cerebral Hemorrhage,1,1410,1409,63,62,420363,4.751450426397197
nifedipine,Cerebral venous sinus thrombosis,3,1410,1407,222,219,420206,4.0493766687796535
nifedipine,Cerebrospinal fluid leak,1,1410,1409,70,69,420356,4.276234411436683
nifedipine,Cerebrovascular accident,1,1410,1409,23,22,420403,13.016076773536582
nifedipine,Cheilitis,1,1410,1409,46,45,420380,6.507683525164317
nifedipine,Cholecystectomy procedure,2,1410,1408,187,185,420240,3.2028439474963535
nifedipine,Cholestasis,1,1410,1409,72,71,420354,4.157430407696554
nifedipine,Chromatopsia,1,1410,1409,81,80,420345,3.6954148375960534
nifedipine,Chronic sinusitis,1,1410,1409,75,74,420351,3.991104802460374
nifedipine,Closed Fracture Reduction,1,1410,1409,25,24,420401,11.97473385379702
nifedipine,Cognition Disorders,1,1410,1409,13,12,420413,23.028989463340068
nifedipine,Coital bleeding,1,1410,1409,9,8,420417,33.26441132402807
nifedipine,Colitis,2,1410,1408,175,173,420252,3.4225649350649348
nifedipine,Compression of brain,1,1410,1409,13,12,420413,23.028989463340068
nifedipine,Congenital cystic kidney disease,1,1410,1409,55,54,420371,5.442673720885218
nifedipine,Constipation,3,1410,1407,178,175,420250,5.050873242136029
nifedipine,Contrast media allergy,2,1410,1408,141,139,420286,4.2482068020631845
nifedipine,Coombs test positive,1,1410,1409,5,4,420421,59.87650816181689
nifedipine,Corneal Diseases,4,1410,1406,251,247,420178,4.778428250015585
nifedipine,Corneal dystrophy,1,1410,1409,50,49,420376,5.987012065294536
nifedipine,Coronary Aneurysm,1,1410,1409,11,10,420415,27.216207497257887
nifedipine,Coronary Artery Vasospasm,2,1410,1408,14,12,420413,42.79839691558441
nifedipine,Coronary Stenosis,2,1410,1408,161,159,420266,3.720302795031056
nifedipine,Cyst of tongue,1,1410,1409,6,5,420420,49.896971847646086
nifedipine,Cyst removal,1,1410,1409,25,24,420401,11.97473385379702
nifedipine,Cytomegaloviral pneumonia,1,1410,1409,89,88,420337,3.3631789220181654
nifedipine,De Quervain Disease,3,1410,1407,175,172,420253,5.137496192506854
nifedipine,Decreased urine output,1,1410,1409,28,27,420398,10.69165061340363
nifedipine,Deep Vein Thrombosis,2,1410,1408,19,17,420408,31.53528708133971
nifedipine,Dehydroepiandrosterone decreased,1,1410,1409,5,4,420421,59.87650816181689
nifedipine,Delayed Hypersensitivity,1,1410,1409,10,9,420416,29.937899219304473
nifedipine,Delayed union of fracture,1,1410,1409,85,84,420341,3.5214795641464534
nifedipine,"Dermatitis, Atopic",1,1410,1409,10,9,420416,29.937899219304473
nifedipine,Device Failure,2,1410,1408,100,98,420327,5.990553977272727
nifedipine,Device defective,1,1410,1409,5,4,420421,59.87650816181689
nifedipine,Device difficult to use,1,1410,1409,56,55,420370,5.34547044509784
nifedipine,Device leakage,1,1410,1409,21,20,420405,14.255770725607489
nifedipine,Dextrocardia,1,1410,1409,6,5,420420,49.896971847646086
nifedipine,Dilatation of aorta,4,1410,1406,308,304,420121,3.8935822356874987
nifedipine,Discharge from eye,1,1410,1409,24,23,420402,12.473710669505559
nifedipine,Disease Exacerbation,1,1410,1409,71,70,420355,4.215995761652955
nifedipine,Disease of capillaries,1,1410,1409,42,41,420384,7.12753050119977
nifedipine,Disease of mucous membrane,1,1410,1409,29,28,420397,10.322948532830818
nifedipine,Disease recurrence,1,1410,1409,59,58,420367,5.07363077552297
nifedipine,Disorder of endocrine pancreas,1,1410,1409,10,9,420416,29.937899219304473
nifedipine,Disorder of tympanic membrane,1,1410,1409,37,36,420389,8.090806207200814
nifedipine,Disorder of vein,1,1410,1409,99,98,420327,3.0233921901771446
nifedipine,"Disruptive, Impulse Control, and Conduct Disorders",1,1410,1409,56,55,420370,5.34547044509784
nifedipine,Disseminated Histoplasmosis,1,1410,1409,15,14,420411,19.958362905133665
nifedipine,Double kidney (disorder),1,1410,1409,7,6,420419,42.76873162323837
nifedipine,Dry Eye Syndromes,1,1410,1409,79,78,420347,3.788987611287294
nifedipine,Dry lips (finding),1,1410,1409,19,18,420407,15.756452878114375
nifedipine,Dry tongue,1,1410,1409,27,26,420399,11.08766395920406
nifedipine,Dwarfism,2,1410,1408,35,33,420392,17.118506493506494
nifedipine,Dysgraphia,3,1410,1407,248,245,420180,3.62462170713254
nifedipine,Dyskinetic syndrome,5,1410,1405,218,213,420212,6.882643899572301
nifedipine,Ecchymosis,1,1410,1409,56,55,420370,5.34547044509784
nifedipine,Elective Surgical Procedures,1,1410,1409,65,64,420361,4.605230114101655
nifedipine,Electric Countershock,2,1410,1408,124,122,420303,4.830816990469208
nifedipine,Enlarged uvula,1,1410,1409,55,54,420371,5.442673720885218
nifedipine,Erosion of bone,1,1410,1409,6,5,420420,49.896971847646086
nifedipine,Eschar,1,1410,1409,25,24,420401,11.97473385379702
nifedipine,Euphoric mood,2,1410,1408,131,129,420296,4.5726058292852185
nifedipine,Extremity necrosis,1,1410,1409,15,14,420411,19.958362905133665
nifedipine,Eye allergy,1,1410,1409,11,10,420415,27.216207497257887
nifedipine,Femoral Fractures,1,1410,1409,77,76,420349,3.8874213082871707
nifedipine,Femoral Neck Fractures,3,1410,1407,137,134,420291,6.563086548488008
nifedipine,Fever,1,1410,1409,32,31,420394,9.355105571327183
nifedipine,Fibrin D dimer increased,1,1410,1409,31,30,420395,9.656906064699283
nifedipine,Fibromuscular dysplasia of wall of renal artery,2,1410,1408,89,87,420338,6.731135086823288
nifedipine,First degree atrioventricular block,1,1410,1409,23,22,420403,13.016076773536582
nifedipine,Foetal monitoring abnormal,1,1410,1409,7,6,420419,42.76873162323837
nifedipine,Fracture of cervical spine,1,1410,1409,25,24,420401,11.97473385379702
nifedipine,Fracture of sacrum,1,1410,1409,31,30,420395,9.656906064699283
nifedipine,Fungal pneumonia,1,1410,1409,8,7,420418,37.422551454932574
nifedipine,Furred tongue,1,1410,1409,49,48,420377,6.109210469141524
nifedipine,Gastric infection,1,1410,1409,42,41,420384,7.12753050119977
nifedipine,Gastroenteritis norovirus,3,1410,1407,202,199,420226,4.45051616035804
nifedipine,Gastrointestinal Hemorrhage,1,1410,1409,67,66,420359,4.467739372689427
nifedipine,Gastrointestinal angiodysplasia haemorrhagic,1,1410,1409,13,12,420413,23.028989463340068
nifedipine,Gastrointestinal carcinoma,4,1410,1406,350,346,420079,3.426010973379394
nifedipine,Gastrointestinal obstruction,1,1410,1409,26,25,420400,11.514139870066058
nifedipine,Gastrointestinal tract adenoma,1,1410,1409,14,13,420412,21.384010950015206
nifedipine,General symptom,1,1410,1409,31,30,420395,9.656906064699283
nifedipine,Genital hemorrhage,1,1410,1409,65,64,420361,4.605230114101655
nifedipine,Gingival discolouration,2,1410,1408,113,111,420314,5.301211786001609
nifedipine,HELLP Syndrome,15,1410,1395,405,390,420035,11.188902163812557
nifedipine,"Hearing Loss, Sudden",1,1410,1409,13,12,420413,23.028989463340068
nifedipine,"Heart Failure, Right-Sided",2,1410,1408,116,114,420311,5.164074745297805
nifedipine,Hematemesis,1,1410,1409,40,39,420386,7.483942512420157
nifedipine,"Hematoma, Subdural",1,1410,1409,58,57,420368,5.1611194048114335
nifedipine,Hemorrhage of kidney,1,1410,1409,11,10,420415,27.216207497257887
nifedipine,Hemorrhagic diarrhea,1,1410,1409,41,40,420385,7.3013900188682515
nifedipine,Hemorrhoids,1,1410,1409,77,76,420349,3.8874213082871707
nifedipine,"Hepatitis, Alcoholic",1,1410,1409,5,4,420421,59.87650816181689
nifedipine,"Hepatitis, Chronic",1,1410,1409,8,7,420418,37.422551454932574
nifedipine,Hepatomegaly,2,1410,1408,67,65,420360,8.941824966078697
nifedipine,Hip Fractures,1,1410,1409,66,65,420360,4.5354431468696905
nifedipine,Hydrocephalus,1,1410,1409,8,7,420418,37.422551454932574
nifedipine,Hyperesthesia,1,1410,1409,42,41,420384,7.12753050119977
nifedipine,Hyperplasia,1,1410,1409,87,86,420339,3.44050969547164
nifedipine,Hypertensive Retinopathy,1,1410,1409,5,4,420421,59.87650816181689
nifedipine,Hypertensive heart disease,2,1410,1408,122,120,420305,4.910033997764531
nifedipine,Hyperthyroidism,1,1410,1409,78,77,420348,3.837573474550054
nifedipine,Hysterectomy,1,1410,1409,17,16,420409,17.610236713564063
nifedipine,Ileus,2,1410,1408,198,196,420229,3.0248292584940315
nifedipine,Impaired wound healing,5,1410,1405,326,321,420104,4.601325240704758
nifedipine,Increased fibrinolysis (finding),1,1410,1409,24,23,420402,12.473710669505559
nifedipine,Increased upper airway secretion,4,1410,1406,352,348,420077,3.4065288374498905
nifedipine,Infantile apnoeic attack,1,1410,1409,30,29,420396,9.978826590962857
nifedipine,Infarction of basal ganglia,1,1410,1409,7,6,420419,42.76873162323837
nifedipine,Infection,2,1410,1408,170,168,420257,3.523270387700535
nifedipine,Infective conjunctivitis,1,1410,1409,35,34,420391,8.553178546081314
nifedipine,Inflammatory polyposis of intestine,1,1410,1409,5,4,420421,59.87650816181689
nifedipine,Initial insomnia,2,1410,1408,95,93,420332,6.305921052631579
nifedipine,Injection site itching,1,1410,1409,82,81,420344,3.650340147830151
nifedipine,Injury of ear,1,1410,1409,5,4,420421,59.87650816181689
nifedipine,Injury of urethra,1,1410,1409,17,16,420409,17.610236713564063
nifedipine,Intervertebral disc disorder,1,1410,1409,62,61,420364,4.828098170745667
nifedipine,Intraabdominal hemorrhage,1,1410,1409,94,93,420332,3.1842486749316703
nifedipine,Joint stiffness,2,1410,1408,168,166,420259,3.565230992965368
nifedipine,Keratitis,1,1410,1409,10,9,420416,29.937899219304473
nifedipine,Kidney Diseases,1,1410,1409,21,20,420405,14.255770725607489
nifedipine,Kidney Neoplasm,2,1410,1408,19,17,420408,31.53528708133971
nifedipine,Klebsiella test positive,2,1410,1408,32,30,420395,18.723499644886363
nifedipine,Labile blood pressure,1,1410,1409,86,85,420340,3.4805238747586116
nifedipine,Labyrinthitis,1,1410,1409,91,90,420335,3.2892473034417677
nifedipine,Leiomyosarcoma of uterus,1,1410,1409,73,72,420353,4.100469583985533
nifedipine,"Leukemia, Myelocytic, Acute",1,1410,1409,48,47,420378,6.236500473148805
nifedipine,Leukocytes in urine (finding),2,1410,1408,96,94,420331,6.240219578598484
nifedipine,Limb injury,1,1410,1409,80,79,420346,3.741616394606104
nifedipine,Lip oedema,1,1410,1409,87,86,420339,3.44050969547164
nifedipine,Lividity,1,1410,1409,5,4,420421,59.87650816181689
nifedipine,Loose tooth,1,1410,1409,41,40,420385,7.3013900188682515
nifedipine,Lower gastrointestinal hemorrhage,1,1410,1409,37,36,420389,8.090806207200814
nifedipine,Lumpectomy of breast,1,1410,1409,37,36,420389,8.090806207200814
nifedipine,Lymphadenitis,1,1410,1409,28,27,420398,10.69165061340363
nifedipine,Lymphedema,8,1410,1402,549,541,419884,4.378714768649522
nifedipine,Lymphocyte stimulation test positive,1,1410,1409,76,75,420350,3.9385809271226324
nifedipine,Malignant Hypertension,2,1410,1408,140,138,420287,4.278561282467532
nifedipine,Malignant urinary tract neoplasm metastatic,1,1410,1409,16,15,420410,18.710920865862313
nifedipine,Maternal drugs affecting foetus,4,1410,1406,92,88,420337,13.041715628672149
nifedipine,Mean cell haemoglobin increased,2,1410,1408,159,157,420268,3.7671169239565465
nifedipine,Mental handicap,1,1410,1409,5,4,420421,59.87650816181689
nifedipine,Metabolic acidosis,1,1410,1409,25,24,420401,11.97473385379702
nifedipine,Metastatic Malignant Neoplasm to the Thyroid,1,1410,1409,5,4,420421,59.87650816181689
nifedipine,Metastatic Renal Cell Carcinoma,2,1410,1408,62,60,420365,9.66305443548387
nifedipine,Metastatic malignant neoplasm to spleen,3,1410,1407,24,21,420404,37.47432480454869
nifedipine,Migraine Aura without Headache,1,1410,1409,66,65,420360,4.5354431468696905
nifedipine,Monocyte percentage increased,1,1410,1409,28,27,420398,10.69165061340363
nifedipine,Mucosal discolouration,2,1410,1408,13,11,420414,46.09069055944056
nifedipine,Multimorbidity,1,1410,1409,8,7,420418,37.422551454932574
nifedipine,Multiple allergies,1,1410,1409,99,98,420327,3.0233921901771446
nifedipine,Nail Diseases,1,1410,1409,29,28,420397,10.322948532830818
nifedipine,Nasal discharge discolouration,1,1410,1409,84,83,420342,3.563410388995911
nifedipine,Neonatal Abstinence Syndrome,1,1410,1409,24,23,420402,12.473710669505559
nifedipine,Nephrectomy,1,1410,1409,62,61,420364,4.828098170745667
nifedipine,Nephrosclerosis,1,1410,1409,41,40,420385,7.3013900188682515
nifedipine,Neutropenic sepsis,1,1410,1409,95,94,420331,3.1507227970565164
nifedipine,Nocturia,1,1410,1409,23,22,420403,13.016076773536582
nifedipine,Nonalcoholic Steatohepatitis,2,1410,1408,26,24,420401,23.044635052447553
nifedipine,Ocular icterus,1,1410,1409,15,14,420411,19.958362905133665
nifedipine,Onychomycosis,1,1410,1409,87,86,420339,3.44050969547164
nifedipine,Oral mucosal blisters,1,1410,1409,15,14,420411,19.958362905133665
nifedipine,Pancreatic carcinoma stage III,1,1410,1409,6,5,420420,49.896971847646086
nifedipine,Parathyroid Diseases,1,1410,1409,52,51,420374,5.7567150734290555
nifedipine,Paronychia (disorder),1,1410,1409,12,11,420414,24.948131062219066
nifedipine,Pericardial effusion,1,1410,1409,55,54,420371,5.442673720885218
nifedipine,Pericarditis,2,1410,1408,42,40,420385,14.265185335497835
nifedipine,Perinephric hematoma,1,1410,1409,6,5,420420,49.896971847646086
nifedipine,Periodontitis,2,1410,1408,52,50,420375,11.52160729895105
nifedipine,Phlebitis,1,1410,1409,27,26,420399,11.08766395920406
nifedipine,Physical abuse,1,1410,1409,43,42,420383,6.961757472725171
nifedipine,Platelet aggregation inhibition,1,1410,1409,14,13,420412,21.384010950015206
nifedipine,"Pneumonia, Bacterial",1,1410,1409,79,78,420347,3.788987611287294
nifedipine,Polydactyly,6,1410,1404,343,337,420088,5.251451496349456
nifedipine,Polypharmacy,1,1410,1409,16,15,420410,18.710920865862313
nifedipine,Postural dizziness,1,1410,1409,36,35,420390,8.315570538601056
nifedipine,Preterm premature rupture of membranes (disorder),4,1410,1406,163,159,420266,7.35972911885085
nifedipine,Projectile vomiting,1,1410,1409,23,22,420403,13.016076773536582
nifedipine,Prostate examination abnormal,1,1410,1409,15,14,420411,19.958362905133665
nifedipine,Prostatectomy,1,1410,1409,6,5,420420,49.896971847646086
nifedipine,Proteinuria,1,1410,1409,6,5,420420,49.896971847646086
nifedipine,Prothrombin consumption time shortened,2,1410,1408,56,54,420371,10.698533887987013
nifedipine,Pruritus Ani,1,1410,1409,30,29,420396,9.978826590962857
nifedipine,Psoriasis,1,1410,1409,21,20,420405,14.255770725607489
nifedipine,Psychological Trauma,1,1410,1409,99,98,420327,3.0233921901771446
nifedipine,Pulmonary Embolism,2,1410,1408,113,111,420314,5.301211786001609
nifedipine,Radiation exposure during pregnancy,4,1410,1406,64,60,420365,18.748710881934567
nifedipine,Renal Insufficiency,18,1410,1392,907,889,419536,6.001140554309394
nifedipine,Renal tubular acidosis,1,1410,1409,23,22,420403,13.016076773536582
nifedipine,Renal vascular disorder,1,1410,1409,13,12,420413,23.028989463340068
nifedipine,Replacement of aortic valve (procedure),1,1410,1409,5,4,420421,59.87650816181689
nifedipine,"Respiratory Distress Syndrome, Adult",1,1410,1409,25,24,420401,11.97473385379702
nifedipine,"Respiratory Distress Syndrome, Newborn",1,1410,1409,9,8,420417,33.26441132402807
nifedipine,Respiratory distress,1,1410,1409,99,98,420327,3.0233921901771446
nifedipine,Respiratory tract congestion,6,1410,1404,337,331,420094,5.345025235232951
nifedipine,Retrognathia,1,1410,1409,14,13,420412,21.384010950015206
nifedipine,Rhabdomyolysis,4,1410,1406,210,206,420219,5.711914922441238
nifedipine,Right atrial dilatation,1,1410,1409,6,5,420420,49.896971847646086
nifedipine,Rupture of liver,2,1410,1408,19,17,420408,31.53528708133971
nifedipine,Ruptured cyst of kidney,1,1410,1409,5,4,420421,59.87650816181689
nifedipine,"Scoliosis, unspecified",2,1410,1408,191,189,420236,3.135738933841028
nifedipine,Sensory Disorders,3,1410,1407,213,210,420215,4.220567184199726
nifedipine,Sinus bradycardia,2,1410,1408,142,140,420285,4.218279849551856
nifedipine,Skeletal injury,1,1410,1409,51,50,420375,5.869605755716055
nifedipine,Skin toxicity,1,1410,1409,34,33,420392,8.804763495178056
nifedipine,Small bowel angioedema,1,1410,1409,21,20,420405,14.255770725607489
nifedipine,Small kidney,1,1410,1409,23,22,420403,13.016076773536582
nifedipine,Splenomegaly,1,1410,1409,90,89,420336,3.325802381515653
nifedipine,Squamous cell carcinoma,1,1410,1409,91,90,420335,3.2892473034417677
nifedipine,Status Epilepticus,1,1410,1409,7,6,420419,42.76873162323837
nifedipine,Sudden death,1,1410,1409,60,59,420366,4.989058433877454
nifedipine,Superficial phlebitis,1,1410,1409,92,91,420334,3.2534869009781837
nifedipine,Tachycardia,2,1410,1408,128,126,420299,4.6798095703125
nifedipine,"Tachycardia, Ventricular",2,1410,1408,33,31,420394,18.15607782369146
nifedipine,Temperature intolerance,1,1410,1409,40,39,420386,7.483942512420157
nifedipine,Tibial Fractures,1,1410,1409,22,21,420404,13.607748887024968
nifedipine,Tonic-Clonic Epilepsy,1,1410,1409,7,6,420419,42.76873162323837
nifedipine,Traumatic skin ulcer,1,1410,1409,37,36,420389,8.090806207200814
nifedipine,Tremor,2,1410,1408,81,79,420346,7.39607884399551
nifedipine,Typhlitis,1,1410,1409,78,77,420348,3.837573474550054
nifedipine,Underdose (unintentional),1,1410,1409,89,88,420337,3.3631789220181654
nifedipine,Urinary tract obstruction,1,1410,1409,24,23,420402,12.473710669505559
nifedipine,Urinoma,1,1410,1409,18,17,420408,16.63185080041006
nifedipine,Vascular rupture,1,1410,1409,31,30,420395,9.656906064699283
nifedipine,Vasculitis,3,1410,1407,127,124,420301,7.080032906334469
nifedipine,Viral Encephalitis,2,1410,1408,11,9,420416,54.47107438016529
nifedipine,Vitamin B1 increased,1,1410,1409,35,34,420391,8.553178546081314
nifedipine,Vitamin D below reference range,1,1410,1409,57,56,420369,5.25167781056616
nifedipine,Weight Gain,1,1410,1409,68,67,420358,4.4020268859850535
nifedipine,Weight decrease neonatal,1,1410,1409,10,9,420416,29.937899219304473
nifedipine,White matter lesion,1,1410,1409,91,90,420335,3.2892473034417677
nifedipine,Wound inflammation,1,1410,1409,13,12,420413,23.028989463340068
nifedipine,prostatitis,2,1410,1408,150,148,420277,3.993229166666667
nifedipine,treatment failure,1,1410,1409,63,62,420363,4.751450426397197
nifedipine,upper airway cough syndrome,1,1410,1409,54,53,420372,5.543477117998054
olmesartan,Abdominal Compartment Syndrome,1,4708,4707,7,6,417121,12.802452274727608
olmesartan,Abdominal adhesions,2,4708,4706,18,16,417111,9.95931907257874
olmesartan,Abdominal tenderness,2,4708,4706,24,22,417105,7.469383057090239
olmesartan,Abnormal urine odor,13,4708,4695,140,127,417000,8.340232770424464
olmesartan,Abnormal ventricular axis,3,4708,4705,27,24,417103,9.961223284921477
olmesartan,Abscess of peritoneum,1,4708,4707,12,11,417116,7.468008639614759
olmesartan,Abscess of vulva,2,4708,4706,9,7,417120,19.91906313453275
olmesartan,Absolute neutrophil count abnormal,1,4708,4707,14,13,417114,6.401119912592188
olmesartan,Accessory nipple,1,4708,4707,6,5,417122,14.936229728772748
olmesartan,"Acidosis, Respiratory",1,4708,4707,22,21,417106,4.07336268999749
olmesartan,Acromegaly,1,4708,4707,11,10,417117,8.146937829538212
olmesartan,Adams-Stokes Syndrome,3,4708,4705,25,22,417105,10.758172157279489
olmesartan,Adrenal insufficiency neonatal,1,4708,4707,11,10,417117,8.146937829538212
olmesartan,Adrenocorticotropic hormone (ACTH) deficiency (disorder),6,4708,4702,6,0,417127,89.71267545725223
olmesartan,Alcohol abuse,1,4708,4707,17,16,417111,5.271473025156525
olmesartan,Allergy to chemicals,2,4708,4706,20,18,417109,8.96334466638334
olmesartan,Amblyopia,4,4708,4704,73,69,417058,4.912892554281987
olmesartan,"Amnesia, Anterograde",2,4708,4706,6,4,417123,29.87880719648675
olmesartan,"Angioedemas, Hereditary",1,4708,4707,22,21,417106,4.07336268999749
olmesartan,Anorectal Diseases,1,4708,4707,13,12,417115,6.893530094294913
olmesartan,"Aortic Aneurysm, Ruptured",1,4708,4707,18,17,417110,4.978601609895428
olmesartan,Aortitis,1,4708,4707,29,28,417099,3.0900859321773146
olmesartan,Aphakic cystoid macular oedema,1,4708,4707,7,6,417121,12.802452274727608
olmesartan,Apparent death,2,4708,4706,53,51,417076,3.382129597703454
olmesartan,Application site erosion,6,4708,4702,28,22,417105,19.22314212796986
olmesartan,Arterial embolism,5,4708,4703,37,32,417095,12.119865985483676
olmesartan,Arterial thrombosis,2,4708,4706,35,33,417094,5.121729099629651
olmesartan,Arteriovenous fistula,2,4708,4706,58,56,417071,3.0905300643345988
olmesartan,Atrophic endometrium,7,4708,4701,32,25,417102,19.627612476068922
olmesartan,Atrophy of pancreas,3,4708,4705,54,51,417076,4.980292832683906
olmesartan,Bacterial osteomyelitis,2,4708,4706,38,36,417091,4.71734851365558
olmesartan,Bacteriuria,1,4708,4707,23,22,417105,3.8962507274087623
olmesartan,Balanitis,5,4708,4703,83,78,417049,5.402242608537488
olmesartan,Band sensation,1,4708,4707,27,26,417101,3.3189969234158734
olmesartan,Blast cells present,2,4708,4706,14,12,417115,12.80496023313703
olmesartan,Blepharitis,6,4708,4702,58,52,417075,9.279477551738806
olmesartan,Blood HIV RNA decreased,1,4708,4707,7,6,417121,12.802452274727608
olmesartan,Blood albumin abnormal,1,4708,4707,15,14,417113,5.97436442178316
olmesartan,Blood albumin increased,1,4708,4707,13,12,417115,6.893530094294913
olmesartan,Blood bicarbonate abnormal,6,4708,4702,135,129,416998,3.9860106810340756
olmesartan,Blood bicarbonate level decreased below normal,1,4708,4707,11,10,417117,8.146937829538212
olmesartan,Blood creatine phosphokinase MB increased,4,4708,4704,61,57,417070,5.87953050072488
olmesartan,Blood electrolytes decreased,3,4708,4705,34,31,417096,7.91025192223542
olmesartan,Blood loss anaemia neonatal,3,4708,4705,53,50,417077,5.074272652537445
olmesartan,Blood oestrogen decreased,21,4708,4687,40,19,417108,47.24607958182206
olmesartan,Blood pH decreased,1,4708,4707,9,8,417119,9.95741566933409
olmesartan,Blood potassium increased,3,4708,4705,46,43,417084,5.846541606986093
olmesartan,Blood sodium increased,1,4708,4707,22,21,417106,4.07336268999749
olmesartan,Blood stem cell harvest failure,3,4708,4705,9,6,417121,29.884945093871767
olmesartan,Blood uric acid abnormal,1,4708,4707,10,9,417118,8.961652857446358
olmesartan,Bone scan abnormal,1,4708,4707,14,13,417114,6.401119912592188
olmesartan,Brain stem ischemia,1,4708,4707,5,4,417123,17.923518164435947
olmesartan,Bromhidrosis,1,4708,4707,7,6,417121,12.802452274727608
olmesartan,Bronchopleural Fistula,4,4708,4704,5,1,417126,71.73979591836735
olmesartan,Buccal mucosal roughening,1,4708,4707,24,23,417104,3.7338980950357623
olmesartan,Burning Mouth Syndrome,1,4708,4707,25,24,417103,3.5845336732526025
olmesartan,CD4 Lymphocytes Decreased,4,4708,4704,65,61,417066,5.517660910518053
olmesartan,CSF eosinophil count increased,7,4708,4701,23,16,417111,27.308565245137487
olmesartan,Cancer antigen 125 above reference range,1,4708,4707,19,18,417109,4.716558764661814
olmesartan,Capillary Fragility,1,4708,4707,19,18,417109,4.716558764661814
olmesartan,"Carcinoma, Basosquamous",1,4708,4707,20,19,417108,4.480720203951561
olmesartan,Cardiac Catheterization Procedures,1,4708,4707,11,10,417117,8.146937829538212
olmesartan,Catheter site inflammation,1,4708,4707,6,5,417122,14.936229728772748
olmesartan,Cellulitis of male external genital organ,1,4708,4707,14,13,417114,6.401119912592188
olmesartan,Central nervous system haemorrhage,6,4708,4702,15,9,417118,35.884304551254786
olmesartan,Cerebral haematoma,3,4708,4705,36,33,417094,7.470758058802692
olmesartan,Cerebrovascular Insufficiency,1,4708,4707,16,15,417112,5.6009533673252605
olmesartan,Cerebrovascular stenosis,1,4708,4707,6,5,417122,14.936229728772748
olmesartan,Cervical dysplasia,4,4708,4704,39,35,417092,9.196668410954125
olmesartan,Choking,7,4708,4701,142,135,416992,4.421970452795479
olmesartan,Chronic cholecystitis,68,4708,4640,462,394,416733,13.366437154799224
olmesartan,Chronic fibrous thyroiditis,10,4708,4698,240,230,416897,3.7391354477082444
olmesartan,Chronic glomerulonephritis,2,4708,4706,7,5,417122,25.61034545564932
olmesartan,Clostridium difficile colitis,3,4708,4705,29,26,417101,9.274198394957676
olmesartan,Colon cancer recurrent,4,4708,4704,25,21,417106,14.347278911564626
olmesartan,Colonic Neoplasms,3,4708,4705,23,20,417107,11.69372083352585
olmesartan,Complex Regional Pain Syndromes,1,4708,4707,9,8,417119,9.95741566933409
olmesartan,Complications of Diabetes Mellitus,1,4708,4707,15,14,417113,5.97436442178316
olmesartan,Compulsive hoarding,1,4708,4707,26,25,417102,3.4466588223758396
olmesartan,Congenital anomaly of gastrointestinal tract,3,4708,4705,11,8,417119,24.45120278233987
olmesartan,Congenital cystic kidney disease,2,4708,4706,55,53,417074,3.259127612718773
olmesartan,Congestive heart failure,11,4708,4697,308,297,416830,3.2051385382767115
olmesartan,Consciousness fluctuating,1,4708,4707,19,18,417109,4.716558764661814
olmesartan,Coronary Artery Bypass Surgery,1,4708,4707,11,10,417117,8.146937829538212
olmesartan,Coronary Occlusion,1,4708,4707,24,23,417104,3.7338980950357623
olmesartan,Creatinine measurement,1,4708,4707,9,8,417119,9.95741566933409
olmesartan,Cushingoid,2,4708,4706,45,43,417084,3.9834726354063372
olmesartan,Cyanosis,1,4708,4707,11,10,417117,8.146937829538212
olmesartan,Cyst of tongue,1,4708,4707,6,5,417122,14.936229728772748
olmesartan,Cystatin C increased,2,4708,4706,29,27,417100,6.1814851180444625
olmesartan,Day Dreams,1,4708,4707,6,5,417122,14.936229728772748
olmesartan,Debridement of bone,2,4708,4706,5,3,417124,35.85465363365916
olmesartan,Deep Vein Thrombosis,1,4708,4707,19,18,417109,4.716558764661814
olmesartan,Delusional perception,3,4708,4705,19,16,417111,14.15569103417417
olmesartan,Dental Pulp Diseases,2,4708,4706,30,28,417099,5.975421447797139
olmesartan,Dental discomfort,1,4708,4707,7,6,417121,12.802452274727608
olmesartan,Dermabrasion,2,4708,4706,34,32,417095,5.272380690482738
olmesartan,Dermatitis acneiform,3,4708,4705,16,13,417114,16.81000265674814
olmesartan,Device leakage,1,4708,4707,21,20,417107,4.267342458547047
olmesartan,Dilatation of intestine (disorder),4,4708,4704,41,37,417090,8.748008959681433
olmesartan,Disease Exacerbation,17,4708,4691,71,54,417073,21.527552009992164
olmesartan,Disease of diaphragm,2,4708,4706,37,35,417092,4.8448559056293865
olmesartan,Disease of mucous membrane,1,4708,4707,29,28,417099,3.0900859321773146
olmesartan,Disorder of accommodation,1,4708,4707,7,6,417121,12.802452274727608
olmesartan,Disorder of middle ear,1,4708,4707,18,17,417110,4.978601609895428
olmesartan,Disorder of mineral metabolism,14,4708,4694,70,56,417071,17.970387729015766
olmesartan,Disorder of tendon,2,4708,4706,25,23,417104,7.1705907352316185
olmesartan,Disseminated Intravascular Coagulation,2,4708,4706,42,40,417087,4.268036751462166
olmesartan,Disuse syndrome,1,4708,4707,7,6,417121,12.802452274727608
olmesartan,Diverticulum,6,4708,4702,66,60,417067,8.154537720892463
olmesartan,Double kidney (disorder),1,4708,4707,7,6,417121,12.802452274727608
olmesartan,Drug Overdose,7,4708,4701,72,65,417062,8.722556075539485
olmesartan,Duodenal ulcer perforation,1,4708,4707,29,28,417099,3.0900859321773146
olmesartan,Dysbacteriosis,3,4708,4705,18,15,417112,14.94215373715905
olmesartan,Dyschromatopsia,6,4708,4702,19,13,417114,28.329445476728825
olmesartan,Eating Disorders,2,4708,4706,54,52,417075,3.3194896979427364
olmesartan,Ejection fraction abnormal,2,4708,4706,14,12,417115,12.80496023313703
olmesartan,Electrocardiogram ST-T segment elevation,2,4708,4706,29,27,417100,6.1814851180444625
olmesartan,Enamel anomaly,1,4708,4707,20,19,417108,4.480720203951561
olmesartan,Enthesopathy,1,4708,4707,10,9,417118,8.961652857446358
olmesartan,Epilepsy,6,4708,4702,101,95,417032,5.3282656211176205
olmesartan,Eructation,38,4708,4670,478,440,416687,7.172805139186295
olmesartan,Erythrodermic psoriasis,20,4708,4688,94,74,417053,19.14081221407305
olmesartan,Erythropenia,2,4708,4706,8,6,417121,22.40899915002125
olmesartan,Esophageal carcinoma,5,4708,4703,79,74,417053,5.675827710295341
olmesartan,Esophageal spasm,1,4708,4707,20,19,417108,4.480720203951561
olmesartan,Euglycaemic diabetic ketoacidosis,2,4708,4706,8,6,417121,22.40899915002125
olmesartan,Evaluation procedure,1,4708,4707,19,18,417109,4.716558764661814
olmesartan,Exostosis of jaw,1,4708,4707,11,10,417117,8.146937829538212
olmesartan,Exposure via body fluid,2,4708,4706,12,10,417117,14.939191103555745
olmesartan,Exposure via breast milk,1,4708,4707,7,6,417121,12.802452274727608
olmesartan,Extravasation,1,4708,4707,19,18,417109,4.716558764661814
olmesartan,Eye colour change,1,4708,4707,9,8,417119,9.95741566933409
olmesartan,Eye opacity,2,4708,4706,6,4,417123,29.87880719648675
olmesartan,Eye pain,3,4708,4705,70,67,417060,3.8417944436010325
olmesartan,Failure to Thrive,12,4708,4696,61,49,417078,17.6686402100148
olmesartan,Falls,3,4708,4705,72,69,417058,3.7350602196245126
olmesartan,Fibroid Tumor,1,4708,4707,17,16,417111,5.271473025156525
olmesartan,Fistula discharge,7,4708,4701,185,178,416949,3.393815001983477
olmesartan,Fracture of cervical spine,1,4708,4707,25,24,417103,3.5845336732526025
olmesartan,Fracture of sternum,2,4708,4706,54,52,417075,3.3194896979427364
olmesartan,Gait inability,3,4708,4705,34,31,417096,7.91025192223542
olmesartan,Gastric hypermotility,1,4708,4707,7,6,417121,12.802452274727608
olmesartan,Gastric infection,2,4708,4706,42,40,417087,4.268036751462166
olmesartan,"Gastritis, Hypertrophic",4,4708,4704,5,1,417126,71.73979591836735
olmesartan,Genital rash,13,4708,4695,210,197,416930,5.559232212586846
olmesartan,Genitourinary tract hemorrhage,1,4708,4707,28,27,417100,3.200453731524477
olmesartan,Gingiva operations,3,4708,4705,61,58,417069,4.40871064964025
olmesartan,"Graft Occlusion, Vascular",5,4708,4703,45,40,417087,9.965034138965672
olmesartan,Growing pains,1,4708,4707,7,6,417121,12.802452274727608
olmesartan,Haematotoxicity,1,4708,4707,27,26,417101,3.3189969234158734
olmesartan,Haemorrhagic arteriovenous malformation,2,4708,4706,57,55,417072,3.144757345978631
olmesartan,Hay fever,1,4708,4707,22,21,417106,4.07336268999749
olmesartan,Head Banging,1,4708,4707,11,10,417117,8.146937829538212
olmesartan,Heart Diseases,2,4708,4706,15,13,417114,11.951267884969543
olmesartan,Heart valve stenosis,2,4708,4706,12,10,417117,14.939191103555745
olmesartan,Hemiparesis,3,4708,4705,59,56,417071,4.558180082494282
olmesartan,Hemorrhagic Disorders,1,4708,4707,6,5,417122,14.936229728772748
olmesartan,Hemorrhagic enterocolitis,1,4708,4707,5,4,417123,17.923518164435947
olmesartan,Hemorrhagic gastritis,11,4708,4697,323,312,416815,3.056184337410546
olmesartan,"Hepatitis C, Chronic",1,4708,4707,16,15,417112,5.6009533673252605
olmesartan,Hepatomegaly,7,4708,4701,67,60,417067,9.373604218854673
olmesartan,Hepatorenal Syndrome,1,4708,4707,12,11,417116,7.468008639614759
olmesartan,Hereditary lymphedema and yellow nails,3,4708,4705,5,2,417125,53.79341126461211
olmesartan,Hoigne's syndrome,1,4708,4707,18,17,417110,4.978601609895428
olmesartan,Hunger,2,4708,4706,27,25,417102,6.639404385260738
olmesartan,Hydrocele operation,3,4708,4705,44,41,417086,6.112322480919717
olmesartan,Hyperlipasaemia,1,4708,4707,6,5,417122,14.936229728772748
olmesartan,Hypernatremia,1,4708,4707,29,28,417099,3.0900859321773146
olmesartan,Hyperopia,1,4708,4707,5,4,417123,17.923518164435947
olmesartan,Hypertensive Encephalopathy,3,4708,4705,33,30,417097,8.14997584774418
olmesartan,Hypertensive Urgency,2,4708,4706,11,9,417118,16.297338021094927
olmesartan,Hyperthyroidism,4,4708,4704,78,74,417053,4.597909035409035
olmesartan,Hypertriglyceridemia,2,4708,4706,18,16,417111,9.95931907257874
olmesartan,Hypokalemic alkalosis,2,4708,4706,5,3,417124,35.85465363365916
olmesartan,Hypomania,1,4708,4707,16,15,417112,5.6009533673252605
olmesartan,Hyponatremia,42,4708,4666,941,899,416228,4.026128827573515
olmesartan,INR Increased,5,4708,4703,57,52,417075,7.866908393671825
olmesartan,Immunosuppressant drug level increased,1,4708,4707,16,15,417112,5.6009533673252605
olmesartan,Impacted cerumen,10,4708,4698,134,124,417003,6.698642801319075
olmesartan,Incarcerated inguinal hernia,2,4708,4706,10,8,417119,17.927114322141946
olmesartan,Incision site vesicles,1,4708,4707,8,7,417120,11.202119184193755
olmesartan,Incorrect product storage,1,4708,4707,18,17,417110,4.978601609895428
olmesartan,Increased Libido,1,4708,4707,17,16,417111,5.271473025156525
olmesartan,Increased fibrinolysis (finding),1,4708,4707,24,23,417104,3.7338980950357623
olmesartan,Infected ulcer of skin,4,4708,4704,83,79,417048,4.320875338087042
olmesartan,Influenza,2,4708,4706,33,31,417096,5.432162680781465
olmesartan,Infrequent bowel movements,2,4708,4706,6,4,417123,29.87880719648675
olmesartan,Infusion Site Extravasation,3,4708,4705,72,69,417058,3.7350602196245126
olmesartan,Infusion site erythema,1,4708,4707,8,7,417120,11.202119184193755
olmesartan,Injection site atrophy,1,4708,4707,17,16,417111,5.271473025156525
olmesartan,Injection site discomfort,1,4708,4707,21,20,417107,4.267342458547047
olmesartan,Injection site scar,3,4708,4705,23,20,417107,11.69372083352585
olmesartan,Insertion of prosthesis of bone,1,4708,4707,11,10,417117,8.146937829538212
olmesartan,Instillation site pain,1,4708,4707,18,17,417110,4.978601609895428
olmesartan,Insurance issue,1,4708,4707,8,7,417120,11.202119184193755
olmesartan,Intentional device misuse,1,4708,4707,14,13,417114,6.401119912592188
olmesartan,Intentional dose omission,92,4708,4616,211,119,417008,39.82583554420233
olmesartan,Intentional drug misuse,3,4708,4705,26,23,417104,10.344371781247446
olmesartan,Intentional overdose,4,4708,4704,36,32,417095,9.963128306878307
olmesartan,Intercepted product administration error,3,4708,4705,5,2,417125,53.79341126461211
olmesartan,Intestinal hemorrhage NOS,2,4708,4706,24,22,417105,7.469383057090239
olmesartan,Iridocyclitis,2,4708,4706,12,10,417117,14.939191103555745
olmesartan,Irreducible umbilical hernia,1,4708,4707,5,4,417123,17.923518164435947
olmesartan,Ischemic stroke,2,4708,4706,19,17,417110,9.435122016686424
olmesartan,Lack of injection site rotation,2,4708,4706,20,18,417109,8.96334466638334
olmesartan,Left Bundle-Branch Block,5,4708,4703,109,104,417023,4.113380684201184
olmesartan,Left-Sided Heart Failure,3,4708,4705,33,30,417097,8.14997584774418
olmesartan,Lip and/or oral cavity cancer,6,4708,4702,16,10,417117,33.64145576350489
olmesartan,Lipodystrophy acquired,3,4708,4705,9,6,417121,29.884945093871767
olmesartan,Lipoid nephrosis,6,4708,4702,7,1,417126,76.89639667010998
olmesartan,Liquid product physical issue,7,4708,4701,99,92,417035,6.3432710426966965
olmesartan,Liver diseases,3,4708,4705,55,52,417075,4.8897304608250405
olmesartan,Liver palpable,1,4708,4707,8,7,417120,11.202119184193755
olmesartan,Lobular carcinoma in situ of breast,1,4708,4707,5,4,417123,17.923518164435947
olmesartan,Low density lipoprotein increased,1,4708,4707,26,25,417102,3.4466588223758396
olmesartan,Lymphadenitis,1,4708,4707,28,27,417100,3.200453731524477
olmesartan,Lymphocyte count decreased,6,4708,4702,148,142,416985,3.6357760354995574
olmesartan,Lymphocytosis,1,4708,4707,5,4,417123,17.923518164435947
olmesartan,Macrocytosis (finding),1,4708,4707,22,21,417106,4.07336268999749
olmesartan,Macrophages increased,3,4708,4705,47,44,417083,5.72213353833631
olmesartan,Malignant mesothelioma,1,4708,4707,7,6,417121,12.802452274727608
olmesartan,Malignant neoplasm of colon stage IV,9,4708,4699,92,83,417044,8.780052647649361
olmesartan,Malignant neoplasm of parietal pleura,1,4708,4707,10,9,417118,8.961652857446358
olmesartan,Malignant neoplasm of tonsil,1,4708,4707,11,10,417117,8.146937829538212
olmesartan,Mastication disorder,6,4708,4702,165,159,416968,3.261049456710877
olmesartan,Mediastinal Neoplasms,1,4708,4707,6,5,417122,14.936229728772748
olmesartan,Melanosis,19,4708,4689,105,86,417041,16.274908854563364
olmesartan,Meniscus operation,1,4708,4707,15,14,417113,5.97436442178316
olmesartan,Menorrhagia,1,4708,4707,26,25,417102,3.4466588223758396
olmesartan,Metabolic acidosis,1,4708,4707,25,24,417103,3.5845336732526025
olmesartan,Metastases to stomach,1,4708,4707,5,4,417123,17.923518164435947
olmesartan,Metastatic malignant neoplasm to pancreas,10,4708,4698,99,89,417038,9.067602375392925
olmesartan,Methylenetetrahydrofolate reductase gene mutation,2,4708,4706,13,11,417116,13.789989865637976
olmesartan,Monocyte count outside reference range,1,4708,4707,5,4,417123,17.923518164435947
olmesartan,Mucosal toxicity,2,4708,4706,12,10,417117,14.939191103555745
olmesartan,Multi-organ disorder,1,4708,4707,19,18,417109,4.716558764661814
olmesartan,Muscle hemorrhage,2,4708,4706,50,48,417079,3.5850828729281767
olmesartan,Musculoskeletal Pain,1,4708,4707,13,12,417115,6.893530094294913
olmesartan,Myotonus (finding),2,4708,4706,9,7,417120,19.91906313453275
olmesartan,Necrotising colitis,1,4708,4707,20,19,417108,4.480720203951561
olmesartan,Neonatal hypoglycemia,1,4708,4707,25,24,417103,3.5845336732526025
olmesartan,Neuromuscular Diseases,2,4708,4706,9,7,417120,19.91906313453275
olmesartan,Nitrite detected in urine,2,4708,4706,22,20,417107,8.14845651585983
olmesartan,Nonalcoholic Steatohepatitis,1,4708,4707,26,25,417102,3.4466588223758396
olmesartan,Nonspecific reaction,7,4708,4701,56,49,417078,11.215140395660498
olmesartan,Occult blood screen,1,4708,4707,17,16,417111,5.271473025156525
olmesartan,Ocular Hypotension,3,4708,4705,75,72,417055,3.585632306057386
olmesartan,Oestrogen deficiency,2,4708,4706,18,16,417111,9.95931907257874
olmesartan,Onycholysis,1,4708,4707,8,7,417120,11.202119184193755
olmesartan,Operation on colon,3,4708,4705,74,71,417056,3.634095413160238
olmesartan,Operation on gallbladder,1,4708,4707,17,16,417111,5.271473025156525
olmesartan,Operation on ligament,1,4708,4707,16,15,417112,5.6009533673252605
olmesartan,Orbital Diseases,3,4708,4705,12,9,417118,22.41354941551541
olmesartan,Osteochondrosis,1,4708,4707,10,9,417118,8.961652857446358
olmesartan,Osteolysis,2,4708,4706,28,26,417101,6.402267621880881
olmesartan,Oxygen saturation abnormal,2,4708,4706,11,9,417118,16.297338021094927
olmesartan,PCO2 decreased,1,4708,4707,14,13,417114,6.401119912592188
olmesartan,Pain in esophagus (finding),23,4708,4685,595,572,416555,3.4756087280162866
olmesartan,Pallor of skin,1,4708,4707,26,25,417102,3.4466588223758396
olmesartan,Papule,1,4708,4707,10,9,417118,8.961652857446358
olmesartan,Parathyroid Diseases,2,4708,4706,52,50,417077,3.4471787243780443
olmesartan,Paroxysmal nocturnal dyspnea,1,4708,4707,18,17,417110,4.978601609895428
olmesartan,Partner stress,1,4708,4707,21,20,417107,4.267342458547047
olmesartan,Perforation of small intestine,5,4708,4703,127,122,417005,3.5302311642258837
olmesartan,Performance status decreased,1,4708,4707,25,24,417103,3.5845336732526025
olmesartan,Peritoneal carcinoma metastatic,1,4708,4707,5,4,417123,17.923518164435947
olmesartan,Permanent cardiac pacemaker insertion,1,4708,4707,7,6,417121,12.802452274727608
olmesartan,Pharyngitis bacterial,2,4708,4706,6,4,417123,29.87880719648675
olmesartan,Photoinduced acute generalised exanthematous pustulosis,4,4708,4704,106,102,417025,3.383142407906559
olmesartan,Physical product label issue,5,4708,4703,19,14,417113,23.60285148337567
olmesartan,Plague,2,4708,4706,19,17,417110,9.435122016686424
olmesartan,Pneumonia due to Klebsiella pneumoniae,1,4708,4707,14,13,417114,6.401119912592188
olmesartan,"Pneumonia, Bacterial",4,4708,4704,79,75,417052,4.539696891414794
olmesartan,Polyarteritis Nodosa,2,4708,4706,11,9,417118,16.297338021094927
olmesartan,Polycystic Ovary Syndrome,3,4708,4705,31,28,417099,8.675821877892428
olmesartan,Polycythemia,3,4708,4705,24,21,417106,11.20645589798087
olmesartan,Polyp of vagina,2,4708,4706,15,13,417114,11.951267884969543
olmesartan,Polypharmacy,1,4708,4707,16,15,417112,5.6009533673252605
olmesartan,"Polyradiculoneuropathy, Chronic Inflammatory Demyelinating",1,4708,4707,28,27,417100,3.200453731524477
olmesartan,Portal Hypertension,11,4708,4697,274,263,416864,3.603147062342946
olmesartan,Post procedural hematoma,1,4708,4707,15,14,417113,5.97436442178316
olmesartan,Post-Traumatic Headache,2,4708,4706,12,10,417117,14.939191103555745
olmesartan,Postoperative retention of urine,1,4708,4707,5,4,417123,17.923518164435947
olmesartan,Product Recalls,6,4708,4702,6,0,417127,89.71267545725223
olmesartan,Product administration error,1,4708,4707,25,24,417103,3.5845336732526025
olmesartan,Product availability issue,7,4708,4701,146,139,416988,4.300779781626177
olmesartan,Product monitoring error,2,4708,4706,9,7,417120,19.91906313453275
olmesartan,Productive Cough,8,4708,4700,106,98,417029,6.772043356081895
olmesartan,Proliferative glomerulonephritis,1,4708,4707,6,5,417122,14.936229728772748
olmesartan,Prolonged PR interval,2,4708,4706,24,22,417105,7.469383057090239
olmesartan,Prostate examination abnormal,1,4708,4707,15,14,417113,5.97436442178316
olmesartan,Prostatic cyst,1,4708,4707,6,5,417122,14.936229728772748
olmesartan,Protein albumin ratio decreased,1,4708,4707,21,20,417107,4.267342458547047
olmesartan,Protein total increased,7,4708,4701,102,95,417032,6.156660451885498
olmesartan,Protein/Creatinine ratio in urine above normal,1,4708,4707,6,5,417122,14.936229728772748
olmesartan,Prothrombin time ratio decreased,1,4708,4707,14,13,417114,6.401119912592188
olmesartan,Protrusion of tongue,1,4708,4707,5,4,417123,17.923518164435947
olmesartan,Psychotic Disorders,1,4708,4707,19,18,417109,4.716558764661814
olmesartan,Pulmonary Edema,2,4708,4706,15,13,417114,11.951267884969543
olmesartan,Pulmonary artery stenosis,2,4708,4706,11,9,417118,16.297338021094927
olmesartan,Pulmonary cryptococcosis,3,4708,4705,27,24,417103,9.961223284921477
olmesartan,Pupillary light reflex tests abnormal,2,4708,4706,9,7,417120,19.91906313453275
olmesartan,"Purpura, Thrombotic Thrombocytopenic",10,4708,4698,110,100,417027,8.160629281318936
olmesartan,Pyuria,1,4708,4707,9,8,417119,9.95741566933409
olmesartan,Rales,13,4708,4695,375,362,416765,3.1119517216897403
olmesartan,Reactivation of hepatitis B viral hepatitis,1,4708,4707,11,10,417117,8.146937829538212
olmesartan,Rectal Prolapse,1,4708,4707,8,7,417120,11.202119184193755
olmesartan,"Reflex, Abnormal",1,4708,4707,29,28,417099,3.0900859321773146
olmesartan,Refusal of treatment by relative,2,4708,4706,9,7,417120,19.91906313453275
olmesartan,Renal failure neonatal,1,4708,4707,12,11,417116,7.468008639614759
olmesartan,Renal vascular disorder,2,4708,4706,13,11,417116,13.789989865637976
olmesartan,Rest Dyspnea,6,4708,4702,57,51,417076,9.442297790413933
olmesartan,Restless Legs Syndrome,6,4708,4702,173,167,416960,3.11019047361472
olmesartan,Retinal artery embolism,1,4708,4707,21,20,417107,4.267342458547047
olmesartan,Retinogram abnormal,3,4708,4705,7,4,417123,38.42368301199332
olmesartan,Right Ventricular Dysfunction,4,4708,4704,79,75,417052,4.539696891414794
olmesartan,Right bundle branch block,3,4708,4705,25,22,417105,10.758172157279489
olmesartan,Sense of smell impaired,8,4708,4700,23,15,417112,31.216429232192414
olmesartan,"Shock, Hemorrhagic",1,4708,4707,11,10,417117,8.146937829538212
olmesartan,Shortened PR interval,1,4708,4707,26,25,417102,3.4466588223758396
olmesartan,Sialolithiasis,1,4708,4707,6,5,417122,14.936229728772748
olmesartan,Skin laceration,1,4708,4707,14,13,417114,6.401119912592188
olmesartan,Skin weeping,1,4708,4707,7,6,417121,12.802452274727608
olmesartan,Small cell carcinoma of lung,1,4708,4707,13,12,417115,6.893530094294913
olmesartan,Soft Tissue Neoplasms,1,4708,4707,5,4,417123,17.923518164435947
olmesartan,Splenic Infection,1,4708,4707,16,15,417112,5.6009533673252605
olmesartan,Subileus,1,4708,4707,5,4,417123,17.923518164435947
olmesartan,Substance-induced psychotic disorder,2,4708,4706,12,10,417117,14.939191103555745
olmesartan,Suicide attempt,6,4708,4702,101,95,417032,5.3282656211176205
olmesartan,Superficial injury of eye,1,4708,4707,17,16,417111,5.271473025156525
olmesartan,Superinfection bacterial,2,4708,4706,25,23,417104,7.1705907352316185
olmesartan,Superior vena cava stenosis,4,4708,4704,28,24,417103,12.80997934888241
olmesartan,Suspected drug-induced liver injury,1,4708,4707,21,20,417107,4.267342458547047
olmesartan,Swelling of skin,1,4708,4707,26,25,417102,3.4466588223758396
olmesartan,"Tachycardia, Paroxysmal",2,4708,4706,24,22,417105,7.469383057090239
olmesartan,"Tachycardia, Ventricular",2,4708,4706,33,31,417096,5.432162680781465
olmesartan,Taste Disorders,2,4708,4706,51,49,417078,3.514778797196737
olmesartan,Therapeutic response unexpected with drug substitution,2,4708,4706,14,12,417115,12.80496023313703
olmesartan,"Thrombocythemia, Essential",2,4708,4706,40,38,417089,4.481459838504038
olmesartan,Thyroid Neoplasm,3,4708,4705,77,74,417053,3.492482437859696
olmesartan,Thyroxine level above reference range,7,4708,4701,161,154,416973,3.899947282261868
olmesartan,Tobacco user,1,4708,4707,24,23,417104,3.7338980950357623
olmesartan,Tooth Extraction,4,4708,4704,68,64,417063,5.274197178871549
olmesartan,Tooth Injuries,2,4708,4706,25,23,417104,7.1705907352316185
olmesartan,Toxicoderma,7,4708,4701,191,184,416943,3.287156236113292
olmesartan,Traumatic subcutaneous emphysema,2,4708,4706,8,6,417121,22.40899915002125
olmesartan,Trigeminal Neuralgia,1,4708,4707,24,23,417104,3.7338980950357623
olmesartan,Tumour perforation,1,4708,4707,21,20,417107,4.267342458547047
olmesartan,Ulcerative Colitis,6,4708,4702,156,150,416977,3.4492605437947845
olmesartan,Ultrasound Doppler abnormal,2,4708,4706,15,13,417114,11.951267884969543
olmesartan,Ultrasound liver abnormal,2,4708,4706,41,39,417088,4.37214557440942
olmesartan,Urine potassium abnormal,1,4708,4707,6,5,417122,14.936229728772748
olmesartan,Urine screening abnormal,4,4708,4704,52,48,417079,6.89728872318158
olmesartan,Uterine Cancer,1,4708,4707,5,4,417123,17.923518164435947
olmesartan,Uterine Prolapse,2,4708,4706,21,19,417108,8.536498492299597
olmesartan,Vaginal Diseases,1,4708,4707,20,19,417108,4.480720203951561
olmesartan,Vascular Grafting (surgical procedure),2,4708,4706,38,36,417091,4.71734851365558
olmesartan,Vascular occlusion,3,4708,4705,76,73,417054,3.5384445438782923
olmesartan,Vasculitic rash,1,4708,4707,11,10,417117,8.146937829538212
olmesartan,Verbal repetition,3,4708,4705,35,32,417095,7.684226506755731
olmesartan,Vertebroplasty,2,4708,4706,18,16,417111,9.95931907257874
olmesartan,Vesicular eczema of hands and/or feet,1,4708,4707,24,23,417104,3.7338980950357623
olmesartan,Vulval intraepithelial neoplasia,1,4708,4707,9,8,417119,9.95741566933409
olmesartan,Vulvovaginal dryness,3,4708,4705,39,36,417091,6.8960353143137425
olmesartan,Withdrawal of life support,4,4708,4704,16,12,417115,22.418101615646258
olmesartan,Wound infection pseudomonas,1,4708,4707,27,26,417101,3.3189969234158734
olmesartan,X-ray of pelvis and hip abnormal,1,4708,4707,9,8,417119,9.95741566933409
olmesartan,c-ANCA positive,2,4708,4706,29,27,417100,6.1814851180444625
olmesartan,congenital renal arteriovenous malformation,2,4708,4706,39,37,417090,4.5963799622958135
olmesartan,hypoglycemic encephalopathy,1,4708,4707,14,13,417114,6.401119912592188
perindopril,Abdominoplasty (procedure),3,13335,13332,6,3,408497,15.820169516951694
perindopril,Abnormal feces,40,13335,13295,243,203,408297,5.219846565047351
perindopril,Abnormal thyroxine,3,13335,13332,6,3,408497,15.820169516951694
perindopril,Abnormal urine odor,16,13335,13319,140,124,408376,3.6184183711775875
perindopril,Absolute neutrophil count abnormal,2,13335,13333,14,12,408488,4.519623704878336
perindopril,Acanthosis,1,13335,13334,6,5,408495,5.272598870056497
perindopril,Acidosis,16,13335,13319,157,141,408359,3.226485031918867
perindopril,Acquired corneal dystrophy,1,13335,13334,10,9,408491,3.1635293235338238
perindopril,Acral overgrowth,3,13335,13332,24,21,408479,3.9548736123612365
perindopril,Acute lymphocytic leukemia,9,13335,13326,64,55,408445,4.450813963304817
perindopril,"Adenocarcinoma, Oxyphilic",4,13335,13331,5,1,408499,25.314229990248297
perindopril,Adjustment disorder with depressed mood,2,13335,13333,6,4,408496,10.545988649716243
perindopril,Adrenal Gland Hyperfunction,6,13335,13329,33,27,408473,5.753715412054372
perindopril,Adverse reactions,27,13335,13308,284,257,408243,3.0114992252886115
perindopril,Agitation,1,13335,13334,8,7,408493,3.954430403479826
perindopril,Agnosia,3,13335,13332,11,8,408492,8.629081089927174
perindopril,Allergic respiratory symptom,4,13335,13331,24,20,408480,5.273560373065287
perindopril,Aminoaciduria,3,13335,13332,15,12,408488,6.327932793279329
perindopril,Anal abscess,4,13335,13331,37,33,408467,3.420582385701281
perindopril,Anastomotic stenosis,1,13335,13334,8,7,408493,3.954430403479826
perindopril,Anemia of chronic disease,18,13335,13317,189,171,408329,3.015451070418405
perindopril,"Angina, Unstable",13,13335,13322,46,33,408467,8.947698478489324
perindopril,Angiomyolipoma,3,13335,13332,16,13,408487,5.93242292979298
perindopril,Animal bite,11,13335,13324,83,72,408428,4.195049787863553
perindopril,Anti-DNA antibodies positive,2,13335,13333,5,3,408497,12.655216380409511
perindopril,"Aortic Aneurysm, Ruptured",3,13335,13332,18,15,408485,5.273239823982398
perindopril,Aortic aneurysm repair,6,13335,13329,18,12,408488,10.548853377347637
perindopril,Apparent life threatening event in infant,11,13335,13324,91,80,408420,3.8261816238399846
perindopril,Arthropod sting,5,13335,13330,34,29,408471,4.653380256828914
perindopril,Ascorbic Acid Deficiency,1,13335,13334,8,7,408493,3.954430403479826
perindopril,Aspiration Pneumonia,3,13335,13332,29,26,408474,3.272960054626152
perindopril,Asthenopia,9,13335,13326,34,25,408475,8.378598670445214
perindopril,Axillary vein thrombosis,8,13335,13327,70,62,408438,3.6168465735510082
perindopril,B-cell lymphoma stage IV,1,13335,13334,5,4,408496,6.3271336433178345
perindopril,Bacterial genital infection,2,13335,13333,21,19,408481,3.0130324686688597
perindopril,Bacterial peritonitis,2,13335,13333,12,10,408490,5.272919322983075
perindopril,Bacterial vulvovaginitis,5,13335,13330,6,1,408499,26.37090522630658
perindopril,Bed rest,10,13335,13325,22,12,408488,14.388981749957358
perindopril,Benign neoplasm of skin,1,13335,13334,6,5,408495,5.272598870056497
perindopril,Biopsy of thyroid (procedure),2,13335,13333,10,8,408492,6.327533188329709
perindopril,"Bladder cancer stage I, with cancer in situ",1,13335,13334,7,6,408494,4.5193597462984
perindopril,Bladder malposition acquired,3,13335,13332,29,26,408474,3.272960054626152
perindopril,Bladder prolapse,2,13335,13333,7,5,408495,9.039397413506766
perindopril,Bladder sphincter atony,3,13335,13332,5,2,408498,18.984248424842484
perindopril,Bleeding esophageal varices,1,13335,13334,8,7,408493,3.954430403479826
perindopril,Blood alkaline phosphatase increased,8,13335,13327,22,14,408486,11.509457901594166
perindopril,Blood cortisol increased,2,13335,13333,8,6,408494,7.909453986349659
perindopril,Blood lactic acid,1,13335,13334,8,7,408493,3.954430403479826
perindopril,Blood pH decreased,1,13335,13334,9,8,408492,3.5150409146209354
perindopril,Blood parathyroid hormone decreased,1,13335,13334,5,4,408496,6.3271336433178345
perindopril,Blood potassium abnormal,3,13335,13332,24,21,408479,3.9548736123612365
perindopril,Body Dysmorphic Disorders,9,13335,13326,70,61,408439,4.0692577346111785
perindopril,Body weight problem,12,13335,13323,112,100,408400,3.3914739280084927
perindopril,Brachial Plexus Neuropathies,12,13335,13323,16,4,408496,23.745721684305337
perindopril,Brain stem hemorrhage,10,13335,13325,43,33,408467,7.3614381081199
perindopril,Bronchial Neoplasms,2,13335,13333,18,16,408484,3.515229547405352
perindopril,Bronchitis,63,13335,13272,439,376,408124,4.556486260488452
perindopril,Bronchogenic Carcinoma,2,13335,13333,16,14,408486,3.954651991299782
perindopril,Brucellosis,8,13335,13327,69,61,408439,3.6692733396189277
perindopril,Burning sensation of skin,3,13335,13332,26,23,408477,3.650635255833276
perindopril,C-reactive protein outside reference range,2,13335,13333,5,3,408497,12.655216380409511
perindopril,CD4 Lymphocytes Decreased,7,13335,13328,65,58,408442,3.4079670329670333
perindopril,Calcinosis Cutis,3,13335,13332,5,2,408498,18.984248424842484
perindopril,Campylobacter infection,3,13335,13332,11,8,408492,8.629081089927174
perindopril,Cancer antigen 125 above reference range,2,13335,13333,19,17,408483,3.330209571028749
perindopril,Candida infection of genital region,1,13335,13334,6,5,408495,5.272598870056497
perindopril,Carbohydrate intolerance,2,13335,13333,15,13,408487,4.218305457636441
perindopril,Carbon monoxide diffusing capacity measurement,6,13335,13329,31,25,408475,6.124951899689979
perindopril,Cardiac Arrhythmia,7,13335,13328,33,26,408474,6.71317163228928
perindopril,Cardiac Hypertrophy,19,13335,13316,92,73,408427,6.54093555317565
perindopril,Cardiac perforation,6,13335,13329,14,8,408492,13.562940098389118
perindopril,Cardiovascular stress testing,9,13335,13326,76,67,408433,3.7479472262375886
perindopril,Catarrh,1,13335,13334,6,5,408495,5.272598870056497
perindopril,Cerebrospinal fluid leak,16,13335,13319,70,54,408446,7.2380380337434165
perindopril,Choroidal Effusions,4,13335,13331,13,9,408491,9.736057656243691
perindopril,Circumoral oedema,2,13335,13333,20,18,408482,3.1636915922898075
perindopril,Cleft upper lip,6,13335,13329,11,5,408495,17.26204652875821
perindopril,Cold Hemagglutinin Disease,1,13335,13334,5,4,408496,6.3271336433178345
perindopril,Colonic Pseudo-Obstruction,2,13335,13333,15,13,408487,4.218305457636441
perindopril,Congenital inguinal hernia,2,13335,13333,19,17,408483,3.330209571028749
perindopril,Conjunctivitis caused by adenovirus,3,13335,13332,14,11,408489,6.7799440658351555
perindopril,Conn Syndrome,5,13335,13330,31,26,408474,5.103743677854948
perindopril,Contusion of eyelid,2,13335,13333,15,13,408487,4.218305457636441
perindopril,Cor pulmonale,6,13335,13329,26,20,408480,7.302913831610658
perindopril,Coronavirus Infections,4,13335,13331,30,26,408474,4.2187882879503915
perindopril,Craniectomy,9,13335,13326,61,52,408448,4.669739668292971
perindopril,Creation of ileostomy,35,13335,13300,174,139,408361,6.37720810647308
perindopril,Cystic Fibrosis,2,13335,13333,11,9,408491,5.752289261776999
perindopril,Cytomegalovirus gastroenteritis,1,13335,13334,6,5,408495,5.272598870056497
perindopril,Decreased HDL cholesterol concentration,121,13335,13214,693,572,407928,5.564759358160296
perindopril,Decreased drug tolerance,7,13335,13328,7,0,408500,31.649759903961588
perindopril,"Delusional disorder, unspecified type",12,13335,13323,109,97,408403,3.4848420369823314
perindopril,Dental Pulp Diseases,7,13335,13328,30,23,408477,7.384541316526612
perindopril,Dependent edema,30,13335,13305,72,42,408458,13.208161092321182
perindopril,Depression suicidal,34,13335,13301,351,317,408183,3.0695068018577523
perindopril,Dermatitis Herpetiformis,1,13335,13334,9,8,408492,3.5150409146209354
perindopril,Dermo-hypodermitis,1,13335,13334,10,9,408491,3.1635293235338238
perindopril,Device damage,3,13335,13332,17,14,408486,5.583443638481496
perindopril,Dextrocardia,1,13335,13334,6,5,408495,5.272598870056497
perindopril,Diabetes mellitus inadequate control,1,13335,13334,8,7,408493,3.954430403479826
perindopril,Diastolic dysfunction,13,13335,13322,109,96,408404,3.7755289243563457
perindopril,Differential white blood cell count abnormal,5,13335,13330,20,15,408485,7.911009002250563
perindopril,Diffuse alopecia,2,13335,13333,8,6,408494,7.909453986349659
perindopril,Dilatation intrahepatic duct acquired,3,13335,13332,7,4,408496,13.56011315417256
perindopril,Dilatation of pulmonary artery (disorder),2,13335,13333,7,5,408495,9.039397413506766
perindopril,Dilatation of ureter,2,13335,13333,18,16,408484,3.515229547405352
perindopril,Disorder of anterior chamber of eye,17,13335,13318,179,162,408338,3.0068735470371935
perindopril,Disorder of synovial membrane,1,13335,13334,7,6,408494,4.5193597462984
perindopril,Disorder of transplanted kidney,1,13335,13334,10,9,408491,3.1635293235338238
perindopril,Dissection of aorta,2,13335,13333,20,18,408482,3.1636915922898075
perindopril,Disseminated Histoplasmosis,2,13335,13333,15,13,408487,4.218305457636441
perindopril,Drug Dependence,1,13335,13334,9,8,408492,3.5150409146209354
perindopril,Drug dose omission by device,10,13335,13325,23,13,408487,13.763341218696468
perindopril,Drug withdrawal syndrome,17,13335,13318,134,117,408383,4.017073178931891
perindopril,Duodenal Ulcer,9,13335,13326,70,61,408439,4.0692577346111785
perindopril,Dysmorphism,1,13335,13334,5,4,408496,6.3271336433178345
perindopril,Elbow deformity,1,13335,13334,7,6,408494,4.5193597462984
perindopril,Encephalomyelitis,1,13335,13334,8,7,408493,3.954430403479826
perindopril,Endoscopy (procedure),2,13335,13333,13,11,408489,4.867298605542062
perindopril,Enophthalmos,2,13335,13333,6,4,408496,10.545988649716243
perindopril,Eosinophil percentage decreased,6,13335,13329,12,6,408494,15.82350513917023
perindopril,Eructation,59,13335,13276,478,419,408081,3.9174826755046706
perindopril,Eye opacity,1,13335,13334,6,5,408495,5.272598870056497
perindopril,Faecal volume decreased,1,13335,13334,10,9,408491,3.1635293235338238
perindopril,Femoral artery embolus,2,13335,13333,20,18,408482,3.1636915922898075
perindopril,Fetal Death,2,13335,13333,8,6,408494,7.909453986349659
perindopril,Finger repair operation,2,13335,13333,13,11,408489,4.867298605542062
perindopril,Fistula discharge,31,13335,13304,185,154,408346,5.310798621832898
perindopril,Flat affect,2,13335,13333,21,19,408481,3.0130324686688597
perindopril,Foetal exposure during pregnancy,16,13335,13319,152,136,408364,3.3326589241329163
perindopril,Foreign body sensation (finding),13,13335,13322,47,34,408466,8.75730115278838
perindopril,Fracture of coccyx,5,13335,13330,23,18,408482,6.87908933755178
perindopril,Friedreich Ataxia,3,13335,13332,11,8,408492,8.629081089927174
perindopril,Gangrene due to diabetes mellitus,3,13335,13332,6,3,408497,15.820169516951694
perindopril,Gastric ulcer,48,13335,13287,474,426,408074,3.211369636067613
perindopril,Gastroenteritis,32,13335,13303,245,213,408287,4.139278082126634
perindopril,Gastrointestinal arteriovenous malformation,26,13335,13309,231,205,408295,3.565501846063872
perindopril,Gastrointestinal mucosal disorder,3,13335,13332,11,8,408492,8.629081089927174
perindopril,Gastrointestinal vascular malformation haemorrhagic,7,13335,13328,7,0,408500,31.649759903961588
perindopril,Gastrointestinal viral infection,1,13335,13334,5,4,408496,6.3271336433178345
perindopril,Gliosis,5,13335,13330,11,6,408494,14.383959626270203
perindopril,Glucocorticoid deficiency,2,13335,13333,8,6,408494,7.909453986349659
perindopril,Glycosylated haemoglobin abnormal,1,13335,13334,9,8,408492,3.5150409146209354
perindopril,Grip strength decreased,30,13335,13305,179,149,408351,5.311432044491192
perindopril,Haemophilus Infections,4,13335,13331,8,4,408496,15.821281224214237
perindopril,Haemorrhagic transformation stroke,1,13335,13334,8,7,408493,3.954430403479826
perindopril,"Hallucinations, Auditory",13,13335,13322,116,103,408397,3.5476363961091066
perindopril,"Hallucinations, Olfactory",5,13335,13330,10,5,408495,15.822393098274567
perindopril,Heart Transplantation,3,13335,13332,8,5,408495,11.86507088208821
perindopril,"Hematoma, Epidural, Cranial",5,13335,13330,31,26,408474,5.103743677854948
perindopril,Hemodialysis,4,13335,13331,37,33,408467,3.420582385701281
perindopril,Hemorrhagic stomatitis,3,13335,13332,12,9,408491,7.909972247224722
perindopril,Hepatic enzyme decreased,3,13335,13332,7,4,408496,13.56011315417256
perindopril,Hepatitis B DNA increased,15,13335,13320,31,16,408484,15.322725951758212
perindopril,"Hepatitis C, Chronic",4,13335,13331,16,12,408488,7.910490585852525
perindopril,"Hepatitis, Toxic",11,13335,13324,81,70,408430,4.298651648746715
perindopril,Humeral Fractures,7,13335,13328,71,64,408436,3.1199254349627177
perindopril,Hydrocele operation,5,13335,13330,44,39,408461,3.595708586237468
perindopril,Hyperesthesia,5,13335,13330,42,37,408463,3.766950666237988
perindopril,Hypermagnesemia,2,13335,13333,7,5,408495,9.039397413506766
perindopril,"Hyperparathyroidism, Primary",55,13335,13280,440,385,408115,3.96644390060241
perindopril,Hyperpigmentation,15,13335,13320,63,48,408452,7.539182039182039
perindopril,Hypertriglyceridemia,3,13335,13332,18,15,408485,5.273239823982398
perindopril,Hypertrophy of submaxillary gland,1,13335,13334,5,4,408496,6.3271336433178345
perindopril,Hypoalbuminemia,1,13335,13334,5,4,408496,6.3271336433178345
perindopril,Hypochondriasis,3,13335,13332,22,19,408481,4.314428033712462
perindopril,Hypoglycemic coma,8,13335,13327,16,8,408492,15.825729721617767
perindopril,Hypohidrosis,1,13335,13334,10,9,408491,3.1635293235338238
perindopril,Hypovolemia,6,13335,13329,59,53,408447,3.2179814371874254
perindopril,INR Increased,13,13335,13322,57,44,408456,7.220761331342167
perindopril,Idiopathic basal ganglia calcification 1,1,13335,13334,5,4,408496,6.3271336433178345
perindopril,Incorrect product administration duration,11,13335,13324,94,83,408417,3.7040430961247344
perindopril,Infection causing abscess of colon,1,13335,13334,7,6,408494,4.5193597462984
perindopril,Inflammation,1,13335,13334,7,6,408494,4.5193597462984
perindopril,Inflammatory Bowel Diseases,2,13335,13333,10,8,408492,6.327533188329709
perindopril,Infusion site erythema,1,13335,13334,8,7,408493,3.954430403479826
perindopril,Injection site cyst,1,13335,13334,8,7,408493,3.954430403479826
perindopril,Injection site dryness,5,13335,13330,28,23,408477,5.6506135462437035
perindopril,Injury of mouth,7,13335,13328,21,14,408486,10.54956982793117
perindopril,Injury of retina,20,13335,13315,110,90,408410,5.758713685863517
perindopril,Instillation site discomfort,9,13335,13326,40,31,408469,7.121707564160289
perindopril,Insulin Resistance,26,13335,13309,205,179,408321,4.017959605548419
perindopril,Intraductal papillary-mucinous carcinoma of pancreas,1,13335,13334,10,9,408491,3.1635293235338238
perindopril,Intraocular pressure test,1,13335,13334,10,9,408491,3.1635293235338238
perindopril,Ischemia,18,13335,13317,64,46,408454,8.907643895021401
perindopril,Ischemic stroke,4,13335,13331,19,15,408485,6.6614183797954105
perindopril,Kidney Transplantation,1,13335,13334,9,8,408492,3.5150409146209354
perindopril,Klebsiella Infections,16,13335,13319,32,16,408484,15.834634732337264
perindopril,Laryngospasm,5,13335,13330,29,24,408476,5.455751869001733
perindopril,Ligamentitis,4,13335,13331,22,18,408482,5.753002229935693
perindopril,Lipase increased,46,13335,13289,303,257,408243,4.815633764444997
perindopril,Liver induration,2,13335,13333,6,4,408496,10.545988649716243
perindopril,Lobular carcinoma in situ of breast,4,13335,13331,5,1,408499,25.314229990248297
perindopril,Loss of proprioception,1,13335,13334,10,9,408491,3.1635293235338238
perindopril,Lower abdominal pain,3,13335,13332,22,19,408481,4.314428033712462
perindopril,"Lung Diseases, Obstructive",2,13335,13333,6,4,408496,10.545988649716243
perindopril,Lung Injury,3,13335,13332,10,7,408493,9.492011701170116
perindopril,Lymph nodes scan abnormal,7,13335,13328,27,20,408480,8.205104263927794
perindopril,"Lymphangioma, Cystic",9,13335,13326,23,14,408486,12.386077560049332
perindopril,Lymphangiosis carcinomatosa,1,13335,13334,9,8,408492,3.5150409146209354
perindopril,Macular degeneration,3,13335,13332,26,23,408477,3.650635255833276
perindopril,Magnesium Deficiency,7,13335,13328,59,52,408448,3.7545933627688366
perindopril,Malaria,1,13335,13334,6,5,408495,5.272598870056497
perindopril,Malignant neoplasm of parietal pleura,7,13335,13328,10,3,408497,22.154674369747898
perindopril,Malignant neoplasm of stomach stage IV,3,13335,13332,6,3,408497,15.820169516951694
perindopril,Manipulation of joint - non-surgical,2,13335,13333,7,5,408495,9.039397413506766
perindopril,Marasmus,1,13335,13334,7,6,408494,4.5193597462984
perindopril,Mask-like facies,2,13335,13333,11,9,408491,5.752289261776999
perindopril,Mass of urinary bladder,8,13335,13327,31,23,408477,8.167828105446862
perindopril,Maternal exposure during pregnancy,36,13335,13299,288,252,408248,3.962205804947741
perindopril,Mean corpuscular volume above reference range,1,13335,13334,10,9,408491,3.1635293235338238
perindopril,Medical device site injury,1,13335,13334,5,4,408496,6.3271336433178345
perindopril,Medication residue present,3,13335,13332,28,25,408475,3.3898595216664527
perindopril,Meningorrhagia,13,13335,13322,26,13,408487,15.831294099984989
perindopril,Merkel cell carcinoma,4,13335,13331,17,13,408487,7.445149960066542
perindopril,Metabolic alkalosis,13,13335,13322,113,100,408400,3.6418473401506324
perindopril,Metastasis from malignant neoplasm of colon and/or rectum,3,13335,13332,5,2,408498,18.984248424842484
perindopril,Metastatic liver carcinoma,2,13335,13333,21,19,408481,3.0130324686688597
perindopril,Miosis disorder,39,13335,13296,185,146,408354,6.685347350961069
perindopril,Miscarriage of partner,3,13335,13332,5,2,408498,18.984248424842484
perindopril,Mitral valve sclerosis,2,13335,13333,8,6,408494,7.909453986349659
perindopril,Mononucleosis syndrome,1,13335,13334,7,6,408494,4.5193597462984
perindopril,Mood Disorders,2,13335,13333,18,16,408484,3.515229547405352
perindopril,Morose,4,13335,13331,17,13,408487,7.445149960066542
perindopril,Myeloma kidney,1,13335,13334,9,8,408492,3.5150409146209354
perindopril,Myocardial rupture,2,13335,13333,11,9,408491,5.752289261776999
perindopril,Myocardial strain imaging,4,13335,13331,24,20,408480,5.273560373065287
perindopril,Myoglobin blood increased,4,13335,13331,12,8,408492,10.547420798639761
perindopril,Myositis,3,13335,13332,12,9,408491,7.909972247224722
perindopril,Nail discomfort,2,13335,13333,8,6,408494,7.909453986349659
perindopril,Necrosis of pancreas,4,13335,13331,6,2,408498,21.09514164978871
perindopril,Necrotising retinitis,9,13335,13326,20,11,408489,14.244090499774876
perindopril,Necrotizing fasciitis,9,13335,13326,54,45,408455,5.275163840112062
perindopril,Needle track,2,13335,13333,6,4,408496,10.545988649716243
perindopril,Neonatal hypoglycemia,3,13335,13332,25,22,408478,3.796669666966696
perindopril,Neoplasm of pericardium,1,13335,13334,6,5,408495,5.272598870056497
perindopril,Neuromuscular Diseases,1,13335,13334,9,8,408492,3.5150409146209354
perindopril,Neutrophil percentage decreased,1,13335,13334,5,4,408496,6.3271336433178345
perindopril,Neutrophilia (disorder),3,13335,13332,8,5,408495,11.86507088208821
perindopril,Neutrophilic dermatosis,1,13335,13334,9,8,408492,3.5150409146209354
perindopril,Night sweats,1,13335,13334,10,9,408491,3.1635293235338238
perindopril,Noninfectious peritonitis,3,13335,13332,8,5,408495,11.86507088208821
perindopril,Normochromic anemia,15,13335,13320,22,7,408493,21.591574529074528
perindopril,Nose Diseases,6,13335,13329,37,31,408469,5.131643459800111
perindopril,Nuchal Rigidity,3,13335,13332,5,2,408498,18.984248424842484
perindopril,Oesophageal squamous cell carcinoma recurrent,4,13335,13331,10,6,408494,12.656964968869554
perindopril,Operation on facial joint,5,13335,13330,5,0,408500,31.64516129032258
perindopril,Operation on retina,2,13335,13333,7,5,408495,9.039397413506766
perindopril,Operative procedure on small intestine,2,13335,13333,8,6,408494,7.909453986349659
perindopril,Oral Ulcer,4,13335,13331,12,8,408492,10.547420798639761
perindopril,Oral mucosal exfoliation,5,13335,13330,6,1,408499,26.37090522630658
perindopril,Orgasmic Disorder,1,13335,13334,7,6,408494,4.5193597462984
perindopril,Orthopnea,5,13335,13330,32,27,408473,4.94423996624156
perindopril,Pain in axilla,4,13335,13331,8,4,408496,15.821281224214237
perindopril,Panic Attacks,34,13335,13301,255,221,408279,4.2260481668045005
perindopril,Paradoxical bronchospasm,6,13335,13329,27,21,408479,7.032418869465909
perindopril,Paresis,2,13335,13333,15,13,408487,4.218305457636441
perindopril,Partial thromboplastin time increased (finding),2,13335,13333,15,13,408487,4.218305457636441
perindopril,Pelvic discomfort,3,13335,13332,8,5,408495,11.86507088208821
perindopril,Pelvic haemorrhage,18,13335,13317,93,75,408425,6.129570013589227
perindopril,Peptic Ulcer Perforation,1,13335,13334,6,5,408495,5.272598870056497
perindopril,"Pericarditis, Constrictive",4,13335,13331,6,2,408498,21.09514164978871
perindopril,Peripheral artery thrombosis,30,13335,13305,274,244,408256,3.469095367802566
perindopril,Peripheral swelling,1,13335,13334,7,6,408494,4.5193597462984
perindopril,Perirectal abscess,6,13335,13329,40,34,408466,4.746736439342786
perindopril,Phagophobia,2,13335,13333,5,3,408497,12.655216380409511
perindopril,Pharyngeal swelling,4,13335,13331,14,10,408490,9.040603534189911
perindopril,Phobic avoidance - mental defense mechanism,16,13335,13319,99,83,408417,5.117452776886669
perindopril,Pituitary hemorrhage,2,13335,13333,5,3,408497,12.655216380409511
perindopril,Placenta Previa,7,13335,13328,45,38,408462,4.922852474323062
perindopril,Plasmacytoma,7,13335,13328,41,34,408466,5.403182004509121
perindopril,Platelet count outside reference range,1,13335,13334,6,5,408495,5.272598870056497
perindopril,"Pleural Effusion, Malignant",30,13335,13305,170,140,408360,5.592744876981233
perindopril,Pleural effusion (disorder),6,13335,13329,20,14,408486,9.493923024983118
perindopril,Pleurocutaneous fistula,1,13335,13334,10,9,408491,3.1635293235338238
perindopril,Pneumonia,135,13335,13200,1348,1213,407287,3.1902338481251684
perindopril,Pneumonia and influenza,1,13335,13334,10,9,408491,3.1635293235338238
perindopril,Pneumonia caused by respiratory syncytial virus,5,13335,13330,50,45,408455,3.1641785446361594
perindopril,Pneumonia due to Klebsiella pneumoniae,3,13335,13332,14,11,408489,6.7799440658351555
perindopril,Poisoning by parasympathomimetic drug,23,13335,13312,184,161,408339,3.9593130258413463
perindopril,Polycystic Ovary Syndrome,8,13335,13327,31,23,408477,8.167828105446862
perindopril,Polyneuropathy,6,13335,13329,52,46,408454,3.6512318426565558
perindopril,"Polyradiculoneuropathy, Chronic Inflammatory Demyelinating",4,13335,13331,28,24,408476,4.520151740840362
perindopril,Porokeratosis,7,13335,13328,36,29,408471,6.1536968954248366
perindopril,Positional Vertigo,12,13335,13323,99,87,408413,3.8369372627422615
perindopril,Primary Hypothyroidism,1,13335,13334,8,7,408493,3.954430403479826
perindopril,Product availability issue,18,13335,13317,146,128,408372,3.903961462380457
perindopril,Product counterfeit,14,13335,13321,125,111,408389,3.5456437204414084
perindopril,Proliferative glomerulonephritis,1,13335,13334,6,5,408495,5.272598870056497
perindopril,Prolonged PR interval,14,13335,13321,24,10,408490,18.471317218427046
perindopril,Prostatectomy,1,13335,13334,6,5,408495,5.272598870056497
perindopril,Pyometra,3,13335,13332,9,6,408494,10.546704670467047
perindopril,Quadriplegia,1,13335,13334,5,4,408496,6.3271336433178345
perindopril,Raynaud Phenomenon,5,13335,13330,18,13,408487,8.790051679586565
perindopril,Rectal Prolapse,1,13335,13334,8,7,408493,3.954430403479826
perindopril,Recurrent Chronic Lymphoid Leukemia,10,13335,13325,43,33,408467,7.3614381081199
perindopril,Reflux gastritis,6,13335,13329,25,19,408481,7.595048390726987
perindopril,Refusal of Treatment,1,13335,13334,10,9,408491,3.1635293235338238
perindopril,Rehabilitation therapy,8,13335,13327,23,15,408485,11.009020589127662
perindopril,Renal Osteodystrophy,4,13335,13331,37,33,408467,3.420582385701281
perindopril,Renal cancer recurrent,2,13335,13333,10,8,408492,6.327533188329709
perindopril,Renal mass,12,13335,13323,29,17,408483,13.100684064632848
perindopril,Repair of hip,20,13335,13315,184,164,408336,3.4421051772273836
perindopril,Respiratory Failure,5,13335,13330,45,40,408460,3.515795615570559
perindopril,Respiratory syncytial virus bronchitis,1,13335,13334,6,5,408495,5.272598870056497
perindopril,Rest Dyspnea,9,13335,13326,57,48,408452,4.997488092134885
perindopril,Retinal Hemorrhage,4,13335,13331,33,29,408471,3.835234802454066
perindopril,Retinogram abnormal,1,13335,13334,7,6,408494,4.5193597462984
perindopril,Rhinorrhea,90,13335,13245,903,813,407687,3.167486257586076
perindopril,Rupture of tendon,5,13335,13330,47,42,408458,3.366171330066559
perindopril,Ruptured cerebral aneurysm,2,13335,13333,17,15,408485,3.72201657982626
perindopril,Ruptured varicose veins,4,13335,13331,9,5,408495,14.063327749022744
perindopril,Sarcoidosis,9,13335,13326,57,48,408452,4.997488092134885
perindopril,Seborrheic dermatitis of scalp,2,13335,13333,21,19,408481,3.0130324686688597
perindopril,Second degree atrioventricular block,6,13335,13329,57,51,408449,3.3309088611693536
perindopril,Seizure like phenomena,1,13335,13334,7,6,408494,4.5193597462984
perindopril,Sensorimotor disorder,1,13335,13334,5,4,408496,6.3271336433178345
perindopril,Sialolithiasis,1,13335,13334,6,5,408495,5.272598870056497
perindopril,Sirenomelia,5,13335,13330,14,9,408491,11.301602186260851
perindopril,"Sleep disorder due to general medical condition, insomnia type",17,13335,13318,38,21,408479,14.168693339445625
perindopril,Sleeplessness,14,13335,13321,120,106,408394,3.6934226659660183
perindopril,Small Intestinal Stenosis,7,13335,13328,22,15,408485,10.070020053475934
perindopril,Spontaneous pneumothorax,1,13335,13334,6,5,408495,5.272598870056497
perindopril,Stage II Colon Cancer,22,13335,13313,219,197,408303,3.181410555206279
perindopril,Stage IV Non-Hodgkin Lymphoma,1,13335,13334,10,9,408491,3.1635293235338238
perindopril,Starvation,48,13335,13287,208,160,408340,7.3228372440384195
perindopril,Steroid withdrawal syndrome,5,13335,13330,25,20,408480,6.328732183045761
perindopril,Strangulated femoral hernia,3,13335,13332,9,6,408494,10.546704670467047
perindopril,Subclavian Steal Syndrome,1,13335,13334,7,6,408494,4.5193597462984
perindopril,Subcutaneous hematoma,7,13335,13328,31,24,408476,7.146313364055299
perindopril,Superior vena cava stenosis,5,13335,13330,28,23,408477,5.6506135462437035
perindopril,Suture insertion,1,13335,13334,8,7,408493,3.954430403479826
perindopril,Sweat gland infection,1,13335,13334,6,5,408495,5.272598870056497
perindopril,Swelling at injection site,4,13335,13331,40,36,408464,3.1640162028354966
perindopril,"Synovitis, Acne, Pustulosis, Hyperostosis, and Osteitis Syndrome",6,13335,13329,11,5,408495,17.26204652875821
perindopril,Taste Disorders,16,13335,13319,51,35,408465,9.93500954702776
perindopril,Telangiectasis,2,13335,13333,14,12,408488,4.519623704878336
perindopril,Thalassemia,13,13335,13322,17,4,408496,24.213084062629704
perindopril,Therapeutic product effect decreased,9,13335,13326,54,45,408455,5.275163840112062
perindopril,Therapeutic product effect incomplete,7,13335,13328,17,10,408490,13.031945130993574
perindopril,Thoracic Procedure Postoperative Complication,8,13335,13327,77,69,408431,3.2879877682158765
perindopril,Threatened labour,16,13335,13319,35,19,408481,14.477277358875078
perindopril,Thrombocytopenia,10,13335,13325,62,52,408448,5.105283544150578
perindopril,Thrombocytosis,1,13335,13334,5,4,408496,6.3271336433178345
perindopril,Thrombosis of jugular vein,21,13335,13314,191,170,408330,3.4819561662840437
perindopril,Time perception altered,2,13335,13333,5,3,408497,12.655216380409511
perindopril,Tinnitus,19,13335,13316,184,165,408335,3.269754349132133
perindopril,Tooth repair,6,13335,13329,12,6,408494,15.82350513917023
perindopril,Traumatic injury of visual pathways,1,13335,13334,6,5,408495,5.272598870056497
perindopril,Trifascicular block,1,13335,13334,5,4,408496,6.3271336433178345
perindopril,Triple Negative Breast Neoplasms,6,13335,13329,16,10,408490,11.867516317803286
perindopril,Tubulointerstitial nephritis and uveitis,1,13335,13334,9,8,408492,3.5150409146209354
perindopril,Unspecified abortion incomplete,9,13335,13326,20,11,408489,14.244090499774876
perindopril,Urinary Bladder Fistula,25,13335,13310,139,114,408386,5.698317379154528
perindopril,Urinary tract infection pseudomonal,3,13335,13332,11,8,408492,8.629081089927174
perindopril,Urine calcium increased,5,13335,13330,15,10,408490,10.548137034258563
perindopril,Urine osmolarity decreased,10,13335,13325,20,10,408490,15.82795497185741
perindopril,Urine potassium abnormal,1,13335,13334,6,5,408495,5.272598870056497
perindopril,Vascular stent thrombosis,15,13335,13320,39,24,408476,12.17937167937168
perindopril,"Ventricular Dysfunction, Left",3,13335,13332,23,20,408480,4.126834422572692
perindopril,Vertebroplasty,4,13335,13331,18,14,408486,7.031513848256778
perindopril,Vitamin B12 absorption decreased,4,13335,13331,24,20,408480,5.273560373065287
perindopril,alpha 1-Antitrypsin Deficiency,7,13335,13328,7,0,408500,31.649759903961588
perindopril,congenital renal arteriovenous malformation,5,13335,13330,39,34,408466,4.056744955469636
perindopril,prostatitis,15,13335,13320,150,135,408365,3.1658033033033033
prazosin,Abdomen distended,1,492,491,83,82,421261,10.348980443157558
prazosin,Abnormal urine odor,5,492,487,140,135,421208,30.9251246699912
prazosin,"Acidosis, Lactic",1,492,491,165,164,421179,5.204838610133926
prazosin,Acute pyelonephritis,3,492,489,133,130,421213,19.452096498916
prazosin,Adrenal Cortical Adenoma,1,492,491,35,34,421309,24.54466104160605
prazosin,Alanine Aminotransferase Increased,1,492,491,188,187,421156,4.567827273909087
prazosin,Allergy to animal,1,492,491,233,232,421111,3.6852355270403745
prazosin,Altered visual depth perception,1,492,491,91,90,421253,9.43900091761599
prazosin,Amblyopia,1,492,491,73,72,421271,11.766927991518566
prazosin,Anaphylactoid Reaction,1,492,491,286,285,421058,3.0019298420520415
prazosin,Anemia of chronic disease,1,492,491,189,188,421155,4.543648099656246
prazosin,Apallic syndrome,3,492,489,198,195,421148,13.064293239139866
prazosin,Application site irritation,1,492,491,87,86,421257,9.873071610834094
prazosin,Ataxia,5,492,487,40,35,421308,108.26360369609857
prazosin,Atypical fracture of femur,1,492,491,41,40,421303,20.95246137797427
prazosin,Bacterial Endocarditis,1,492,491,175,174,421169,4.90730288041897
prazosin,Balanitis,2,492,490,83,81,421262,20.740201622817803
prazosin,Benign neoplasm of kidney,2,492,490,457,455,420888,3.7634796588219532
prazosin,Blepharitis,1,492,491,58,57,421286,14.810625746190041
prazosin,Blister of lip,1,492,491,22,21,421322,39.049527865210145
prazosin,Blood glucose outside reference range,3,492,489,668,665,420678,3.86803387090849
prazosin,Blunted affect,1,492,491,102,101,421242,8.420849806317639
prazosin,Body fluid retention,6,492,486,1627,1621,419722,3.188539082003536
prazosin,Bursitis,1,492,491,121,120,421223,7.098247799229099
prazosin,Cardiac Arrhythmia,1,492,491,33,32,421311,26.03233969018083
prazosin,Cardiovascular stress testing,1,492,491,76,75,421268,11.302363597384499
prazosin,Carpal Tunnel Syndrome,1,492,491,55,54,421289,15.618589150157378
prazosin,Catatonia,1,492,491,100,99,421244,8.589307535641549
prazosin,Cerebral Ischemia,1,492,491,183,182,421161,4.692686944231133
prazosin,Cerebrovascular accident,2,492,490,23,21,421322,74.85572315882874
prazosin,Chapping of lips,1,492,491,131,130,421213,6.55624135196903
prazosin,Chills,4,492,488,670,666,420677,5.152495718130658
prazosin,Chronic sinusitis,1,492,491,75,74,421269,11.453088934147999
prazosin,Cognitive function: distractibility,1,492,491,46,45,421298,18.674798547772955
prazosin,Coital bleeding,1,492,491,9,8,421335,95.45734329033716
prazosin,Congenital anomaly of central nervous system,3,492,489,648,645,420698,3.9876069832613794
prazosin,Congenital cystic kidney disease,1,492,491,55,54,421289,15.618589150157378
prazosin,Congenital phimosis,2,492,490,6,4,421339,286.95850340136053
prazosin,Congestive heart failure,2,492,490,308,306,421037,5.5860985952822695
prazosin,Connective Tissue Diseases,7,492,485,1120,1113,420230,5.421585051546392
prazosin,Corneal dystrophy,1,492,491,50,49,421294,17.180651731160896
prazosin,Crystal nephropathy,1,492,491,21,20,421323,40.90912617592861
prazosin,Culture urine positive,1,492,491,17,16,421327,50.535282137294836
prazosin,Cytomegalovirus viremia,1,492,491,82,81,421262,10.475212359048234
prazosin,De Quervain Disease,1,492,491,175,174,421169,4.90730288041897
prazosin,Decreased thyroxine level,1,492,491,40,39,421304,21.47632382892057
prazosin,Dehydration,5,492,487,1376,1371,419972,3.1372292989828567
prazosin,Dehydroepiandrosterone decreased,1,492,491,5,4,421339,171.82484725050918
prazosin,Dermatitis,3,492,489,479,476,420867,5.396672515593582
prazosin,Difficult venous access,2,492,490,16,14,421329,107.60688775510204
prazosin,Dilatation of aorta,2,492,490,308,306,421037,5.5860985952822695
prazosin,Dissociative disorder,1,492,491,101,100,421243,8.504244721824524
prazosin,Drug effect incomplete,1,492,491,34,33,421310,25.266622738708516
prazosin,Duodenal ulcer with hemorrhage,1,492,491,279,278,421065,3.0772981772259085
prazosin,Dyskinetic syndrome,2,492,490,218,216,421127,7.893971166448231
prazosin,Dyspnea,2,492,490,191,189,421154,9.010449834384016
prazosin,Echocardiogram abnormal (finding),2,492,490,235,233,421110,7.322622666087711
prazosin,Edema of esophagus,2,492,490,325,323,421020,5.2936891679748825
prazosin,Electrocardiogram abnormal (finding),1,492,491,142,141,421202,6.048205731333009
prazosin,Elevated circulating hepatic transaminase concentration,1,492,491,193,192,421151,4.449437016557095
prazosin,Enamel anomaly,1,492,491,20,19,421324,42.95468431771894
prazosin,Encephalopathies,1,492,491,11,10,421333,78.1010923902981
prazosin,Endoscopy (procedure),1,492,491,13,12,421331,66.08522638257874
prazosin,Epididymitis,1,492,491,19,18,421325,45.2155643691714
prazosin,Epistaxis,2,492,490,258,256,421087,6.669466856510046
prazosin,Eructation,6,492,486,478,472,420871,10.882716049382715
prazosin,Esophageal carcinoma,1,492,491,79,78,421265,10.873082574956817
prazosin,Exfoliative rash,1,492,491,277,276,421067,3.099531641753733
prazosin,Extrinsic allergic alveolitis,1,492,491,166,165,421178,5.173471891639879
prazosin,Fear (Mental Process),4,492,488,118,114,421229,29.2940400111142
prazosin,Feeling abnormal,2,492,490,528,526,420817,3.256856833642548
prazosin,Feeling despair,1,492,491,143,142,421201,6.005896343981885
prazosin,Femoral Fractures,1,492,491,77,76,421267,11.15555320443304
prazosin,Fever,1,492,491,32,31,421312,26.84591395112016
prazosin,Fibrillation,1,492,491,184,183,421160,4.667172142034889
prazosin,Flushing,2,492,490,242,240,421103,7.110693202900995
prazosin,Fracture of lower leg,1,492,491,126,125,421218,6.816490479423269
prazosin,Fungemia,1,492,491,38,37,421306,22.6067638546468
prazosin,Fusariosis,1,492,491,115,114,421229,7.468697423182503
prazosin,Gastric Carcinoid Tumor,3,492,489,704,701,420642,3.669922964305633
prazosin,Gastroenteritis,1,492,491,245,244,421099,3.5046344403341787
prazosin,Gastroenteritis norovirus,7,492,485,202,195,421148,30.125865060732878
prazosin,Gastrointestinal carcinoma,2,492,490,350,348,420995,4.91527696793003
prazosin,Gastrointestinal ulcer,1,492,491,120,119,421224,7.1574168363883235
prazosin,General physical health deterioration,6,492,486,818,812,420531,6.354206284524133
prazosin,Gingival discolouration,2,492,490,113,111,421232,15.232869785082174
prazosin,HELLP Syndrome,2,492,490,405,403,420940,4.2472159234064
prazosin,Haemorrhagic arteriovenous malformation,1,492,491,57,56,421287,15.070497016471931
prazosin,Headache,1,492,491,204,203,421140,4.209406573219919
prazosin,Heat Cramps,1,492,491,264,263,421080,3.2522603838795283
prazosin,Hemiparesis,1,492,491,59,58,421285,14.559563671510926
prazosin,Hemorrhage of kidney,1,492,491,11,10,421333,78.1010923902981
prazosin,Hemorrhagic diarrhea,1,492,491,41,40,421303,20.95246137797427
prazosin,Hepatotoxicity,1,492,491,186,185,421158,4.6169655957777636
prazosin,Hospitalization,1,492,491,55,54,421289,15.618589150157378
prazosin,Hot flushes,1,492,491,243,242,421101,3.5334959308709024
prazosin,Hypergammaglobulinemia,1,492,491,63,62,421281,13.635017618724337
prazosin,Hypertensive disease,2,492,490,164,162,421181,10.494549527127925
prazosin,Hypothermia due to exposure,1,492,491,43,42,421301,19.97783356226022
prazosin,Hypothyroidism,12,492,480,2794,2782,418561,3.749472083035075
prazosin,Hypovolemia,1,492,491,59,58,421285,14.559563671510926
prazosin,Ileus,1,492,491,198,197,421146,4.337026065131972
prazosin,Impaired judgement,1,492,491,38,37,421306,22.6067638546468
prazosin,Impaired pupillary reflex,1,492,491,109,108,421235,7.879930491974813
prazosin,Impaired work ability,3,492,489,270,267,421076,9.578845716882528
prazosin,Impairment of urinary concentration,1,492,491,5,4,421339,171.82484725050918
prazosin,Incorrect storage of drug,1,492,491,108,107,421236,7.952911669306781
prazosin,Increased energy,8,492,484,214,206,421137,32.56515022785201
prazosin,Infective vaginitis,5,492,487,115,110,421233,37.65020980269619
prazosin,Inflammatory pain,1,492,491,32,31,421312,26.84591395112016
prazosin,Infusion site inflammation,2,492,490,529,527,420816,3.250692488715713
prazosin,Injection site anesthesia,1,492,491,25,24,421319,34.36334012219959
prazosin,Intraocular pressure test,2,492,490,10,8,421335,172.1734693877551
prazosin,Klebsiella Infections,1,492,491,32,31,421312,26.84591395112016
prazosin,Labile blood pressure,2,492,490,86,84,421259,20.01656383483626
prazosin,Large prostate,2,492,490,172,170,421173,10.006241101091598
prazosin,Leukocytoclastic vasculitis,1,492,491,122,121,421222,7.040048746285599
prazosin,Ligament injury,1,492,491,104,103,421240,8.258871220429265
prazosin,Limb asymmetry,1,492,491,181,180,421163,4.744562343171563
prazosin,Lipids outside reference range,4,492,488,202,198,421145,17.108951468917386
prazosin,Liver diseases,1,492,491,55,54,421289,15.618589150157378
prazosin,Low density lipoprotein abnormal,1,492,491,249,248,421095,3.448302374467319
prazosin,Lung Neoplasms,1,492,491,7,6,421337,122.73145184754145
prazosin,Mental disorder due to a general medical condition,5,492,487,338,333,421010,12.803208874524623
prazosin,Metastatic Prostate Carcinoma,1,492,491,37,36,421307,23.21781251720152
prazosin,Metastatic malignant neoplasm to adrenal gland,1,492,491,10,9,421334,85.91140529531569
prazosin,Microangiopathic hemolytic anemia,6,492,486,703,697,420646,7.395676378132519
prazosin,Multiple Trauma,2,492,490,148,146,421197,11.62953667953668
prazosin,Myocardial oedema,2,492,490,130,128,421215,13.240345368916799
prazosin,Myocarditis,1,492,491,20,19,421324,42.95468431771894
prazosin,Neurological decompensation,1,492,491,6,5,421338,143.18703326544465
prazosin,Neuromuscular Diseases,1,492,491,9,8,421335,95.45734329033716
prazosin,Neutrophil count decreased,5,492,487,567,562,420781,7.628101358423055
prazosin,Night sweats,1,492,491,10,9,421334,85.91140529531569
prazosin,Obsessive-Compulsive Disorder,1,492,491,86,85,421258,9.987898451191208
prazosin,Oral mucosal blisters,1,492,491,15,14,421329,57.273591310251184
prazosin,Pain in esophagus (finding),3,492,489,595,592,420751,4.343352064752281
prazosin,Pancytopenia,1,492,491,233,232,421111,3.6852355270403745
prazosin,Performance status decreased,1,492,491,25,24,421319,34.36334012219959
prazosin,Polydactyly,2,492,490,343,341,421002,5.0156720414113165
prazosin,Postural dizziness,1,492,491,36,35,421308,23.862808327675946
prazosin,Premature Birth,1,492,491,61,60,421283,14.082134152449001
prazosin,Preterm premature rupture of membranes (disorder),1,492,491,163,162,421181,5.268726650256769
prazosin,Prolonged bleeding time,1,492,491,58,57,421286,14.810625746190041
prazosin,Pruritus Ani,2,492,490,30,28,421315,57.38843537414966
prazosin,Pulmonary arterial pressure increased,2,492,490,120,118,421225,14.344047619047618
prazosin,Pulpitis,1,492,491,15,14,421329,57.273591310251184
prazosin,Radiation exposure during pregnancy,1,492,491,64,63,421280,13.421938645621182
prazosin,Radius Fractures,1,492,491,31,30,421313,27.71197687405558
prazosin,Reduced visual acuity,1,492,491,161,160,421183,5.334201970879558
prazosin,Reflux gastritis,1,492,491,25,24,421319,34.36334012219959
prazosin,Renal tubular acidosis,1,492,491,23,22,421321,37.35163375542371
prazosin,Respiration Disorders,2,492,490,363,361,420982,4.739101591049643
prazosin,Retrograde ejaculation,1,492,491,27,26,421317,31.817756656860528
prazosin,Rhabdomyolysis,1,492,491,210,209,421134,4.089079623702842
prazosin,Right bundle branch block,1,492,491,25,24,421319,34.36334012219959
prazosin,Salpingitis,1,492,491,76,75,421268,11.302363597384499
prazosin,Second Primary Cancers,2,492,490,32,30,421313,53.801403061224484
prazosin,Shock,3,492,489,367,364,420979,7.045485699002022
prazosin,Shunt stenosis,1,492,491,7,6,421337,122.73145184754145
prazosin,Skin Basal Cell Carcinoma,1,492,491,107,106,421237,8.027256980794487
prazosin,Skin tightness,9,492,483,174,165,421178,45.155386592418076
prazosin,Sleep disorder due to a general medical condition,2,492,490,431,429,420914,3.99075713812207
prazosin,Spinal Diseases,1,492,491,53,52,421291,16.208046727894555
prazosin,Spinal stenosis in cervical region,1,492,491,11,10,421333,78.1010923902981
prazosin,Stage IV Renal Cell Cancer,1,492,491,5,4,421339,171.82484725050918
prazosin,Standard chest X-ray abnormal,1,492,491,137,136,421207,6.269017497435593
prazosin,Staphylococcal Infections,11,492,481,2882,2871,418472,3.3244433511609084
prazosin,Status Asthmaticus,1,492,491,102,101,421242,8.420849806317639
prazosin,Ubiquinone decreased,1,492,491,10,9,421334,85.91140529531569
prazosin,Unresponsive to stimuli,1,492,491,72,71,421272,11.930385833899072
prazosin,Upper respiratory tract congestion,1,492,491,117,116,421227,7.340992567061814
prazosin,Uterine Neoplasms,1,492,491,6,5,421338,143.18703326544465
prazosin,Victim of sexual abuse,1,492,491,284,283,421060,3.023084535727604
prazosin,Wound inflammation,1,492,491,13,12,421331,66.08522638257874
prazosin,bite injury,5,492,487,1079,1074,420269,4.003592953396273
propranolol,APACHE II score increased,2,7420,7418,18,16,414399,6.318219945477966
propranolol,Abnormal blood pressure,5,7420,7415,29,24,414391,9.80784523449671
propranolol,Abnormal breath sounds,1,7420,7419,12,11,414404,4.738093633463629
propranolol,Abnormal ventricular axis,3,7420,7417,27,24,414391,6.318936976615284
propranolol,Abnormal weight loss (finding),10,7420,7410,172,162,414253,3.308406301980354
propranolol,Absolute neutrophil count abnormal,2,7420,7418,14,12,414403,8.123502676886337
propranolol,Accidental overdose,2,7420,7418,24,22,414393,4.738597555495641
propranolol,Activation syndrome,6,7420,7414,80,74,414341,4.266472214728892
propranolol,Acute left ventricular failure,2,7420,7418,10,8,414407,11.373011593421408
propranolol,Addisonian crisis,5,7420,7415,37,32,414383,7.6870842521550555
propranolol,Adenocarcinoma,5,7420,7415,19,14,414401,14.970223941512579
propranolol,Adrenal insufficiency neonatal,1,7420,7419,11,10,414405,5.168841671874426
propranolol,Adverse reactions,37,7420,7383,284,247,414168,7.43876158208904
propranolol,Agoraphobia,1,7420,7419,15,14,414401,3.7904479489598772
propranolol,Agraphia,7,7420,7413,7,0,414415,56.90381761769864
propranolol,Alcohol abuse,1,7420,7419,17,16,414399,3.344497038605171
propranolol,Alcohol poisoning,6,7420,7414,94,88,414327,3.6309196517227322
propranolol,Amputation,2,7420,7418,24,22,414393,4.738597555495641
propranolol,Amputation of hand (procedure),1,7420,7419,6,5,414410,9.476322055982388
propranolol,Anaemia of malignant disease,3,7420,7417,9,6,414409,18.95761988225248
propranolol,Anal inflammation,1,7420,7419,5,4,414411,11.37161342498989
propranolol,Anemia of chronic disease,21,7420,7399,189,168,414247,6.3318766800318365
propranolol,Animal scratch,3,7420,7417,46,43,414372,3.708774202624992
propranolol,Anti-DNA antibodies positive,1,7420,7419,5,4,414411,11.37161342498989
propranolol,Aortic Aneurysm,12,7420,7408,226,214,414201,3.0219112559490817
propranolol,Aortic Injury,6,7420,7414,18,12,414403,18.9648862512364
propranolol,Aortic valve sclerosis,3,7420,7417,53,50,414365,3.218882679006159
propranolol,Appendicitis purulent perforated,1,7420,7419,11,10,414405,5.168841671874426
propranolol,Application of cast,3,7420,7417,9,6,414409,18.95761988225248
propranolol,Arterial Occlusive Diseases,4,7420,7416,67,63,414352,3.3953855318874884
propranolol,Atrial standstill,1,7420,7419,6,5,414410,9.476322055982388
propranolol,Autoimmune myocarditis,2,7420,7418,12,10,414405,9.477464725442616
propranolol,BK virus infection,3,7420,7417,29,26,414389,5.883120324696759
propranolol,Bacterial Endocarditis,10,7420,7410,175,165,414250,3.2516676306149987
propranolol,Bacteriuria,4,7420,7416,23,19,414396,9.89193752638244
propranolol,Benign Neoplasm,1,7420,7419,10,9,414406,5.685739317967381
propranolol,Benign neoplasm of skin,2,7420,7418,6,4,414411,18.955199065336565
propranolol,Benign neoplasm of thyroid gland,2,7420,7418,5,3,414412,22.74629280129415
propranolol,"Bladder cancer stage I, with cancer in situ",5,7420,7415,7,2,414413,40.63462094210578
propranolol,Bleeding esophageal varices,1,7420,7419,8,7,414408,7.107207844723008
propranolol,Bleeding of soft tissue,1,7420,7419,7,6,414409,8.122542506691314
propranolol,Bleeding ulcer,2,7420,7418,30,28,414387,3.790824121506246
propranolol,Blood albumin abnormal,1,7420,7419,15,14,414401,3.7904479489598772
propranolol,Blood bicarbonate abnormal,10,7420,7410,135,125,414290,4.215524566401759
propranolol,Blood calcitonin increased,7,7420,7413,15,8,414407,26.554611268492287
propranolol,Blood cholinesterase decreased,7,7420,7413,39,32,414383,10.212730926611947
propranolol,Blood creatine phosphokinase abnormal,2,7420,7418,21,19,414396,5.41557857977378
propranolol,Blood pressure orthostatic increased,4,7420,7416,14,10,414405,16.251386962552008
propranolol,Blood urate above reference range,1,7420,7419,9,8,414407,6.317503107636549
propranolol,Bone pain,13,7420,7407,154,141,414274,4.805784805177272
propranolol,Brain stem hemorrhage,3,7420,7417,43,40,414375,3.9675541104502225
propranolol,Breast Diseases,7,7420,7413,97,90,414325,4.105584922558726
propranolol,Brucellosis,11,7420,7409,69,58,414357,9.07518666095485
propranolol,Bulla,1,7420,7419,12,11,414404,4.738093633463629
propranolol,Burning Mouth Syndrome,3,7420,7417,25,22,414393,6.82448429284077
propranolol,C-reactive protein above reference range,3,7420,7417,46,43,414372,3.708774202624992
propranolol,CD30 expression,1,7420,7419,18,17,414398,3.15868415929071
propranolol,Cardiac Flutter,3,7420,7417,54,51,414364,3.159266250205983
propranolol,Cardiac neoplasm unspecified,2,7420,7418,15,13,414402,7.581917857463826
propranolol,Cardiac ventricular thrombosis,1,7420,7419,6,5,414410,9.476322055982388
propranolol,Cardiotoxicity,9,7420,7411,10,1,414414,51.226892457158286
propranolol,Carotid Artery Thrombosis,1,7420,7419,9,8,414407,6.317503107636549
propranolol,Cataplexy,1,7420,7419,17,16,414399,3.344497038605171
propranolol,Cataract due to diabetes mellitus,2,7420,7418,8,6,414409,14.216331895389592
propranolol,Central cyanosis,1,7420,7419,17,16,414399,3.344497038605171
propranolol,Central nervous system haemorrhage,1,7420,7419,15,14,414401,3.7904479489598772
propranolol,Cerebellar Neoplasms,1,7420,7419,16,15,414400,3.5535365278339395
propranolol,Cerebral cyst,3,7420,7417,52,49,414366,3.280792047375572
propranolol,Cerebral disorder,2,7420,7418,9,7,414408,12.636709505407266
propranolol,Cerebrovascular Insufficiency,1,7420,7419,16,15,414400,3.5535365278339395
propranolol,Cheilitis,7,7420,7413,46,39,414376,8.658476002791806
propranolol,Chickenpox,5,7420,7415,27,22,414393,10.534402237706349
propranolol,Choking sensation,3,7420,7417,14,11,414404,12.186896897089696
propranolol,Cholangitis,1,7420,7419,17,16,414399,3.344497038605171
propranolol,Chondroplasty,39,7420,7381,87,48,414367,25.614340641628786
propranolol,Chronic kidney disease mineral and bone disorder,5,7420,7415,6,1,414414,47.40717015059564
propranolol,Chronic throat clearing,10,7420,7410,33,23,414392,17.249499038972726
propranolol,Circumstance or information capable of leading to medication error,1,7420,7419,12,11,414404,4.738093633463629
propranolol,Completed Suicide,3,7420,7417,37,34,414381,4.611006854231878
propranolol,Complications of Diabetes Mellitus,1,7420,7419,15,14,414401,3.7904479489598772
propranolol,Compression fracture of vertebral column,1,7420,7419,11,10,414405,5.168841671874426
propranolol,Congenital hearing disorder,1,7420,7419,12,11,414404,4.738093633463629
propranolol,Contraindication to vaccination,3,7420,7417,10,7,414408,17.061817446406902
propranolol,Coronary artery restenosis prophylaxis,1,7420,7419,14,13,414402,4.061203858818092
propranolol,Creatinine renal clearance increased,1,7420,7419,5,4,414411,11.37161342498989
propranolol,Crystal nephropathy,5,7420,7415,21,16,414399,13.544424108146293
propranolol,Cushingoid,3,7420,7417,45,42,414373,3.7912003954878433
propranolol,Cystic Fibrosis,3,7420,7417,11,8,414407,15.510706362533245
propranolol,Day Dreams,1,7420,7419,6,5,414410,9.476322055982388
propranolol,Decreased forced expiratory volume,7,7420,7413,33,26,414389,12.069762783643805
propranolol,Decreased urine output,2,7420,7418,28,26,414389,4.061616531217502
propranolol,Delayed Hypersensitivity,1,7420,7419,10,9,414406,5.685739317967381
propranolol,"Dementia, Vascular",1,7420,7419,9,8,414407,6.317503107636549
propranolol,Dental Plaque,3,7420,7417,42,39,414376,4.062029314894355
propranolol,Dental Prosthesis Implantation,1,7420,7419,10,9,414406,5.685739317967381
propranolol,Dermatomycoses,2,7420,7418,31,29,414386,3.668530775185034
propranolol,Device extrusion,1,7420,7419,16,15,414400,3.5535365278339395
propranolol,Device related infection,1,7420,7419,15,14,414401,3.7904479489598772
propranolol,Diabetic ketoacidotic hyperglycaemic coma,1,7420,7419,14,13,414402,4.061203858818092
propranolol,Differential white blood cell count abnormal,3,7420,7417,20,17,414398,8.530706485101792
propranolol,Disorder of anterior chamber of eye,32,7420,7388,179,147,414268,10.203010770901326
propranolol,Disorder of middle ear,1,7420,7419,18,17,414398,3.15868415929071
propranolol,"Disruptive, Impulse Control, and Conduct Disorders",3,7420,7417,56,53,414362,3.0464208671199366
propranolol,Drug Tolerance,6,7420,7414,11,5,414410,31.03396522549476
propranolol,Drug administered at inappropriate site,5,7420,7415,32,27,414388,8.888296527309507
propranolol,Drug effect incomplete,7,7420,7413,34,27,414388,11.714741987446537
propranolol,Drug level increased,6,7420,7414,58,52,414363,5.885096229872654
propranolol,Duodenal Obstruction,1,7420,7419,14,13,414402,4.061203858818092
propranolol,Dysphemia,1,7420,7419,10,9,414406,5.685739317967381
propranolol,Ectropion,1,7420,7419,9,8,414407,6.317503107636549
propranolol,Emotional disorder,5,7420,7415,91,86,414329,3.125117633546494
propranolol,Empyema,1,7420,7419,10,9,414406,5.685739317967381
propranolol,Encephalomyelitis,3,7420,7417,8,5,414410,21.327372927059457
propranolol,Eosinophilic Pneumonia,2,7420,7418,15,13,414402,7.581917857463826
propranolol,Epididymal Cyst,7,7420,7413,22,15,414400,18.105116318997336
propranolol,Epigastric discomfort,2,7420,7418,18,16,414399,6.318219945477966
propranolol,Epiphyseal fracture of bone,4,7420,7416,51,47,414368,4.460773737758318
propranolol,Erythema Multiforme,2,7420,7418,25,23,414392,4.549042868697763
propranolol,Erythema at injection site,10,7420,7410,67,57,414358,8.495337079783269
propranolol,Erythrocyte sedimentation rate raised,1,7420,7419,6,5,414410,9.476322055982388
propranolol,Eschar,2,7420,7418,25,23,414392,4.549042868697763
propranolol,Escherichia urinary tract infection,3,7420,7417,12,9,414406,14.218113792638533
propranolol,Esophageal Varices,4,7420,7416,13,9,414406,17.50153514231184
propranolol,Excision of benign neoplasm,2,7420,7418,25,23,414392,4.549042868697763
propranolol,Exposure to allergen,2,7420,7418,7,5,414410,16.24727496822401
propranolol,Extraction of wisdom tooth,4,7420,7416,13,9,414406,17.50153514231184
propranolol,Eye pain,6,7420,7414,70,64,414351,4.876083856796023
propranolol,Family tension,1,7420,7419,12,11,414404,4.738093633463629
propranolol,Female infertility,1,7420,7419,5,4,414411,11.37161342498989
propranolol,Focal dyscognitive seizures,46,7420,7374,599,553,413862,4.3868557712814
propranolol,Folic Acid Deficiency,2,7420,7418,15,13,414402,7.581917857463826
propranolol,Foreign-Body Reaction,2,7420,7418,11,9,414406,10.33907693816025
propranolol,Fracture of clavicle,2,7420,7418,9,7,414408,12.636709505407266
propranolol,Frontotemporal dementia,1,7420,7419,10,9,414406,5.685739317967381
propranolol,Gall Bladder Diseases,4,7420,7416,43,39,414376,5.290785479541406
propranolol,Gallstone ileus,8,7420,7412,88,80,414335,5.172778786243438
propranolol,Gastroenteritis norovirus,11,7420,7409,202,191,414224,3.0989624606947133
propranolol,Gastrointestinal Stromal Tumors,2,7420,7418,15,13,414402,7.581917857463826
propranolol,Gastrointestinal tract mucosal discoloration,2,7420,7418,10,8,414407,11.373011593421408
propranolol,Gaze palsy,2,7420,7418,29,27,414388,3.92155149171168
propranolol,Glossalgia,1,7420,7419,6,5,414410,9.476322055982388
propranolol,Guilt,1,7420,7419,5,4,414411,11.37161342498989
propranolol,Gum Infection,2,7420,7418,37,35,414380,3.0735901714602174
propranolol,Heart Injuries,43,7420,7377,212,169,414246,11.592500019182518
propranolol,Heart valve disease,2,7420,7418,9,7,414408,12.636709505407266
propranolol,Hematocrit decreased,2,7420,7418,5,3,414412,22.74629280129415
propranolol,Hemiparaesthesia,1,7420,7419,10,9,414406,5.685739317967381
propranolol,Hemiparesis,5,7420,7415,59,54,414361,4.820462415854258
propranolol,Hemorrhagic proctitis,1,7420,7419,7,6,414409,8.122542506691314
propranolol,Hepatectomy,1,7420,7419,7,6,414409,8.122542506691314
propranolol,"Hepatitis C, Chronic",3,7420,7417,16,13,414402,10.663484225428071
propranolol,Hepatorenal Syndrome,1,7420,7419,12,11,414404,4.738093633463629
propranolol,Hepatotoxicity,13,7420,7407,186,173,414242,3.978681166173817
propranolol,Hernia pain,1,7420,7419,13,12,414403,4.37361452403911
propranolol,Heterophoria,11,7420,7409,134,123,414292,4.672323696673872
propranolol,Hip Fractures,7,7420,7413,66,59,414356,6.0344092482902685
propranolol,Histrionic Personality Disorder,2,7420,7418,21,19,414396,5.41557857977378
propranolol,Hospitalization,3,7420,7417,55,52,414363,3.101817691543996
propranolol,"Hygroma, Subdural",1,7420,7419,6,5,414410,9.476322055982388
propranolol,Hyperammonemic encephalopathy,3,7420,7417,15,12,414403,11.374410138870163
propranolol,Hyperopia,1,7420,7419,5,4,414411,11.37161342498989
propranolol,Hyperphagia,1,7420,7419,11,10,414405,5.168841671874426
propranolol,Hypertensive disease,9,7420,7411,164,155,414260,3.1224506419264704
propranolol,Hypertensive heart disease,17,7420,7403,122,105,414310,7.93776670069511
propranolol,Hypertriglyceridemia,3,7420,7417,18,15,414400,9.478607703024583
propranolol,Hyperventilation,2,7420,7418,30,28,414387,3.790824121506246
propranolol,Hypoglycemic coma,1,7420,7419,16,15,414400,3.5535365278339395
propranolol,Hypoglycemic seizures,3,7420,7417,5,2,414413,34.12403936901712
propranolol,Hypopigmentation disorder,1,7420,7419,6,5,414410,9.476322055982388
propranolol,Hypoplasia of aorta,7,7420,7413,16,9,414406,24.894889046270066
propranolol,Hypoxic ischaemic encephalopathy neonatal,3,7420,7417,17,14,414401,10.036196654743872
propranolol,Ileal Fistula,2,7420,7418,6,4,414411,18.955199065336565
propranolol,Immunosuppressant drug level increased,1,7420,7419,16,15,414400,3.5535365278339395
propranolol,Incarcerated inguinal hernia,2,7420,7418,10,8,414407,11.373011593421408
propranolol,Incorrect drug administration duration,13,7420,7407,236,223,414192,3.135368398651756
propranolol,Incorrect product administration duration,6,7420,7414,94,88,414327,3.6309196517227322
propranolol,Increase in blood pressure,4,7420,7416,26,22,414393,8.750497883993031
propranolol,Increased anteroposterior chest diameter,3,7420,7417,45,42,414373,3.7912003954878433
propranolol,Increased blood viscosity (finding),3,7420,7417,42,39,414376,4.062029314894355
propranolol,Increased bone formation,4,7420,7416,32,28,414387,7.109678398058253
propranolol,Infected neoplasm,1,7420,7419,7,6,414409,8.122542506691314
propranolol,Inflammatory corneal ulcer,5,7420,7415,59,54,414361,4.820462415854258
propranolol,Injection site anesthesia,2,7420,7418,25,23,414392,4.549042868697763
propranolol,Injection site haematoma,1,7420,7419,17,16,414399,3.344497038605171
propranolol,Injury of ear,1,7420,7419,5,4,414411,11.37161342498989
propranolol,Instillation site pain,1,7420,7419,18,17,414398,3.15868415929071
propranolol,Intervertebral disc annular tear,4,7420,7416,12,8,414407,18.96004135203164
propranolol,Intestinal infarction,1,7420,7419,13,12,414403,4.37361452403911
propranolol,Invasive Lobular Breast Carcinoma,1,7420,7419,17,16,414399,3.344497038605171
propranolol,Investigation noncompliance,1,7420,7419,6,5,414410,9.476322055982388
propranolol,Ketonuria,1,7420,7419,5,4,414411,11.37161342498989
propranolol,Klebsiella test positive,2,7420,7418,32,30,414385,3.5538807630088973
propranolol,Lacrimation decreased,1,7420,7419,12,11,414404,4.738093633463629
propranolol,Large prostate,11,7420,7409,172,161,414254,3.639738124907796
propranolol,Larynx pain,4,7420,7416,26,22,414393,8.750497883993031
propranolol,Left Ventricular Hypertrophy,2,7420,7418,27,25,414390,4.2120567588348665
propranolol,Leukocytoclastic vasculitis,7,7420,7413,122,115,414300,3.264083035341104
propranolol,Leukostasis,1,7420,7419,6,5,414410,9.476322055982388
propranolol,Libido disorder,1,7420,7419,17,16,414399,3.344497038605171
propranolol,Ligamentitis,3,7420,7417,22,19,414396,7.755150943164964
propranolol,"Liver Failure, Acute",3,7420,7417,18,15,414400,9.478607703024583
propranolol,Liver carcinoma,4,7420,7416,68,64,414351,3.3454454597372933
propranolol,Liver enzymes abnormal,1,7420,7419,13,12,414403,4.37361452403911
propranolol,Localised intraabdominal fluid collection,3,7420,7417,48,45,414370,3.5542250910071456
propranolol,Lower respiratory tract infection,1,7420,7419,16,15,414400,3.5535365278339395
propranolol,"Lupus Erythematosus, Systemic",1,7420,7419,6,5,414410,9.476322055982388
propranolol,"Lymphoma, Non-Hodgkin",2,7420,7418,31,29,414386,3.668530775185034
propranolol,Lymphopenia,4,7420,7416,63,59,414356,3.6109998116470607
propranolol,Manufacturing materials contamination,1,7420,7419,5,4,414411,11.37161342498989
propranolol,Marital conflict,4,7420,7416,73,69,414346,3.116268416308315
propranolol,Mass of pancreas,3,7420,7417,44,41,414374,3.8773732334808244
propranolol,Maternal drugs affecting foetus,10,7420,7410,92,82,414333,6.186454849498328
propranolol,Maternal exposure timing unspecified,2,7420,7418,18,16,414399,6.318219945477966
propranolol,Melena,7,7420,7413,86,79,414336,4.630838658673167
propranolol,Meningeal disorder,16,7420,7404,43,27,414388,21.197441986104305
propranolol,Menorrhagia,4,7420,7416,26,22,414393,8.750497883993031
propranolol,Menstruation Disturbances,1,7420,7419,10,9,414406,5.685739317967381
propranolol,Mesenteric Venous Thrombosis,2,7420,7418,12,10,414405,9.477464725442616
propranolol,Metastatic malignant neoplasm to bone,2,7420,7418,25,23,414392,4.549042868697763
propranolol,Migration of implanted drug,2,7420,7418,8,6,414409,14.216331895389592
propranolol,Molluscum Contagiosum,6,7420,7414,15,9,414406,22.75802535743189
propranolol,Monocyte count outside reference range,1,7420,7419,5,4,414411,11.37161342498989
propranolol,Monocyte percentage decreased,1,7420,7419,17,16,414399,3.344497038605171
propranolol,Monoparesis,6,7420,7414,41,35,414380,8.32559363629784
propranolol,Mood Disorders,1,7420,7419,18,17,414398,3.15868415929071
propranolol,Morose,3,7420,7417,17,14,414401,10.036196654743872
propranolol,Muscle Rigidity,3,7420,7417,49,46,414369,3.4816816304518303
propranolol,Muscle twitch,2,7420,7418,28,26,414389,4.061616531217502
propranolol,Musculoskeletal discomfort,6,7420,7414,112,106,414309,3.0472489305946278
propranolol,Myelomalacia,8,7420,7412,47,39,414376,9.686144377719856
propranolol,Myoclonus,2,7420,7418,20,18,414397,5.686370989485037
propranolol,NIH stroke scale score increased,4,7420,7416,46,42,414373,4.945699076028329
propranolol,Nail discomfort,1,7420,7419,8,7,414408,7.107207844723008
propranolol,Nasal odour,2,7420,7418,6,4,414411,18.955199065336565
propranolol,Nasopharyngitis,2,7420,7418,19,17,414398,5.985667863376425
propranolol,Necrotising colitis,4,7420,7416,20,16,414399,11.375809061488674
propranolol,Needle fatigue,16,7420,7404,17,1,414414,53.6203641910573
propranolol,Needle issue,4,7420,7416,59,55,414360,3.8558499259503045
propranolol,Neoplasm Metastasis,3,7420,7417,15,12,414403,11.374410138870163
propranolol,Nephritis,1,7420,7419,6,5,414410,9.476322055982388
propranolol,Nerve Degeneration,1,7420,7419,9,8,414407,6.317503107636549
propranolol,Neutropenic infection,1,7420,7419,18,17,414398,3.15868415929071
propranolol,Neutropenic sepsis,6,7420,7414,95,89,414326,3.5926909261283773
propranolol,Nodule,6,7420,7414,95,89,414326,3.5926909261283773
propranolol,Non-cardiac chest pain,4,7420,7416,44,40,414375,5.170528096498971
propranolol,Obstruction,1,7420,7419,10,9,414406,5.685739317967381
propranolol,Obstruction of esophagus,6,7420,7414,83,77,414338,4.112233124567328
propranolol,Ocular sarcoidosis,1,7420,7419,6,5,414410,9.476322055982388
propranolol,Oedema due to hepatic disease,8,7420,7412,63,55,414360,7.225897086663411
propranolol,Oliguria,5,7420,7415,25,20,414395,11.377208361429537
propranolol,Operation on joint,1,7420,7419,11,10,414405,5.168841671874426
propranolol,Operation on urinary bladder,1,7420,7419,5,4,414411,11.37161342498989
propranolol,Operative procedure on spine,1,7420,7419,17,16,414399,3.344497038605171
propranolol,Oral paresthesia,5,7420,7415,73,68,414347,3.89586085221552
propranolol,Oropharyngeal discomfort,3,7420,7417,48,45,414370,3.5542250910071456
propranolol,Palatal edema,7,7420,7413,68,61,414354,5.856898850191635
propranolol,Pallor of skin,2,7420,7418,26,24,414391,4.3740693116535665
propranolol,Palmar-plantar erythrodysesthesia syndrome,3,7420,7417,46,43,414372,3.708774202624992
propranolol,Pancreatic Ductal Adenocarcinoma,2,7420,7418,21,19,414396,5.41557857977378
propranolol,Pancreatic Infection,8,7420,7412,143,135,414280,3.1828333566056175
propranolol,Pancreatic carcinoma,8,7420,7412,22,14,414401,20.69435313741844
propranolol,Paraganglioma,1,7420,7419,5,4,414411,11.37161342498989
propranolol,Paralysed,2,7420,7418,35,33,414382,3.2492393020837342
propranolol,Parathyroid Diseases,3,7420,7417,52,49,414366,3.280792047375572
propranolol,Paresis,5,7420,7415,15,10,414405,18.96246347493819
propranolol,Pelvic Inflammatory Disease,4,7420,7416,19,15,414400,11.974564242321012
propranolol,Penile erythema,5,7420,7415,5,0,414415,56.888739042481454
propranolol,Peptic Ulcer,9,7420,7411,105,96,414319,4.877652909767335
propranolol,Perforation of rectum,1,7420,7419,12,11,414404,4.738093633463629
propranolol,Perforation of stomach,35,7420,7385,132,97,414318,15.140851644406148
propranolol,Peripheral Nervous System Diseases,22,7420,7398,356,334,414081,3.520742775909675
propranolol,Peripheral Vascular Diseases,2,7420,7418,28,26,414389,4.061616531217502
propranolol,Personality Disorders,2,7420,7418,35,33,414382,3.2492393020837342
propranolol,Pharyngeal Hemorrhage,1,7420,7419,5,4,414411,11.37161342498989
propranolol,Pharyngeal lesion,1,7420,7419,9,8,414407,6.317503107636549
propranolol,Pharyngeal necrosis,3,7420,7417,6,3,414412,28.436632061480385
propranolol,Pigmentation Disorders,2,7420,7418,37,35,414380,3.0735901714602174
propranolol,Placental Insufficiency,1,7420,7419,15,14,414401,3.7904479489598772
propranolol,Platelet aggregation inhibition,1,7420,7419,14,13,414402,4.061203858818092
propranolol,Pleural infection bacterial,1,7420,7419,8,7,414408,7.107207844723008
propranolol,Pneumatosis Cystoides Intestinalis,4,7420,7416,7,3,414412,32.503313299429806
propranolol,Pneumococcal bacteraemia,1,7420,7419,8,7,414408,7.107207844723008
propranolol,Polycythemia,2,7420,7418,24,22,414393,4.738597555495641
propranolol,Polyp of vagina,2,7420,7418,15,13,414402,7.581917857463826
propranolol,Poor quality drug administered,1,7420,7419,18,17,414398,3.15868415929071
propranolol,Post procedural complication,5,7420,7415,53,48,414367,5.3662514790264515
propranolol,Post-Traumatic Headache,6,7420,7414,12,6,414409,28.447734016725114
propranolol,Postoperative abscess,5,7420,7415,11,6,414409,25.858149941764236
propranolol,Postoperative adhesion,3,7420,7417,55,52,414363,3.101817691543996
propranolol,Premature ventricular contractions,1,7420,7419,7,6,414409,8.122542506691314
propranolol,Prescribed underdose,1,7420,7419,5,4,414411,11.37161342498989
propranolol,Preterm premature rupture of membranes (disorder),11,7420,7409,163,152,414263,3.8407872368790406
propranolol,Product colour issue,1,7420,7419,17,16,414399,3.344497038605171
propranolol,Product size issue,1,7420,7419,12,11,414404,4.738093633463629
propranolol,Projectile vomiting,3,7420,7417,23,20,414395,7.417952881453301
propranolol,Prostate cancer stage I,1,7420,7419,7,6,414409,8.122542506691314
propranolol,Pruritus allergic,1,7420,7419,6,5,414410,9.476322055982388
propranolol,Psoriasiform eczema,1,7420,7419,12,11,414404,4.738093633463629
propranolol,Psychomotor skills impaired,2,7420,7418,11,9,414406,10.33907693816025
propranolol,Pulmonary sepsis,1,7420,7419,6,5,414410,9.476322055982388
propranolol,Pustular acne,1,7420,7419,6,5,414410,9.476322055982388
propranolol,Pyoderma Gangrenosum,1,7420,7419,13,12,414403,4.37361452403911
propranolol,Raynaud Phenomenon,1,7420,7419,18,17,414398,3.15868415929071
propranolol,Reaction to drug excipients,4,7420,7416,36,32,414383,6.319654201126692
propranolol,Renal cancer metastatic,2,7420,7418,29,27,414388,3.92155149171168
propranolol,Renal function tests outside reference range,3,7420,7417,33,30,414385,5.169965803375538
propranolol,Renal venous congestion,1,7420,7419,16,15,414400,3.5535365278339395
propranolol,Repair of hip,11,7420,7409,184,173,414242,3.4022670723620507
propranolol,Repeat Surgery,3,7420,7417,13,10,414405,13.124381618112238
propranolol,Respiratory Depression,1,7420,7419,17,16,414399,3.344497038605171
propranolol,Respiratory tract inflammation,1,7420,7419,7,6,414409,8.122542506691314
propranolol,Retroperitoneal lymphadenopathy,1,7420,7419,18,17,414398,3.15868415929071
propranolol,Rocky Mountain Spotted Fever,1,7420,7419,17,16,414399,3.344497038605171
propranolol,Salt craving,13,7420,7407,130,117,414298,5.693330633184825
propranolol,Sarcopenia,2,7420,7418,16,14,414401,7.10803114046913
propranolol,Seasonal rhinitis,8,7420,7412,136,128,414287,3.346711215516968
propranolol,Sensory neuropathy,4,7420,7416,35,31,414384,6.5002311604253356
propranolol,Sinus rhythm,1,7420,7419,6,5,414410,9.476322055982388
propranolol,Sjogren-Larsson Syndrome,6,7420,7414,79,73,414342,4.320488436177878
propranolol,Skeletal injury,4,7420,7416,51,47,414368,4.460773737758318
propranolol,Skin lesion,2,7420,7418,28,26,414389,4.061616531217502
propranolol,Snoring,1,7420,7419,15,14,414401,3.7904479489598772
propranolol,Soft Tissue Injuries,3,7420,7417,7,4,414411,24.37419827038271
propranolol,Somnambulism,3,7420,7417,16,13,414402,10.663484225428071
propranolol,Splenomegaly,6,7420,7414,90,84,414331,3.7923298264544556
propranolol,Spontaneous pneumothorax,1,7420,7419,6,5,414410,9.476322055982388
propranolol,Squamous cell carcinoma of the head and neck,1,7420,7419,15,14,414401,3.7904479489598772
propranolol,Stenosis of intestine,1,7420,7419,6,5,414410,9.476322055982388
propranolol,Stress,9,7420,7411,151,142,414273,3.3913754478084748
propranolol,Substance-induced psychotic disorder,1,7420,7419,12,11,414404,4.738093633463629
propranolol,Sudden death,10,7420,7410,60,50,414365,9.486617183985604
propranolol,Swallowing painful,3,7420,7417,44,41,414374,3.8773732334808244
propranolol,Sweat discolouration,1,7420,7419,5,4,414411,11.37161342498989
propranolol,Swelling,10,7420,7410,185,175,414240,3.07582886530255
propranolol,Swelling of structure of eye,1,7420,7419,6,5,414410,9.476322055982388
propranolol,Syphilis,3,7420,7417,13,10,414405,13.124381618112238
propranolol,Thalamic hemorrhage,4,7420,7416,8,4,414411,28.440331715210355
propranolol,Therapy change,2,7420,7418,28,26,414389,4.061616531217502
propranolol,Thrombocytosis,1,7420,7419,5,4,414411,11.37161342498989
propranolol,Tongue erythema,1,7420,7419,5,4,414411,11.37161342498989
propranolol,Tooth Avulsion,2,7420,7418,37,35,414380,3.0735901714602174
propranolol,Toxicity to various agents,1,7420,7419,5,4,414411,11.37161342498989
propranolol,Tumor Progression,4,7420,7416,35,31,414384,6.5002311604253356
propranolol,Ultrasound Doppler abnormal,1,7420,7419,15,14,414401,3.7904479489598772
propranolol,Umbilical granuloma,2,7420,7418,6,4,414411,18.955199065336565
propranolol,Umbilical hemorrhage,5,7420,7415,91,86,414329,3.125117633546494
propranolol,Unilateral deafness,3,7420,7417,23,20,414395,7.417952881453301
propranolol,Unmasking of previously unidentified disease,7,7420,7413,7,0,414415,56.90381761769864
propranolol,Upper respiratory tract irritation,2,7420,7418,5,3,414412,22.74629280129415
propranolol,Ureteral necrosis,1,7420,7419,16,15,414400,3.5535365278339395
propranolol,Urgency of micturition,3,7420,7417,29,26,414389,5.883120324696759
propranolol,Urinary Bladder Fistula,14,7420,7406,139,125,414290,5.734941725258734
propranolol,Urinary bladder stone (disorder),12,7420,7408,198,186,414229,3.449481314222135
propranolol,Urinary tract infection pseudomonal,1,7420,7419,11,10,414405,5.168841671874426
propranolol,Uveitis,27,7420,7393,92,65,414350,16.741837166767628
propranolol,Vaginal Hemorrhage,3,7420,7417,51,48,414367,3.345129234112413
propranolol,Varicella virus test positive,3,7420,7417,7,4,414411,24.37419827038271
propranolol,Vascular Diseases,1,7420,7419,7,6,414409,8.122542506691314
propranolol,Vascular insufficiency of intestine,5,7420,7415,27,22,414393,10.534402237706349
propranolol,Vascular pain,1,7420,7419,11,10,414405,5.168841671874426
propranolol,Vascular stenosis,1,7420,7419,18,17,414398,3.15868415929071
propranolol,Vascular wall hypertrophy,5,7420,7415,76,71,414344,3.7420502537530607
propranolol,Vesicular eczema of hands and/or feet,3,7420,7417,24,21,414394,7.108854658217608
propranolol,Vestibular Diseases,1,7420,7419,15,14,414401,3.7904479489598772
propranolol,Vulvovaginal discomfort,1,7420,7419,17,16,414399,3.344497038605171
propranolol,Vulvovaginal dryness,3,7420,7417,39,36,414379,4.3745242219018685
propranolol,Wheelchair user,2,7420,7418,13,11,414404,8.748408237758468
propranolol,White matter lesion,12,7420,7408,91,79,414336,7.507369520328484
propranolol,Wide QRS complex,4,7420,7416,15,11,414404,15.167925206760158
propranolol,anti-insulin antibody test,5,7420,7415,5,0,414415,56.888739042481454
propranolol,polyps,2,7420,7418,34,32,414383,3.344813093746531
quinapril,Absolute neutrophil count abnormal,1,1331,1330,14,13,420491,22.654189044038667
quinapril,Acrochordon excision,1,1331,1330,47,46,420458,6.747528395456727
quinapril,Activation syndrome,1,1331,1330,80,79,420425,3.9638627819548873
quinapril,"Alzheimer Disease, Late Onset",1,1331,1330,80,79,420425,3.9638627819548873
quinapril,Amputation,1,1331,1330,24,23,420481,13.214630325814536
quinapril,Amputation of toe (procedure),1,1331,1330,54,53,420451,5.872751322751323
quinapril,Animal scratch,2,1331,1329,46,44,420460,13.798835345307031
quinapril,Ankle Fracture,1,1331,1330,73,72,420432,4.344031311154598
quinapril,Ankle deformity,1,1331,1330,67,66,420438,4.733116373022107
quinapril,Antipsychotic drug level increased,3,1331,1328,293,290,420214,3.250097660265636
quinapril,Apathy,3,1331,1328,97,94,420410,9.821869954042976
quinapril,Application site dryness,1,1331,1330,21,20,420484,15.102542069459362
quinapril,Application site irritation,1,1331,1330,87,86,420418,3.644870797683865
quinapril,Arrested labor,1,1331,1330,23,22,420482,13.789212160836875
quinapril,Arterial insufficiency,1,1331,1330,45,44,420460,7.047451963241437
quinapril,Aseptic Meningitis,2,1331,1329,94,92,420412,6.751853097033444
quinapril,Bacterial Endocarditis,2,1331,1329,175,173,420331,3.6260131140492318
quinapril,Bacterial gastroenteritis,1,1331,1330,58,57,420447,5.467682136375421
quinapril,Biliary Tract Surgical Procedures,1,1331,1330,5,4,420500,63.433082706766925
quinapril,Bladder cyst,1,1331,1330,42,41,420463,7.550895094880056
quinapril,Blepharitis,3,1331,1328,58,55,420449,16.427749792272536
quinapril,Blood bicarbonate level above normal,1,1331,1330,44,43,420461,7.207638414217362
quinapril,Blood blister,1,1331,1330,6,5,420499,52.86077694235589
quinapril,Blood calcium increased,4,1331,1327,10,6,420498,127.15146948003014
quinapril,Blood creatine phosphokinase MB increased,1,1331,1330,61,60,420444,5.198742758535684
quinapril,Blood electrolytes decreased,2,1331,1329,34,32,420472,18.669543663966714
quinapril,Body weight problem,2,1331,1329,112,110,420394,5.6664919918305925
quinapril,Bone fragmentation,1,1331,1330,6,5,420499,52.86077694235589
quinapril,Bone marrow oedema syndrome,2,1331,1329,16,14,420490,39.67447328818661
quinapril,Brain natriuretic peptide increased,1,1331,1330,44,43,420461,7.207638414217362
quinapril,Bullous Dermatitis,1,1331,1330,8,7,420497,39.64539473684211
quinapril,Bunion operation,1,1331,1330,100,99,420405,3.17093984962406
quinapril,Burning sensation,11,1331,1320,925,914,419590,3.7919819819819818
quinapril,CSF white blood cell count increased,1,1331,1330,6,5,420499,52.86077694235589
quinapril,Calcium deposits in tendon,1,1331,1330,65,64,420440,4.878773857721226
quinapril,Cardiac Catheterization Procedures,2,1331,1329,11,9,420495,57.70900882413298
quinapril,Carotid intima-media thickness increased,1,1331,1330,27,26,420478,11.746254525201893
quinapril,Catheter site infection,2,1331,1329,131,129,420375,4.844416108076439
quinapril,Cellulitis,9,1331,1322,840,831,419673,3.411997514588286
quinapril,Cerebral Arteriosclerosis,1,1331,1330,13,12,420492,24.396876807403125
quinapril,Cerebrovascular accident,1,1331,1330,23,22,420482,13.789212160836875
quinapril,Chronic Fatigue Syndrome,1,1331,1330,62,61,420443,5.114879941789958
quinapril,Cold Sensation,1,1331,1330,92,91,420413,3.4467391304347825
quinapril,Colitis,2,1331,1329,175,173,420331,3.6260131140492318
quinapril,"Colitis, Ischemic",1,1331,1330,51,50,420454,6.218251511130768
quinapril,Congestive heart failure,3,1331,1328,308,305,420199,3.091703665310593
quinapril,Corneal dystrophy,1,1331,1330,50,49,420455,6.342631578947368
quinapril,Coronary revascularisation,2,1331,1329,68,66,420438,9.334019386535653
quinapril,Deafness Neurosensory,1,1331,1330,44,43,420461,7.207638414217362
quinapril,Death (finding),1,1331,1330,69,68,420436,4.595902800479459
quinapril,Delayed union of fracture,1,1331,1330,85,84,420420,3.7306501547987616
quinapril,Dental Pulp Diseases,1,1331,1330,30,29,420475,10.57155388471178
quinapril,Dermabrasion,1,1331,1330,34,33,420471,9.327753206545776
quinapril,Device dislocation,2,1331,1329,57,55,420449,11.135611790952172
quinapril,Device malfunction,6,1331,1325,428,422,420082,4.4585469934755775
quinapril,Diarrhea,2,1331,1329,160,158,420346,3.9660929270127916
quinapril,Difficulty driving a car,2,1331,1329,51,49,420455,12.445860812346007
quinapril,Dilatation of ureter,1,1331,1330,18,17,420487,17.619757727652463
quinapril,Discomfort,1,1331,1330,53,52,420452,5.983572137891899
quinapril,Disease Exacerbation,1,1331,1330,71,70,420434,4.46641957005189
quinapril,Disease of capillaries,1,1331,1330,42,41,420463,7.550895094880056
quinapril,Disorientation,4,1331,1327,306,302,420202,4.15236096950712
quinapril,Drug effect delayed,1,1331,1330,66,65,420439,4.804841649578491
quinapril,Dry skin,6,1331,1325,540,534,419970,3.5328721174004194
quinapril,Dysfunction of urinary bladder,1,1331,1330,9,8,420496,35.24026733500418
quinapril,Dysgeusia,4,1331,1327,294,290,420214,4.321968124099677
quinapril,Dysphonia,7,1331,1324,378,371,420133,5.894833277386147
quinapril,Embedded device,1,1331,1330,36,35,420469,8.809502923976607
quinapril,Endoscopy gastrointestinal abnormal,4,1331,1327,259,255,420249,4.90642521087133
quinapril,Enterocolitis viral,2,1331,1329,61,59,420445,10.405309057716266
quinapril,Erythema Multiforme,2,1331,1329,25,23,420481,25.39112114371708
quinapril,Falls,2,1331,1329,72,70,420434,8.815379148900593
quinapril,Feeling jittery,2,1331,1329,87,85,420419,7.29522672824611
quinapril,Felty Syndrome,1,1331,1330,13,12,420492,24.396876807403125
quinapril,Fibromyalgia,2,1331,1329,195,193,420311,3.25395998533696
quinapril,Foetal monitoring abnormal,1,1331,1330,7,6,420498,45.309129967776585
quinapril,Food intolerance (disorder),1,1331,1330,80,79,420425,3.9638627819548873
quinapril,Fracture of wrist,1,1331,1330,96,95,420409,3.3030936716791977
quinapril,Furunculosis of skin AND/OR subcutaneous tissue,1,1331,1330,16,15,420489,19.82232142857143
quinapril,Gastrointestinal Stromal Tumors,1,1331,1330,15,14,420490,21.143859649122806
quinapril,Gastrointestinal mucosa hyperaemia,1,1331,1330,6,5,420499,52.86077694235589
quinapril,Genital hemorrhage,1,1331,1330,65,64,420440,4.878773857721226
quinapril,Granulomatous pneumonitis,1,1331,1330,6,5,420499,52.86077694235589
quinapril,Head discomfort,1,1331,1330,81,80,420424,3.9149169219344655
quinapril,Heat Cramps,3,1331,1328,264,261,420243,3.6073641155531218
quinapril,Heavy feeling,7,1331,1324,223,216,420288,9.995813745546178
quinapril,Hematoma,5,1331,1326,416,411,420093,3.8198583797424295
quinapril,Hemoglobin increased,1,1331,1330,91,90,420414,3.4846236470296623
quinapril,Hernia of abdominal cavity,1,1331,1330,26,25,420479,12.198062463851938
quinapril,Hiccough,1,1331,1330,44,43,420461,7.207638414217362
quinapril,High density lipoprotein abnormal,1,1331,1330,61,60,420444,5.198742758535684
quinapril,Hyperpigmentation,1,1331,1330,63,62,420442,5.033679436686955
quinapril,Idiopathic erosive/hemorrhagic gastritis,1,1331,1330,98,97,420407,3.235668252263311
quinapril,Ileocolectomy,1,1331,1330,11,10,420494,28.832809295967195
quinapril,Inappropriate schedule of drug administration,2,1331,1329,139,137,420367,4.56551418007806
quinapril,Increased anteroposterior chest diameter,1,1331,1330,45,44,420460,7.047451963241437
quinapril,Increased appetite (finding),2,1331,1329,79,77,420427,8.034136259298416
quinapril,Increased bilirubin level (finding),2,1331,1329,173,171,420333,3.6679497383838515
quinapril,Infected bite,1,1331,1330,21,20,420484,15.102542069459362
quinapril,Infected dermal cyst,2,1331,1329,167,165,420339,3.7997864316513703
quinapril,Infectious colitis,2,1331,1329,9,7,420497,70.53356742747262
quinapril,Inflammation,1,1331,1330,7,6,420498,45.309129967776585
quinapril,Injection site discomfort,3,1331,1328,21,18,420486,45.37586058519793
quinapril,Injection site hemorrhage,1,1331,1330,56,55,420449,5.66298335123523
quinapril,Injection site itching,1,1331,1330,82,81,420423,3.8671648633779574
quinapril,Injection site pain,5,1331,1326,477,472,420032,3.330882748196844
quinapril,Injection site scar,1,1331,1330,23,22,420482,13.789212160836875
quinapril,Injection site urticaria,20,1331,1311,1425,1405,419099,4.500756085484497
quinapril,Intervertebral disc disorder,1,1331,1330,62,61,420443,5.114879941789958
quinapril,Intestinal Polyps,3,1331,1328,161,158,420346,5.916626131856619
quinapril,Intracranial Aneurysm,4,1331,1327,225,221,420283,5.648296073013481
quinapril,Jaw pain,1,1331,1330,80,79,420425,3.9638627819548873
quinapril,Joint stiffness,3,1331,1328,168,165,420339,5.670005916523236
quinapril,"Kidney Failure, Acute",2,1331,1329,173,171,420333,3.6679497383838515
quinapril,Kyphoscoliosis deformity of spine,1,1331,1330,74,73,420431,4.285318024791709
quinapril,Lacrimal haemorrhage,1,1331,1330,43,42,420462,7.375275397796818
quinapril,Learning Disorders,2,1331,1329,52,50,420454,12.20648839497598
quinapril,Left-Sided Heart Failure,2,1331,1329,33,31,420473,19.23533301411405
quinapril,Leukoencephalopathy,1,1331,1330,7,6,420498,45.309129967776585
quinapril,Ligament rupture,1,1331,1330,84,83,420421,3.7750716075904043
quinapril,Limb injury,1,1331,1330,80,79,420425,3.9638627819548873
quinapril,Livedo Reticularis,1,1331,1330,67,66,420438,4.733116373022107
quinapril,Liver damage,2,1331,1329,128,126,420378,4.957992381489842
quinapril,Localized Edema,1,1331,1330,65,64,420440,4.878773857721226
quinapril,Lung carcinoma cell type unspecified stage III,2,1331,1329,33,31,420473,19.23533301411405
quinapril,Lyme Disease,1,1331,1330,48,47,420457,6.606939223057644
quinapril,Macular rash,2,1331,1329,126,124,420380,5.036714560416592
quinapril,Madarosis of eyelid,1,1331,1330,88,87,420417,3.6034432672590566
quinapril,Malignant neoplasm of urinary bladder,1,1331,1330,27,26,420478,11.746254525201893
quinapril,Mammary Neoplasms,1,1331,1330,20,19,420485,15.857706766917294
quinapril,Mass of skin,1,1331,1330,26,25,420479,12.198062463851938
quinapril,Mediastinal Diseases,3,1331,1328,278,275,420229,3.425584532374101
quinapril,Metastatic Renal Cell Carcinoma,2,1331,1329,62,60,420444,10.237457219835433
quinapril,Migraine Aura without Headache,2,1331,1329,66,64,420440,9.616914061609322
quinapril,Mucosal atrophy,2,1331,1329,11,9,420495,57.70900882413298
quinapril,Multiple allergies,1,1331,1330,99,98,420406,3.2029771398192453
quinapril,Muscle tightness,3,1331,1328,289,286,420218,3.2951129778630093
quinapril,Musculoskeletal Deformity,1,1331,1330,45,44,420460,7.047451963241437
quinapril,Mycoses,2,1331,1329,166,164,420340,3.822685776967917
quinapril,Mydriasis,1,1331,1330,95,94,420410,3.3378709932726554
quinapril,Myelomalacia,2,1331,1329,47,45,420459,13.505211084962298
quinapril,Myocardial strain imaging,1,1331,1330,24,23,420481,13.214630325814536
quinapril,Nephroangiosclerosis,3,1331,1328,118,115,420389,8.073508015111294
quinapril,Neurodermatitis,2,1331,1329,69,67,420437,9.19872193323955
quinapril,Neutropenic sepsis,1,1331,1330,95,94,420410,3.3378709932726554
quinapril,Normal menstruation (finding),2,1331,1329,93,91,420413,6.824469849591819
quinapril,Nutritional condition abnormal,3,1331,1328,160,157,420347,5.953619164156626
quinapril,Ocular hyperemia,8,1331,1323,763,755,419749,3.3370442687050064
quinapril,Oedema due to hepatic disease,2,1331,1329,63,61,420443,10.074934011728594
quinapril,Open reduction of fracture,1,1331,1330,16,15,420489,19.82232142857143
quinapril,Operation on bone,1,1331,1330,24,23,420481,13.214630325814536
quinapril,Operative procedure on knee,1,1331,1330,85,84,420420,3.7306501547987616
quinapril,Pain in penis,1,1331,1330,87,86,420418,3.644870797683865
quinapril,"Pain, Procedural",1,1331,1330,42,41,420463,7.550895094880056
quinapril,Palmar-plantar erythrodysesthesia syndrome,2,1331,1329,46,44,420460,13.798835345307031
quinapril,Pancreatic Infection,2,1331,1329,143,141,420363,4.4377653948760045
quinapril,Periarthritis,2,1331,1329,52,50,420454,12.20648839497598
quinapril,Physical product label issue,2,1331,1329,19,17,420487,33.409845154647336
quinapril,Pneumonitis,1,1331,1330,55,54,420450,5.765960355434039
quinapril,Poisoning,11,1331,1320,331,320,420184,10.611883182275932
quinapril,Polymyalgia Rheumatica,1,1331,1330,43,42,420462,7.375275397796818
quinapril,Polyp of esophagus,1,1331,1330,25,24,420480,12.686015037593984
quinapril,Postthrombotic Syndrome,2,1331,1329,5,3,420501,126.96162528216706
quinapril,Pregnancy on oral contraceptive,1,1331,1330,6,5,420499,52.86077694235589
quinapril,Product closure issue,1,1331,1330,7,6,420498,45.309129967776585
quinapril,Projectile vomiting,1,1331,1330,23,22,420482,13.789212160836875
quinapril,Prolonged labor,1,1331,1330,27,26,420478,11.746254525201893
quinapril,Psychological Trauma,1,1331,1330,99,98,420406,3.2029771398192453
quinapril,Pulmonary Infiltrate,3,1331,1328,78,75,420429,12.214927015755329
quinapril,"Radiculopathy, Cervical",1,1331,1330,31,30,420474,10.230511763279166
quinapril,Respiratory Depression,1,1331,1330,17,16,420488,18.656258292790802
quinapril,"Respiratory Distress Syndrome, Adult",1,1331,1330,25,24,420480,12.686015037593984
quinapril,Retinitis,1,1331,1330,20,19,420485,15.857706766917294
quinapril,Rheumatoid Arthritis,1,1331,1330,47,46,420458,6.747528395456727
quinapril,Rib Fractures,5,1331,1326,108,103,420401,14.72428216300765
quinapril,Seborrheic dermatitis of scalp,1,1331,1330,21,20,420484,15.102542069459362
quinapril,Sense of smell impaired,1,1331,1330,23,22,420482,13.789212160836875
quinapril,"Shock, Cardiogenic",1,1331,1330,96,95,420409,3.3030936716791977
quinapril,Sialadenitis,1,1331,1330,70,69,420435,4.530236305048335
quinapril,Sleep Apnea Syndromes,8,1331,1323,593,585,419919,4.295434643784438
quinapril,Sleeplessness,2,1331,1329,120,118,420386,5.288625532982192
quinapril,Spondylitis,1,1331,1330,72,71,420433,4.40437552213868
quinapril,Spontaneous abortion,2,1331,1329,174,172,420332,3.6468609186753502
quinapril,Staghorn Calculi,2,1331,1329,108,106,420398,5.876417802301925
quinapril,Subclavian artery embolism,1,1331,1330,39,38,420466,8.131791016001541
quinapril,Subcutaneous Abscess,8,1331,1323,389,381,420123,6.5512244315035355
quinapril,Superficial spreading malignant melanoma of skin,1,1331,1330,104,103,420401,3.0489517061885483
quinapril,Swelling of breast,1,1331,1330,62,61,420443,5.114879941789958
quinapril,Tachyarrhythmia,1,1331,1330,36,35,420469,8.809502923976607
quinapril,Tachycardia,2,1331,1329,128,126,420378,4.957992381489842
quinapril,Thyroid function tests abnormal,3,1331,1328,124,121,420383,7.682745093276331
quinapril,Torsades de Pointes,1,1331,1330,44,43,420461,7.207638414217362
quinapril,Toxicoderma,3,1331,1328,191,188,420316,4.986958304421876
quinapril,Tracheostomy malfunction,1,1331,1330,24,23,420481,13.214630325814536
quinapril,Trigger Finger Disorder,1,1331,1330,88,87,420417,3.6034432672590566
quinapril,Trismus,1,1331,1330,14,13,420491,22.654189044038667
quinapril,Troponin increased,1,1331,1330,35,34,420470,9.061224489795919
quinapril,Typhlitis,1,1331,1330,78,77,420427,4.065519568151147
quinapril,Unresponsive to stimuli,1,1331,1330,72,71,420433,4.40437552213868
quinapril,Unspecified abortion incomplete,1,1331,1330,20,19,420485,15.857706766917294
quinapril,Upper respiratory tract irritation,1,1331,1330,5,4,420500,63.433082706766925
quinapril,Urinary tract infection,2,1331,1329,132,130,420374,4.807704585356955
quinapril,Vaginal Fistula,2,1331,1329,19,17,420487,33.409845154647336
quinapril,Vaginal Hemorrhage,1,1331,1330,51,50,420454,6.218251511130768
quinapril,Vaginal abscess,1,1331,1330,56,55,420449,5.66298335123523
quinapril,Victim of sexual abuse,5,1331,1326,284,279,420225,5.597038111019056
quinapril,Vitamin B12 deficiency anemia,1,1331,1330,105,104,420400,3.0199069101324745
quinapril,Vitamin D below reference range,1,1331,1330,57,56,420448,5.563619575253924
quinapril,Vulvovaginal dryness,2,1331,1329,39,37,420467,16.275819490266443
quinapril,Vulvovaginal pruritus,1,1331,1330,22,21,420483,14.416028708133972
quinapril,Warm skin,1,1331,1330,105,104,420400,3.0199069101324745
quinapril,Wound infection staphylococcal,1,1331,1330,61,60,420444,5.198742758535684
quinapril,bite injury,11,1331,1320,1079,1068,419436,3.2495829471733084
quinapril,furuncle,2,1331,1329,185,183,420321,3.4299310597279
quinapril,tissue injury of lip (physical finding),1,1331,1330,82,81,420423,3.8671648633779574
ramipril,Abasia (gait ataxia),12,6087,6075,240,228,415520,3.469917695473251
ramipril,Abdominal mass,5,6087,6082,55,50,415698,6.304445308062539
ramipril,Abnormal hair growth,1,6087,6086,23,22,415726,3.013416394004772
ramipril,Abnormal heart beat,3,6087,6084,43,40,415708,4.836842346681345
ramipril,Abnormal mean corpuscular volume,3,6087,6084,14,11,415737,14.857037193575653
ramipril,Abscess of pharynx,1,6087,6086,20,19,415729,3.4654534998356885
ramipril,Acarodermatitis,1,6087,6086,19,18,415730,3.6478544372762336
ramipril,Accident while engaged in work-related activity,1,6087,6086,8,7,415741,8.663880216891226
ramipril,Acquired ventricular septal defect,2,6087,6085,5,3,415745,27.729170090386198
ramipril,Actinic keratosis,1,6087,6086,22,21,415727,3.150397335165656
ramipril,Acute graft versus host disease in skin,1,6087,6086,5,4,415744,13.862306933946764
ramipril,Acute tonsillitis,19,6087,6068,117,98,415650,11.286110688549712
ramipril,"Adenocarcinoma of lung, stage I",1,6087,6086,5,4,415744,13.862306933946764
ramipril,Administration of enema,1,6087,6086,10,9,415739,6.931071311206048
ramipril,Adrenal Gland Neoplasms,3,6087,6084,13,10,415738,15.999924138977393
ramipril,Adult-Onset Still Disease,1,6087,6086,6,5,415743,11.551895059699858
ramipril,Agoraphobia,1,6087,6086,15,14,415734,4.620659436959142
ramipril,Amaurosis Fugax,5,6087,6082,68,63,415685,5.099026539257597
ramipril,Ammonia increased,2,6087,6085,10,8,415740,13.86442070665571
ramipril,Anal Ulcer,5,6087,6082,25,20,415728,13.870766195330484
ramipril,Angiogram peripheral abnormal,1,6087,6086,10,9,415739,6.931071311206048
ramipril,Anorexia Nervosa,4,6087,6083,64,60,415688,4.333501150747987
ramipril,Anosmia,1,6087,6086,13,12,415736,5.331555398265881
ramipril,Anti-cyclic citrullinated peptide antibody negative,1,6087,6086,21,20,415728,3.3004240802466236
ramipril,Antibiotic therapy,1,6087,6086,8,7,415741,8.663880216891226
ramipril,"Aortic Aneurysm, Ruptured",2,6087,6085,18,16,415732,7.7023098694421614
ramipril,Aortic Valve Stenosis,1,6087,6086,8,7,415741,8.663880216891226
ramipril,Aortic coarctation,2,6087,6085,5,3,415745,27.729170090386198
ramipril,Aortic valve disorder,3,6087,6084,68,65,415683,3.0584101983988865
ramipril,Apathy,5,6087,6082,97,92,415656,3.574329523996786
ramipril,Aphakic cystoid macular oedema,1,6087,6086,7,6,415742,9.901600863809211
ramipril,Apnea,3,6087,6084,14,11,415737,14.857037193575653
ramipril,Arterial Injury,2,6087,6085,29,27,415721,4.7806193862805655
ramipril,Arterial insufficiency,2,6087,6085,45,43,415705,3.080726741532
ramipril,Arteriovenous fistula,3,6087,6084,58,55,415693,3.585807318234374
ramipril,Arthroscopy,1,6087,6086,23,22,415726,3.013416394004772
ramipril,Asthenopia,2,6087,6085,34,32,415716,4.07753878872831
ramipril,Aura,1,6087,6086,18,17,415731,3.8505221455435055
ramipril,Auriculo-Ventricular Dissociation,2,6087,6085,24,22,415726,5.776650232812928
ramipril,Autoimmune hepatitis,1,6087,6086,6,5,415743,11.551895059699858
ramipril,Autoimmune necrotizing myopathy,1,6087,6086,12,11,415737,5.775865374082594
ramipril,Avulsion fracture,5,6087,6082,107,102,415646,3.2402032041845557
ramipril,Axonal neuropathy,7,6087,6080,111,104,415644,4.374211711711712
ramipril,Benign Neoplasm,1,6087,6086,10,9,415739,6.931071311206048
ramipril,Benign neoplasm of breast,1,6087,6086,6,5,415743,11.551895059699858
ramipril,Benign neoplasm of thyroid gland,1,6087,6086,5,4,415744,13.862306933946764
ramipril,Bicytopenia,2,6087,6085,25,23,415725,5.545571076417421
ramipril,Biliary sphincterotomy,1,6087,6086,7,6,415742,9.901600863809211
ramipril,Biliary tract infection,4,6087,6083,36,32,415716,7.704513489323616
ramipril,Biopsy of pancreas,1,6087,6086,9,8,415740,7.701208602621682
ramipril,Bladder cyst,6,6087,6081,42,36,415712,9.908920055442008
ramipril,Blood bicarbonate level decreased below normal,1,6087,6086,11,10,415738,6.300958981865982
ramipril,Blood chloride increased,2,6087,6085,39,37,415711,3.554735267471504
ramipril,Blood cholesterol,5,6087,6082,92,87,415661,3.7686312425832464
ramipril,Blood cholesterol abnormal,2,6087,6085,37,35,415713,3.7469008860956277
ramipril,Blood creatine phosphokinase abnormal,1,6087,6086,21,20,415728,3.3004240802466236
ramipril,Blood glucose outside reference range,34,6087,6053,668,634,415114,3.541490783508153
ramipril,Blood growth hormone abnormal,1,6087,6086,14,13,415735,4.950718276137271
ramipril,Blood phosphorus decreased,3,6087,6084,36,33,415715,5.777435349550734
ramipril,Blood potassium abnormal,7,6087,6080,24,17,415731,20.234902686403508
ramipril,Blood uric acid abnormal,1,6087,6086,10,9,415739,6.931071311206048
ramipril,Bone density abnormal,1,6087,6086,16,15,415733,4.331857952678278
ramipril,Brain Edema,4,6087,6083,79,75,415673,3.510559621439288
ramipril,Brain stem haematoma,7,6087,6080,19,12,415736,25.56018005540166
ramipril,Breakthrough Pain,5,6087,6082,82,77,415671,4.228320674360969
ramipril,Bronchial Diseases,2,6087,6085,5,3,415745,27.729170090386198
ramipril,Bronchial aspiration procedure,1,6087,6086,7,6,415742,9.901600863809211
ramipril,Brucellosis,4,6087,6083,69,65,415683,4.019431678209885
ramipril,Brugada Syndrome (disorder),2,6087,6085,25,23,415725,5.545571076417421
ramipril,Burning sensation of skin,2,6087,6085,26,24,415724,5.332267239744644
ramipril,Calculus of pancreas,1,6087,6086,12,11,415737,5.775865374082594
ramipril,Candida test positive,6,6087,6081,15,9,415739,27.746752178917944
ramipril,Candiduria,6,6087,6081,80,74,415674,5.201714356191416
ramipril,Carbohydrate antigen 125 normal,1,6087,6086,10,9,415739,6.931071311206048
ramipril,Carbohydrate antigen 19-9 increased,7,6087,6080,90,83,415665,5.3951297514619885
ramipril,Cardiac septal hypertrophy,2,6087,6085,14,12,415736,9.903063739875572
ramipril,Cataplexy,1,6087,6086,17,16,415732,4.077033113606928
ramipril,Central cyanosis,2,6087,6085,17,15,415733,8.155406254531394
ramipril,Cerebral Arteriosclerosis,1,6087,6086,13,12,415736,5.331555398265881
ramipril,Cerebrovascular Insufficiency,1,6087,6086,16,15,415733,4.331857952678278
ramipril,Cervical spinal cord injury,1,6087,6086,17,16,415732,4.077033113606928
ramipril,Cesarean section,1,6087,6086,13,12,415736,5.331555398265881
ramipril,Chemical burns of eye,1,6087,6086,10,9,415739,6.931071311206048
ramipril,Cholecystitis infective,2,6087,6085,44,42,415706,3.150750728318518
ramipril,Chondromalacia,1,6087,6086,5,4,415744,13.862306933946764
ramipril,Chronic Urticaria,2,6087,6085,24,22,415726,5.776650232812928
ramipril,Chronic graft-versus-host disease,1,6087,6086,12,11,415737,5.775865374082594
ramipril,Closed Fracture Reduction,3,6087,6084,25,22,415726,8.319723865877712
ramipril,Coital bleeding,1,6087,6086,9,8,415740,7.701208602621682
ramipril,Cold Sensation,6,6087,6081,92,86,415662,4.5231011775809185
ramipril,"Colitis, Ischemic",4,6087,6083,51,47,415701,5.438286707087898
ramipril,Collagen-vascular disease,1,6087,6086,7,6,415742,9.901600863809211
ramipril,Colonic Neoplasms,2,6087,6085,23,21,415727,6.027823228895002
ramipril,Complications of Diabetes Mellitus,1,6087,6086,15,14,415734,4.620659436959142
ramipril,Congenital choroid plexus cyst,1,6087,6086,15,14,415734,4.620659436959142
ramipril,Congenital heart valve incompetence,2,6087,6085,9,7,415741,15.404948415959097
ramipril,Congenital inguinal hernia,3,6087,6084,19,16,415732,10.947160801411812
ramipril,Congenital stenosis of aortic valve,2,6087,6085,24,22,415726,5.776650232812928
ramipril,Corneal dystrophy,4,6087,6083,50,46,415702,5.547065592635213
ramipril,Coronary Arteriosclerosis,4,6087,6083,88,84,415664,3.151457863195493
ramipril,Cortical cataract,6,6087,6081,108,102,415646,3.8528659394470934
ramipril,Crushing injury,13,6087,6074,253,240,415508,3.566400428965031
ramipril,Cutaneous plaque,1,6087,6086,13,12,415736,5.331555398265881
ramipril,Deafness Neurosensory,3,6087,6084,44,41,415707,4.7269029047875195
ramipril,Death of relative,1,6087,6086,17,16,415732,4.077033113606928
ramipril,Decreased peak expiratory flow rate,1,6087,6086,6,5,415743,11.551895059699858
ramipril,"Dementia, Vascular",2,6087,6085,9,7,415741,15.404948415959097
ramipril,Dermatitis Herpetiformis,1,6087,6086,9,8,415740,7.701208602621682
ramipril,Diabetic Ketoacidosis,5,6087,6082,19,14,415734,18.251267761643504
ramipril,Differential white blood cell count abnormal,1,6087,6086,20,19,415729,3.4654534998356885
ramipril,Disseminated Histoplasmosis,1,6087,6086,15,14,415734,4.620659436959142
ramipril,Disturbance of attention,1,6087,6086,19,18,415730,3.6478544372762336
ramipril,Diverticulitis,1,6087,6086,10,9,415739,6.931071311206048
ramipril,Drug Dependence,7,6087,6080,9,2,415746,53.96165935672515
ramipril,Drug effect incomplete,2,6087,6085,34,32,415716,4.07753878872831
ramipril,Drug withdrawal syndrome,8,6087,6079,134,126,415622,4.141500099437015
ramipril,Dry tongue,2,6087,6085,27,25,415723,5.134763687269849
ramipril,Dyslipidemias,1,6087,6086,11,10,415738,6.300958981865982
ramipril,Dysmorphism,1,6087,6086,5,4,415744,13.862306933946764
ramipril,Dystonia,2,6087,6085,11,9,415739,12.603988944498395
ramipril,Eczema,3,6087,6084,64,61,415687,3.2495916543392505
ramipril,Electrocardiogram R on T phenomenon,1,6087,6086,13,12,415736,5.331555398265881
ramipril,Encephalopathies,1,6087,6086,11,10,415738,6.300958981865982
ramipril,Endometrial Carcinoma,1,6087,6086,23,22,415726,3.013416394004772
ramipril,Endometrial Hyperplasia,4,6087,6083,10,6,415742,27.73795824428736
ramipril,Endoscopy gastrointestinal abnormal,14,6087,6073,259,245,415503,3.752328650072764
ramipril,Enteritis,1,6087,6086,8,7,415741,8.663880216891226
ramipril,Enuresis,1,6087,6086,5,4,415744,13.862306933946764
ramipril,Erythropenia,1,6087,6086,8,7,415741,8.663880216891226
ramipril,Escherichia bacteraemia,1,6087,6086,7,6,415742,9.901600863809211
ramipril,Escherichia test positive,3,6087,6084,16,13,415735,12.99984590729783
ramipril,Excessive bronchial secretion,4,6087,6083,59,55,415693,4.700802737275597
ramipril,Exfoliative rash,13,6087,6074,277,264,415484,3.2572127871771617
ramipril,Extremity necrosis,1,6087,6086,15,14,415734,4.620659436959142
ramipril,Eye Burns,1,6087,6086,8,7,415741,8.663880216891226
ramipril,"Eye Infections, Bacterial",3,6087,6084,39,36,415712,5.332979315227836
ramipril,Failure to lose weight,1,6087,6086,16,15,415733,4.331857952678278
ramipril,Falls,5,6087,6082,72,67,415681,4.815701614965837
ramipril,Fecaloma,1,6087,6086,20,19,415729,3.4654534998356885
ramipril,Feeling intoxicated,5,6087,6082,101,96,415652,3.4327393607496233
ramipril,Feeling jittery,10,6087,6077,87,77,415671,7.977090934539312
ramipril,Fixed Pupils,7,6087,6080,14,7,415741,34.689226973684214
ramipril,Flattened T wave (finding),1,6087,6086,8,7,415741,8.663880216891226
ramipril,Focal Infection,1,6087,6086,13,12,415736,5.331555398265881
ramipril,Foetal heart rate deceleration abnormality,10,6087,6077,27,17,415731,25.707616453050054
ramipril,Folliculitis,1,6087,6086,11,10,415738,6.300958981865982
ramipril,Fracture of ilium,1,6087,6086,8,7,415741,8.663880216891226
ramipril,Fracture of lumbar spine,1,6087,6086,18,17,415731,3.8505221455435055
ramipril,Fracture of pelvis,1,6087,6086,19,18,415730,3.6478544372762336
ramipril,Fracture of pubis,1,6087,6086,20,19,415729,3.4654534998356885
ramipril,Functional Gastrointestinal Disorders,2,6087,6085,43,41,415707,3.2240316447230133
ramipril,Fungal pneumonia,1,6087,6086,8,7,415741,8.663880216891226
ramipril,Fungemia,2,6087,6085,38,36,415712,3.6482895818016687
ramipril,Furred tongue,6,6087,6081,49,43,415705,8.493219093261379
ramipril,Gamma-Glutamyltransferase Increased,17,6087,6070,362,345,415403,3.2607793969071697
ramipril,Gastric mucosa erythema,1,6087,6086,21,20,415728,3.3004240802466236
ramipril,Gastrointestinal Stromal Tumors,1,6087,6086,15,14,415734,4.620659436959142
ramipril,Genital swelling,1,6087,6086,17,16,415732,4.077033113606928
ramipril,Gingival Diseases,4,6087,6083,15,11,415737,18.49175297276563
ramipril,Gingival Recession,1,6087,6086,6,5,415743,11.551895059699858
ramipril,Gingivitis,11,6087,6076,170,159,415589,4.490488130736166
ramipril,Graft versus host disease in liver,1,6087,6086,8,7,415741,8.663880216891226
ramipril,Granulomatous pneumonitis,1,6087,6086,6,5,415743,11.551895059699858
ramipril,Graves Disease,5,6087,6082,46,41,415707,7.538084583160573
ramipril,Haemorrhagic erosive gastritis,1,6087,6086,10,9,415739,6.931071311206048
ramipril,Headache,9,6087,6078,204,195,415553,3.0604421926717382
ramipril,Heart murmur,31,6087,6056,626,595,415153,3.444285444477739
ramipril,Heart valve disease,1,6087,6086,9,8,415740,7.701208602621682
ramipril,Hemarthrosis,1,6087,6086,17,16,415732,4.077033113606928
ramipril,Hemodynamic instability,4,6087,6083,51,47,415701,5.438286707087898
ramipril,Hemorrhagic Disorders,4,6087,6083,6,2,415746,46.23036878733081
ramipril,Hepatic Vein Thrombosis,1,6087,6086,5,4,415744,13.862306933946764
ramipril,Hepatitis,1,6087,6086,6,5,415743,11.551895059699858
ramipril,Hepatitis B,19,6087,6068,408,389,415359,3.2342249440976127
ramipril,"Hepatitis, Toxic",4,6087,6083,81,77,415671,3.4238629006561494
ramipril,Hepatotoxicity,9,6087,6078,186,177,415571,3.3567573161799826
ramipril,"Hernia, Inguinal",1,6087,6086,17,16,415732,4.077033113606928
ramipril,Heterophoria,11,6087,6076,134,123,415625,5.697374303597221
ramipril,Hiccough,2,6087,6085,44,42,415706,3.150750728318518
ramipril,Hilar lymphadenopathy,3,6087,6084,22,19,415729,9.454298906221982
ramipril,Hydrocele operation,4,6087,6083,44,40,415708,6.303573296668809
ramipril,Hydrops Fetalis,1,6087,6086,6,5,415743,11.551895059699858
ramipril,Hyperacusis,3,6087,6084,7,4,415744,29.714567483798252
ramipril,Hyperammonemic encephalopathy,1,6087,6086,15,14,415734,4.620659436959142
ramipril,Hypergammaglobulinemia,7,6087,6080,63,56,415692,7.7078216374269
ramipril,Hyperphagia,3,6087,6084,11,8,415740,18.909090909090907
ramipril,Hyperprolactinemia,4,6087,6083,10,6,415742,27.73795824428736
ramipril,Hypersomnia,2,6087,6085,42,40,415708,3.300802128575341
ramipril,Hypocalcemia,16,6087,6071,294,278,415470,3.7787855053073773
ramipril,Hypogammaglobulinemia,1,6087,6086,6,5,415743,11.551895059699858
ramipril,Hysterectomy,1,6087,6086,17,16,415732,4.077033113606928
ramipril,Ileitis,1,6087,6086,13,12,415736,5.331555398265881
ramipril,Iliotibial Band Syndrome,1,6087,6086,20,19,415729,3.4654534998356885
ramipril,Immunosuppressant drug level increased,1,6087,6086,16,15,415733,4.331857952678278
ramipril,Impatience,1,6087,6086,13,12,415736,5.331555398265881
ramipril,Increased capillary permeability,2,6087,6085,8,6,415742,17.33060805258833
ramipril,Increased fibrinolysis (finding),4,6087,6083,24,20,415728,11.557099019124335
ramipril,Infected ulcer of skin,4,6087,6083,83,79,415669,3.3413443350914758
ramipril,Infection,14,6087,6073,170,156,415592,5.717989945854844
ramipril,Inflammatory corneal ulcer,4,6087,6083,59,55,415693,4.700802737275597
ramipril,Inhibitory drug interaction,1,6087,6086,5,4,415744,13.862306933946764
ramipril,Injection site atrophy,1,6087,6086,17,16,415732,4.077033113606928
ramipril,Injection site discolouration,3,6087,6084,35,32,415716,5.942519019442097
ramipril,Injection site infection,1,6087,6086,6,5,415743,11.551895059699858
ramipril,Injection site necrosis,2,6087,6085,38,36,415712,3.6482895818016687
ramipril,Injury of mouth,2,6087,6085,21,19,415729,6.601932934225456
ramipril,International normalized ratio decreased,1,6087,6086,11,10,415738,6.300958981865982
ramipril,Interstitial granulomatous dermatitis,2,6087,6085,40,38,415710,3.4658586688578477
ramipril,Intestinal resection,1,6087,6086,8,7,415741,8.663880216891226
ramipril,Intraductal papilloma of breast,1,6087,6086,6,5,415743,11.551895059699858
ramipril,"Intubation, Intratracheal",1,6087,6086,6,5,415743,11.551895059699858
ramipril,Ischemic cardiomyopathy,1,6087,6086,14,13,415735,4.950718276137271
ramipril,Itching of ear,2,6087,6085,5,3,415745,27.729170090386198
ramipril,Jaw pain,4,6087,6083,80,76,415672,3.4666694065428247
ramipril,Keratitis,1,6087,6086,10,9,415739,6.931071311206048
ramipril,Laryngeal cleft,1,6087,6086,8,7,415741,8.663880216891226
ramipril,Liver Abscess,1,6087,6086,17,16,415732,4.077033113606928
ramipril,Liver mass,6,6087,6081,67,61,415687,6.211193661686633
ramipril,Localised intraabdominal fluid collection,4,6087,6083,48,44,415704,5.778220724423256
ramipril,Loss of proprioception,1,6087,6086,10,9,415739,6.931071311206048
ramipril,Low Cardiac Output,1,6087,6086,21,20,415728,3.3004240802466236
ramipril,Lower respiratory tract infection,1,6087,6086,16,15,415733,4.331857952678278
ramipril,Lung Neoplasms,1,6087,6086,7,6,415742,9.901600863809211
ramipril,Lymph node excision,3,6087,6084,33,30,415718,6.302701571932341
ramipril,Macular fibrosis,1,6087,6086,9,8,415740,7.701208602621682
ramipril,Madarosis of eyelid,9,6087,6078,88,79,415669,7.096613344700709
ramipril,Malignant melanoma in situ,4,6087,6083,53,49,415699,5.233043526809947
ramipril,Malignant neoplasm of skin,1,6087,6086,19,18,415730,3.6478544372762336
ramipril,Malignant neoplasm progression,8,6087,6079,160,152,415596,3.468292482316171
ramipril,Mammary Neoplasms,1,6087,6086,20,19,415729,3.4654534998356885
ramipril,Mass of thyroid gland,1,6087,6086,19,18,415730,3.6478544372762336
ramipril,Mastication disorder,10,6087,6077,165,155,415593,4.205324596965209
ramipril,Melena,4,6087,6083,86,82,415666,3.2247628732762674
ramipril,Memory impairment,7,6087,6080,77,70,415678,6.30619019138756
ramipril,Meningococcal meningitis,2,6087,6085,15,13,415735,9.242837578745549
ramipril,Mesenteric arterial occlusion,1,6087,6086,6,5,415743,11.551895059699858
ramipril,Mesenteric vascular insufficiency,2,6087,6085,7,5,415743,19.806456156825917
ramipril,Metastatic malignant neoplasm to peritoneum,1,6087,6086,12,11,415737,5.775865374082594
ramipril,Middle ear effusion,1,6087,6086,5,4,415744,13.862306933946764
ramipril,Middle insomnia,13,6087,6074,156,143,415605,5.785300735374822
ramipril,Migraine Disorders,12,6087,6075,203,191,415557,4.102725779967159
ramipril,Molluscum Contagiosum,2,6087,6085,15,13,415735,9.242837578745549
ramipril,Monoparesis,3,6087,6084,41,38,415710,5.072809929282724
ramipril,Morbid thoughts,1,6087,6086,13,12,415736,5.331555398265881
ramipril,Mucosal atrophy,1,6087,6086,11,10,415738,6.300958981865982
ramipril,Multi-organ disorder,2,6087,6085,19,17,415731,7.296907840678112
ramipril,Musculoskeletal discomfort,7,6087,6080,112,105,415643,4.335145970394737
ramipril,Myeloproliferative disease,3,6087,6084,58,55,415693,3.585807318234374
ramipril,Myocarditis,1,6087,6086,20,19,415729,3.4654534998356885
ramipril,Myoglobinuria,4,6087,6083,20,16,415732,13.868650337004768
ramipril,Myositis,2,6087,6085,12,10,415738,11.553629142700629
ramipril,Nasal Polyp,4,6087,6083,26,22,415726,10.668040819939556
ramipril,Nasal mucosal disorder,1,6087,6086,6,5,415743,11.551895059699858
ramipril,Neutropenic colitis,1,6087,6086,6,5,415743,11.551895059699858
ramipril,Neutrophil count decreased,25,6087,6062,567,542,415206,3.0640756858726723
ramipril,Night sweats,1,6087,6086,10,9,415739,6.931071311206048
ramipril,Nitrite detected in urine,1,6087,6086,22,21,415727,3.150397335165656
ramipril,No reaction on previous exposure to drug,11,6087,6076,151,140,415608,5.055744237451442
ramipril,Nuclear magnetic resonance imaging spinal abnormal,4,6087,6083,88,84,415664,3.151457863195493
ramipril,Nystagmus,8,6087,6079,164,156,415592,3.383667885042068
ramipril,Obstruction of gallbladder,2,6087,6085,37,35,415713,3.7469008860956277
ramipril,Oligohydramnios,2,6087,6085,8,6,415742,17.33060805258833
ramipril,Operation on joint,2,6087,6085,11,9,415739,12.603988944498395
ramipril,Oral discharge,4,6087,6083,30,26,415722,9.245547701243904
ramipril,Oral mucosal blisters,5,6087,6082,15,10,415738,23.118491724213523
ramipril,Oral mucosal erythema,2,6087,6085,24,22,415726,5.776650232812928
ramipril,Orthostatic intolerance,6,6087,6081,17,11,415737,24.482312313183787
ramipril,PO2 increased,4,6087,6083,27,23,415725,10.272903842524096
ramipril,Pain of uterus,3,6087,6084,10,7,415741,20.800049309664693
ramipril,Palmar-plantar erythrodysesthesia syndrome,2,6087,6085,46,44,415704,3.013747275910114
ramipril,Pancreatic Enzymes Decreased,1,6087,6086,9,8,415740,7.701208602621682
ramipril,Panic Disorder,1,6087,6086,15,14,415734,4.620659436959142
ramipril,Paranasal sinus discomfort,1,6087,6086,7,6,415742,9.901600863809211
ramipril,Paraplegia,1,6087,6086,21,20,415728,3.3004240802466236
ramipril,Parasomnia,1,6087,6086,23,22,415726,3.013416394004772
ramipril,Partial thromboplastin time increased (finding),1,6087,6086,15,14,415734,4.620659436959142
ramipril,Patent ductus arteriosus,1,6087,6086,10,9,415739,6.931071311206048
ramipril,Peptic Ulcer,7,6087,6080,105,98,415650,4.6242324561403505
ramipril,Periodontal Diseases,1,6087,6086,6,5,415743,11.551895059699858
ramipril,Periodontitis,5,6087,6082,52,47,415701,6.6682107353350375
ramipril,Peripheral Ischemia,1,6087,6086,13,12,415736,5.331555398265881
ramipril,Physical product label issue,1,6087,6086,19,18,415730,3.6478544372762336
ramipril,Plague,2,6087,6085,19,17,415731,7.296907840678112
ramipril,Pleural effusion (disorder),4,6087,6083,20,16,415732,13.868650337004768
ramipril,"Pneumonia, Viral",1,6087,6086,12,11,415737,5.775865374082594
ramipril,Polydipsia,18,6087,6069,152,134,415614,8.228068007388714
ramipril,Polyneuropathy,6,6087,6081,52,46,415702,8.003168760198854
ramipril,Polyp of vagina,1,6087,6086,15,14,415734,4.620659436959142
ramipril,Polyp of vocal cord,1,6087,6086,15,14,415734,4.620659436959142
ramipril,Post inflammatory pigmentation change,1,6087,6086,6,5,415743,11.551895059699858
ramipril,Postural dizziness,2,6087,6085,36,34,415714,3.850990596183694
ramipril,Pregnancy associated hypertension,6,6087,6081,52,46,415702,8.003168760198854
ramipril,Premature Birth,4,6087,6083,61,57,415691,4.546656497683682
ramipril,Premature Cardiac Complex,1,6087,6086,14,13,415735,4.950718276137271
ramipril,Projectile vomiting,1,6087,6086,23,22,415726,3.013416394004772
ramipril,Prothrombin consumption time shortened,4,6087,6083,56,52,415696,4.952666682323102
ramipril,Pseudobulbar Palsy,1,6087,6086,7,6,415742,9.901600863809211
ramipril,Pseudodementia,2,6087,6085,7,5,415743,19.806456156825917
ramipril,Ptosis of eyebrow,1,6087,6086,13,12,415736,5.331555398265881
ramipril,Pulmonary Infarction,5,6087,6082,99,94,415654,3.5021042387040415
ramipril,Pulmonary arterial pressure increased,13,6087,6074,120,107,415641,7.521533036988257
ramipril,Pulmonary vasculitis,1,6087,6086,5,4,415744,13.862306933946764
ramipril,Pyloric Stenosis,5,6087,6082,28,23,415725,12.38452459247428
ramipril,Radiation exposure during pregnancy,6,6087,6081,64,58,415690,6.502389615194869
ramipril,Rales,21,6087,6066,375,354,415394,3.8908275634685134
ramipril,Rapid correction of hyponatraemia,1,6087,6086,19,18,415730,3.6478544372762336
ramipril,Rectal Carcinoma,1,6087,6086,5,4,415744,13.862306933946764
ramipril,Rectal pain,2,6087,6085,13,11,415737,10.664863156564062
ramipril,Recurrent Liver Carcinoma,5,6087,6082,6,1,415747,57.797462457524944
ramipril,Rehabilitation therapy,1,6087,6086,23,22,415726,3.013416394004772
ramipril,Renal Insufficiency,98,6087,5989,907,809,414939,7.594029701273357
ramipril,Renal tubular acidosis,1,6087,6086,23,22,415726,3.013416394004772
ramipril,Renal tubular disorder,1,6087,6086,19,18,415730,3.6478544372762336
ramipril,Renal tubular necrosis,4,6087,6083,46,42,415706,6.0294763024537374
ramipril,Renal vascular disorder,1,6087,6086,13,12,415736,5.331555398265881
ramipril,Respiratory Failure,3,6087,6084,45,42,415706,4.621849660311199
ramipril,Respiratory distress,5,6087,6082,99,94,415654,3.5021042387040415
ramipril,Respiratory fume inhalation disorder,1,6087,6086,5,4,415744,13.862306933946764
ramipril,Retinal Hemorrhage,2,6087,6085,33,31,415717,4.201110530116282
ramipril,Retinal Perforations,1,6087,6086,14,13,415735,4.950718276137271
ramipril,Retinal exudates,1,6087,6086,10,9,415739,6.931071311206048
ramipril,Rheumatic disorder,2,6087,6085,22,20,415728,6.30183013371181
ramipril,Rhinalgia,1,6087,6086,23,22,415726,3.013416394004772
ramipril,Rhonchi,1,6087,6086,10,9,415739,6.931071311206048
ramipril,Rosacea,6,6087,6081,107,101,415647,3.888883253645874
ramipril,Rupture of liver,2,6087,6085,19,17,415731,7.296907840678112
ramipril,Ruptured cyst of kidney,1,6087,6086,5,4,415744,13.862306933946764
ramipril,Sciatic Neuropathy,1,6087,6086,14,13,415735,4.950718276137271
ramipril,Sciatica,5,6087,6082,69,64,415684,5.025115689442356
ramipril,Second Primary Cancers,2,6087,6085,32,30,415718,4.332405505341002
ramipril,Short Bowel Syndrome,2,6087,6085,23,21,415727,6.027823228895002
ramipril,Sinusitis,1,6087,6086,14,13,415735,4.950718276137271
ramipril,Skin discomfort,1,6087,6086,16,15,415733,4.331857952678278
ramipril,Slow speech,1,6087,6086,7,6,415742,9.901600863809211
ramipril,Small kidney,1,6087,6086,23,22,415726,3.013416394004772
ramipril,Snoring,1,6087,6086,15,14,415734,4.620659436959142
ramipril,Speech Disorders,1,6087,6086,15,14,415734,4.620659436959142
ramipril,Stage II Rectal Cancer,1,6087,6086,7,6,415742,9.901600863809211
ramipril,Staphylococcal sepsis,10,6087,6077,146,136,415612,4.752807013193695
ramipril,Stoma site haemorrhage,1,6087,6086,14,13,415735,4.950718276137271
ramipril,Subacute thyroiditis,1,6087,6086,13,12,415736,5.331555398265881
ramipril,Subclavian Steal Syndrome,2,6087,6085,7,5,415743,19.806456156825917
ramipril,Subileus,1,6087,6086,5,4,415744,13.862306933946764
ramipril,Suspected drug-induced liver injury,1,6087,6086,21,20,415728,3.3004240802466236
ramipril,Suture insertion,1,6087,6086,8,7,415741,8.663880216891226
ramipril,Swelling at injection site,2,6087,6085,40,38,415710,3.4658586688578477
ramipril,Swollen nasal mucosa (finding),4,6087,6083,40,36,415712,6.933996383363472
ramipril,Tachyarrhythmia,2,6087,6085,36,34,415714,3.850990596183694
ramipril,"Tachycardia, Paroxysmal",3,6087,6084,24,21,415727,8.666399572649572
ramipril,"Tachycardia, Ventricular",3,6087,6084,33,30,415718,6.302701571932341
ramipril,Teeth brittle,1,6087,6086,6,5,415743,11.551895059699858
ramipril,Telangiectasis,1,6087,6086,14,13,415735,4.950718276137271
ramipril,Tendon Injuries,1,6087,6086,19,18,415730,3.6478544372762336
ramipril,Tenotomy (procedure),1,6087,6086,5,4,415744,13.862306933946764
ramipril,Throat irritation,7,6087,6080,132,125,415623,3.678131230063796
ramipril,Thrombocytopenia,4,6087,6083,62,58,415690,4.47331272239398
ramipril,Tibial Fractures,2,6087,6085,22,20,415728,6.30183013371181
ramipril,Tobacco user,2,6087,6085,24,22,415726,5.776650232812928
ramipril,Tongue Diseases,37,6087,6050,428,391,415357,6.021494940912953
ramipril,Tonic-Clonic Epilepsy,1,6087,6086,7,6,415742,9.901600863809211
ramipril,Tonsillitis,1,6087,6086,7,6,415742,9.901600863809211
ramipril,Tooth Diseases,2,6087,6085,19,17,415731,7.296907840678112
ramipril,Toxic Shock Syndrome,1,6087,6086,11,10,415738,6.300958981865982
ramipril,Toxicoderma,12,6087,6075,191,179,415569,4.360612759356214
ramipril,Traffic accident on public road,2,6087,6085,31,29,415719,4.472171124128608
ramipril,Tubo-ovarian abscess,2,6087,6085,8,6,415742,17.33060805258833
ramipril,Tumor pain,3,6087,6084,13,10,415738,15.999924138977393
ramipril,Ulcerative esophagitis,1,6087,6086,6,5,415743,11.551895059699858
ramipril,Ureteral stent insertion,1,6087,6086,5,4,415744,13.862306933946764
ramipril,Urinary hesitation,1,6087,6086,8,7,415741,8.663880216891226
ramipril,Urine albumin/creatinine ratio increased,1,6087,6086,13,12,415736,5.331555398265881
ramipril,Urine screening abnormal,6,6087,6081,52,46,415702,8.003168760198854
ramipril,Vascular rupture,6,6087,6081,31,25,415723,13.4253385744068
ramipril,Vascular stenosis,1,6087,6086,18,17,415731,3.8505221455435055
ramipril,Venous Injury,2,6087,6085,22,20,415728,6.30183013371181
ramipril,Vestibular Diseases,3,6087,6084,15,12,415736,13.866535174227483
ramipril,Vitamin B1 increased,2,6087,6085,35,33,415715,3.9610282897053644
ramipril,Vitamin B6 decreased,1,6087,6086,8,7,415741,8.663880216891226
ramipril,Vulvovaginal rash,2,6087,6085,25,23,415725,5.545571076417421
ramipril,Waist circumference increased,1,6087,6086,16,15,415733,4.331857952678278
ramipril,Weight Gain,4,6087,6083,68,64,415684,4.078550637746468
ramipril,White blood cell count decreased,9,6087,6078,202,193,415555,3.0907582614135056
ramipril,Wide QRS complex,3,6087,6084,15,12,415736,13.866535174227483
ramipril,Wound hematoma,1,6087,6086,9,8,415740,7.701208602621682
ramipril,Wound infection bacterial,3,6087,6084,44,41,415707,4.7269029047875195
ramipril,Wrong technique in drug usage process,5,6087,6082,48,43,415705,7.223963471445797
ramipril,colonoscopy,1,6087,6086,7,6,415742,9.901600863809211
ramipril,effusion,1,6087,6086,5,4,415744,13.862306933946764
ramipril,hypoglycemic encephalopathy,1,6087,6086,14,13,415735,4.950718276137271
ramipril,leukemia,2,6087,6085,41,39,415709,3.381317514079003
ramipril,polyps,3,6087,6084,34,31,415717,6.1173134934447155
spironolactone,Abnormal coordination,1,1131,1130,102,101,420603,3.6589710220371336
spironolactone,Abscess,4,1131,1127,158,154,420550,9.472375411364327
spironolactone,Acidosis,3,1131,1128,157,154,420550,7.143210462122239
spironolactone,Altered visual depth perception,1,1131,1130,91,90,420614,4.1013711951765055
spironolactone,"Alzheimer Disease, Late Onset",2,1131,1129,80,78,420626,9.339127546501329
spironolactone,Anemia of renal disease,1,1131,1130,55,54,420650,6.786484312148029
spironolactone,Ankle deformity,1,1131,1130,67,66,420638,5.570836085061418
spironolactone,Aortic Injury,1,1131,1130,18,17,420687,20.73829891838741
spironolactone,Apathy,1,1131,1130,97,96,420608,3.847623392026275
spironolactone,Aplastic Anemia,3,1131,1128,178,175,420529,6.300158379153717
spironolactone,Application site bruise,1,1131,1130,44,43,420661,8.48332662912309
spironolactone,Arteritis,1,1131,1130,5,4,420700,74.66017699115045
spironolactone,Arthropod sting,1,1131,1130,34,33,420671,10.978682977615826
spironolactone,Atelectasis,5,1131,1126,423,418,420286,4.423827099840856
spironolactone,Atrial Septal Defects,1,1131,1130,53,52,420652,7.042611454332944
spironolactone,Atypical fracture of femur,1,1131,1130,41,40,420664,9.104122598748111
spironolactone,Bacterial gastroenteritis,1,1131,1130,58,57,420647,6.435413487946292
spironolactone,Bacterial osteomyelitis,1,1131,1130,38,37,420667,9.822938984629715
spironolactone,Bacterial test,1,1131,1130,42,41,420663,8.887336704593341
spironolactone,Blood pressure fluctuation,2,1131,1129,204,202,420502,3.6613261779468207
spironolactone,Blunted affect,1,1131,1130,102,101,420603,3.6589710220371336
spironolactone,Body weight problem,1,1131,1130,112,111,420593,3.3321981668773706
spironolactone,Bone marrow harvest failure,1,1131,1130,61,60,420644,6.118874220223415
spironolactone,Bowel movement irregularity,1,1131,1130,48,47,420657,7.776308997050147
spironolactone,Brain Stem Infarctions,1,1131,1130,5,4,420700,74.66017699115045
spironolactone,Breast Diseases,3,1131,1128,97,94,420610,11.563336257951304
spironolactone,"Bronchitis, Chronic",1,1131,1130,56,55,420649,6.665281289506952
spironolactone,Calcium deposits in tendon,2,1131,1129,65,63,420641,11.49471962935205
spironolactone,Cardiac Arrest,1,1131,1130,20,19,420685,18.664380530973453
spironolactone,Cardiovascular Diseases,3,1131,1128,246,243,420461,4.5579160179899665
spironolactone,Cataract,5,1131,1126,618,613,420091,3.0265581978191265
spironolactone,Central nervous system lesion,1,1131,1130,106,105,420599,3.5208632492903655
spironolactone,Cerebral Ischemia,3,1131,1128,183,180,420524,6.127950238344379
spironolactone,Cerebral Thrombosis,4,1131,1127,325,321,420383,4.603207972152071
spironolactone,Cerebrospinal fluid leak,1,1131,1130,70,69,420635,5.33204804045512
spironolactone,Cervical dysplasia,1,1131,1130,39,38,420666,9.57104606308146
spironolactone,Chest Pain,12,1131,1119,1357,1345,419359,3.3228794790590346
spironolactone,Chronic rejection of renal transplant,1,1131,1130,53,52,420652,7.042611454332944
spironolactone,Cold Sensation,1,1131,1130,92,91,420613,4.056781454405541
spironolactone,Cold sweat,3,1131,1128,305,302,420402,3.6757063132193935
spironolactone,"Colitis, Ischemic",2,1131,1129,51,49,420655,14.650619149342642
spironolactone,Colonic Pseudo-Obstruction,1,1131,1130,15,14,420690,24.886135693215337
spironolactone,Colour blindness (incl acquired),2,1131,1129,26,24,420680,28.739456292157797
spironolactone,Colposcopy,1,1131,1130,5,4,420700,74.66017699115045
spironolactone,Congenital heart valve incompetence,1,1131,1130,9,8,420696,41.47748279252704
spironolactone,Constipation,2,1131,1129,178,176,420528,4.196385386291936
spironolactone,Craniocerebral Trauma,6,1131,1125,305,299,420405,7.371016393442624
spironolactone,Crushing injury,3,1131,1128,253,250,420454,4.431734084601799
spironolactone,Crystal Arthropathies,1,1131,1130,9,8,420696,41.47748279252704
spironolactone,Cystopexy,1,1131,1130,6,5,420699,62.21666666666667
spironolactone,Cytology abnormal,1,1131,1130,92,91,420613,4.056781454405541
spironolactone,Cytomegalovirus enterocolitis,2,1131,1129,7,5,420699,106.75136024294571
spironolactone,Death (finding),1,1131,1130,69,68,420636,5.409336924458125
spironolactone,Decreased mean corpuscular volume,2,1131,1129,74,72,420632,10.096497737773204
spironolactone,Device related sepsis,2,1131,1129,31,29,420675,24.1037743935541
spironolactone,Diabetic Ketoacidosis,1,1131,1130,19,18,420686,19.646762925011643
spironolactone,Difficulty driving a car,1,1131,1130,51,50,420654,7.318826999826479
spironolactone,Diffuse Large B-Cell Lymphoma,1,1131,1130,58,57,420647,6.435413487946292
spironolactone,Discoloration of skin,1,1131,1130,86,85,420619,4.339874459765384
spironolactone,Discomfort,1,1131,1130,53,52,420652,7.042611454332944
spironolactone,Disease Exacerbation,1,1131,1130,71,70,420634,5.256936308114172
spironolactone,Disease recurrence,1,1131,1130,59,58,420646,6.326323683815809
spironolactone,Disorder of vein,1,1131,1130,99,98,420606,3.7698757486368106
spironolactone,Disseminated Intravascular Coagulation,1,1131,1130,42,41,420663,8.887336704593341
spironolactone,Drooling,1,1131,1130,34,33,420671,10.978682977615826
spironolactone,Drug Allergy,2,1131,1129,223,221,420483,3.349223686980422
spironolactone,Drug action increased,1,1131,1130,52,51,420653,7.178063308373043
spironolactone,Dry Eye Syndromes,1,1131,1130,79,78,420626,4.724498711773272
spironolactone,Dwarfism,1,1131,1130,35,34,420670,10.664981036662452
spironolactone,Dyskinetic syndrome,2,1131,1129,218,216,420488,3.4260813742777976
spironolactone,Ecchymosis,1,1131,1130,56,55,420649,6.665281289506952
spironolactone,Eczematous dermatitis of eyelid,1,1131,1130,27,26,420678,13.825237627007539
spironolactone,Electric Countershock,1,1131,1130,124,123,420581,3.0096417356551526
spironolactone,Electrocardiogram ST-T segment elevation,1,1131,1130,29,28,420676,12.871711931644796
spironolactone,Electrolyte imbalance,2,1131,1129,19,17,420687,39.328329681599925
spironolactone,Electromechanical dissociation,1,1131,1130,117,116,420588,3.189758717192346
spironolactone,Erythrodermic psoriasis,1,1131,1130,94,93,420611,3.9704481265298432
spironolactone,Escherichia test positive,1,1131,1130,16,15,420689,23.330696902654868
spironolactone,Euphoric mood,3,1131,1128,131,128,420576,8.561474744193601
spironolactone,Extrapyramidal Disorders,1,1131,1130,13,12,420692,28.71490810074881
spironolactone,Extrinsic allergic alveolitis,2,1131,1129,166,164,420540,4.4998666054830485
spironolactone,"Fasciitis, Plantar",1,1131,1130,8,7,420697,46.66227876106195
spironolactone,Feeling despair,3,1131,1128,143,140,420564,7.842806130040174
spironolactone,Feeling intoxicated,1,1131,1130,101,100,420604,3.695207219837028
spironolactone,Feeling jittery,1,1131,1130,87,86,420618,4.289980673380124
spironolactone,Felty Syndrome,1,1131,1130,13,12,420692,28.71490810074881
spironolactone,Fever,1,1131,1130,32,31,420673,11.664905973451328
spironolactone,Fibromuscular dysplasia of wall of renal artery,1,1131,1130,89,88,420616,4.193556726658049
spironolactone,First degree atrioventricular block,1,1131,1130,23,22,420682,16.229780684878797
spironolactone,Fracture of acetabulum,1,1131,1130,8,7,420697,46.66227876106195
spironolactone,Fracture of foot,1,1131,1130,116,115,420589,3.2172642660970396
spironolactone,Fracture of patella,1,1131,1130,13,12,420692,28.71490810074881
spironolactone,"Fractures, Ununited",3,1131,1128,317,314,420390,3.5364621786697095
spironolactone,Gastric mucosa erythema,2,1131,1129,21,19,420685,35.58260576152516
spironolactone,Gastritis,3,1131,1128,202,199,420505,5.551308721297661
spironolactone,Gastrointestinal obstruction,2,1131,1129,26,24,420680,28.739456292157797
spironolactone,Gastrointestinal ulcer,1,1131,1130,120,119,420585,3.1099926253687316
spironolactone,Genital swelling,1,1131,1130,17,16,420688,21.95825091098386
spironolactone,Gout,1,1131,1130,113,112,420592,3.3027018560576398
spironolactone,"Graft Occlusion, Vascular",1,1131,1130,45,44,420660,8.29478859390364
spironolactone,Halitosis,4,1131,1127,277,273,420431,5.401490811361431
spironolactone,"Hallucinations, Auditory",1,1131,1130,116,115,420589,3.2172642660970396
spironolactone,Hay fever,1,1131,1130,22,21,420683,16.96753821399839
spironolactone,Helicobacter Infections,2,1131,1129,59,57,420647,12.663854318355826
spironolactone,Hemangioma,1,1131,1130,8,7,420697,46.66227876106195
spironolactone,Hematuria,5,1131,1126,418,413,420291,4.476796807941054
spironolactone,Hemorrhage of penis,1,1131,1130,75,74,420630,4.976519174041298
spironolactone,Hemorrhagic diarrhea,2,1131,1129,41,39,420665,18.22437296117868
spironolactone,Hepatitis,1,1131,1130,6,5,420699,62.21666666666667
spironolactone,"Hepatitis, Alcoholic",1,1131,1130,5,4,420700,74.66017699115045
spironolactone,"Hepatitis, Chronic",1,1131,1130,8,7,420697,46.66227876106195
spironolactone,Hiatal Hernia,2,1131,1129,46,44,420660,16.243270304617397
spironolactone,Hip Fractures,1,1131,1130,66,65,420639,5.6552561008313225
spironolactone,Hodgkin Disease,1,1131,1130,62,61,420643,6.020168427062517
spironolactone,Hypercalcemia,1,1131,1130,36,35,420669,10.3687069813176
spironolactone,Hypergammaglobulinemia,1,1131,1130,63,62,420642,5.924596151144823
spironolactone,Hyperphagia,1,1131,1130,11,10,420694,33.935961383748996
spironolactone,Hypertensive heart disease,1,1131,1130,122,121,420583,3.0589946322356014
spironolactone,Hypervolemia (finding),1,1131,1130,117,116,420588,3.189758717192346
spironolactone,Hypocalcemia,3,1131,1128,294,291,420413,3.813332247792734
spironolactone,Hypophosphatemia,1,1131,1130,20,19,420685,18.664380530973453
spironolactone,Hypothermia due to exposure,1,1131,1130,43,42,420662,8.68063387528298
spironolactone,Immunosuppression,3,1131,1128,242,239,420465,4.633297432741339
spironolactone,Incorrect storage of drug,1,1131,1130,108,107,420597,3.4556456899377253
spironolactone,Increased anteroposterior chest diameter,1,1131,1130,45,44,420660,8.29478859390364
spironolactone,Infection of kidney,1,1131,1130,63,62,420642,5.924596151144823
spironolactone,Infrequent bowel movements,1,1131,1130,6,5,420699,62.21666666666667
spironolactone,Injection site dermatitis,1,1131,1130,33,32,420672,11.311397157414856
spironolactone,Injection site mass,3,1131,1128,222,219,420485,5.050951217174622
spironolactone,Intentional overdose,1,1131,1130,36,35,420669,10.3687069813176
spironolactone,Internal Carotid Artery Stenosis,1,1131,1130,99,98,420606,3.7698757486368106
spironolactone,Intervertebral disc disorder,1,1131,1130,62,61,420643,6.020168427062517
spironolactone,Intraductal papilloma of breast,1,1131,1130,6,5,420699,62.21666666666667
spironolactone,Joint Range of Motion Decreased,1,1131,1130,104,103,420601,3.588589176310416
spironolactone,Keratitis,1,1131,1130,10,9,420695,37.32964601769912
spironolactone,Klebsiella bacteraemia,3,1131,1128,75,72,420632,14.956028368794328
spironolactone,Kyphoscoliosis deformity of spine,1,1131,1130,74,73,420631,5.04378139201148
spironolactone,Learning Disorders,1,1131,1130,52,51,420653,7.178063308373043
spironolactone,Lesion of liver,5,1131,1126,309,304,420400,6.057556892973954
spironolactone,Limb asymmetry,2,1131,1129,181,179,420525,4.126802675814415
spironolactone,Limb injury,1,1131,1130,80,79,420625,4.665431415929204
spironolactone,Liquid product physical issue,1,1131,1130,99,98,420606,3.7698757486368106
spironolactone,Liver enzymes abnormal,1,1131,1130,13,12,420692,28.71490810074881
spironolactone,Liver function tests abnormal,1,1131,1130,49,48,420656,7.6175907531154055
spironolactone,Localized Edema,1,1131,1130,65,64,420640,5.742273655547992
spironolactone,Locked-In Syndrome,1,1131,1130,14,13,420691,26.66378002528445
spironolactone,Loose tooth,1,1131,1130,41,40,420664,9.104122598748111
spironolactone,Lyme Disease,1,1131,1130,48,47,420657,7.776308997050147
spironolactone,Lymphedema,7,1131,1124,549,542,420162,4.778993187224913
spironolactone,Macromastia,1,1131,1130,6,5,420699,62.21666666666667
spironolactone,Macular degeneration,1,1131,1130,26,25,420679,14.3570115724983
spironolactone,Madarosis of eyelid,1,1131,1130,88,87,420617,4.2412208366854385
spironolactone,Magnesium Deficiency,1,1131,1130,59,58,420646,6.326323683815809
spironolactone,Malignant melanoma in situ,3,1131,1128,53,50,420654,21.165295062224008
spironolactone,Malignant neoplasm of colon stage IV,1,1131,1130,92,91,420613,4.056781454405541
spironolactone,Mass of skin,1,1131,1130,26,25,420679,14.3570115724983
spironolactone,Mediastinal Diseases,3,1131,1128,278,275,420429,4.032957676412062
spironolactone,Meningioma,1,1131,1130,123,122,420582,3.0341175624145627
spironolactone,"Meningitis, Bacterial",1,1131,1130,28,27,420677,13.331447534766118
spironolactone,Meningococcal meningitis,1,1131,1130,15,14,420690,24.886135693215337
spironolactone,Metabolic Syndrome X,1,1131,1130,31,30,420674,12.041221809877248
spironolactone,Metastatic malignant neoplasm to liver,1,1131,1130,88,87,420617,4.2412208366854385
spironolactone,Metrorrhagia,1,1131,1130,20,19,420685,18.664380530973453
spironolactone,Mitral Valve Prolapse Syndrome,1,1131,1130,78,77,420627,4.785080553664624
spironolactone,Moaning,2,1131,1129,182,180,420524,4.104118202435298
spironolactone,Mood swings,3,1131,1128,338,335,420369,3.3165759159007933
spironolactone,Muscle Rigidity,1,1131,1130,49,48,420656,7.6175907531154055
spironolactone,Muscular Atrophy,1,1131,1130,95,94,420610,3.9286446204005587
spironolactone,Myalgia,1,1131,1130,87,86,420618,4.289980673380124
spironolactone,Myasthenia Gravis,1,1131,1130,48,47,420657,7.776308997050147
spironolactone,Mycobacterial peritonitis,1,1131,1130,6,5,420699,62.21666666666667
spironolactone,Mydriasis,1,1131,1130,95,94,420610,3.9286446204005587
spironolactone,Myocardial Ischemia,2,1131,1129,208,206,420498,3.5908819922327453
spironolactone,Negative thoughts,1,1131,1130,8,7,420697,46.66227876106195
spironolactone,Nephrosclerosis,2,1131,1129,41,39,420665,18.22437296117868
spironolactone,Night sweats,1,1131,1130,10,9,420695,37.32964601769912
spironolactone,Nodule,1,1131,1130,95,94,420610,3.9286446204005587
spironolactone,Operative procedure on knee,1,1131,1130,85,84,420620,4.390942217595002
spironolactone,Orbital swelling,2,1131,1129,158,156,420548,4.727797647744727
spironolactone,Osteosclerosis,4,1131,1127,478,474,420230,3.12866015971606
spironolactone,Patient Non-Compliance,1,1131,1130,7,6,420698,53.32844500632111
spironolactone,Perforation of small intestine,3,1131,1128,127,124,420580,8.831211258167196
spironolactone,Peritoneal effluent abnormal,1,1131,1130,8,7,420697,46.66227876106195
spironolactone,Plasmacytoma,1,1131,1130,41,40,420664,9.104122598748111
spironolactone,Pleural Neoplasms,9,1131,1122,693,684,420020,4.874667222260805
spironolactone,Pneumonia,25,1131,1106,1348,1323,419381,7.05094883049565
spironolactone,"Pneumonia, Bacterial",1,1131,1130,79,78,420626,4.724498711773272
spironolactone,Pneumonitis,1,1131,1130,55,54,420650,6.786484312148029
spironolactone,Polymenorrhea,2,1131,1129,51,49,420655,14.650619149342642
spironolactone,Poor quality sleep,2,1131,1129,138,136,420568,5.413242448749053
spironolactone,Product deposit,1,1131,1130,87,86,420618,4.289980673380124
spironolactone,Product odour abnormal,1,1131,1130,43,42,420662,8.68063387528298
spironolactone,Product size issue,1,1131,1130,12,11,420693,31.107890855457228
spironolactone,Product taste abnormal,1,1131,1130,31,30,420674,12.041221809877248
spironolactone,Productive Cough,1,1131,1130,106,105,420599,3.5208632492903655
spironolactone,Prothrombin consumption time prolonged,1,1131,1130,13,12,420692,28.71490810074881
spironolactone,Pulmonary Infiltrate,1,1131,1130,78,77,420627,4.785080553664624
spironolactone,Radiculopathy,1,1131,1130,122,121,420583,3.0589946322356014
spironolactone,Reading disorder,1,1131,1130,78,77,420627,4.785080553664624
spironolactone,Red blood cells urine positive,1,1131,1130,33,32,420672,11.311397157414856
spironolactone,Refusal of treatment by relative,1,1131,1130,9,8,420696,41.47748279252704
spironolactone,Renal Insufficiency,20,1131,1111,907,887,419817,8.354423093908068
spironolactone,Renal function tests outside reference range,1,1131,1130,33,32,420672,11.311397157414856
spironolactone,Renal tubular necrosis,1,1131,1130,46,45,420659,8.114447864563294
spironolactone,Renin increased,1,1131,1130,5,4,420700,74.66017699115045
spironolactone,Resuscitation (procedure),1,1131,1130,7,6,420698,53.32844500632111
spironolactone,Rheumatoid Arthritis,1,1131,1130,47,46,420658,7.941781208811899
spironolactone,Rheumatoid factor increased,1,1131,1130,7,6,420698,53.32844500632111
spironolactone,Rib Fractures,1,1131,1130,108,107,420597,3.4556456899377253
spironolactone,Right Ventricular Dysfunction,1,1131,1130,79,78,420626,4.724498711773272
spironolactone,Salpingitis,2,1131,1129,76,74,420630,9.830753811011142
spironolactone,Sarcoidosis,1,1131,1130,57,56,420648,6.548331004502406
spironolactone,Sense of smell altered,1,1131,1130,71,70,420634,5.256936308114172
spironolactone,Skin Basal Cell Carcinoma,1,1131,1130,107,106,420598,3.487949714663799
spironolactone,Skin Wrinkling,1,1131,1130,81,80,420624,4.607822571834371
spironolactone,Skin odour abnormal,1,1131,1130,57,56,420648,6.548331004502406
spironolactone,Sluggishness,1,1131,1130,21,20,420684,17.775558364938895
spironolactone,Soft Tissue Injuries,1,1131,1130,7,6,420698,53.32844500632111
spironolactone,Spinal stenosis in cervical region,1,1131,1130,11,10,420694,33.935961383748996
spironolactone,Splenomegaly,2,1131,1129,90,88,420616,8.301249876980613
spironolactone,Squamous cell carcinoma,1,1131,1130,91,90,420614,4.1013711951765055
spironolactone,Staphylococcal Skin Infections,1,1131,1130,79,78,420626,4.724498711773272
spironolactone,Steroid withdrawal syndrome,1,1131,1130,25,24,420680,14.931327433628319
spironolactone,Swallowing painful,1,1131,1130,44,43,420661,8.48332662912309
spironolactone,Swelling of skeletal muscle,1,1131,1130,27,26,420678,13.825237627007539
spironolactone,Swollen nasal mucosa (finding),2,1131,1129,40,38,420666,18.680026572187778
spironolactone,Therapeutic product ineffective,1,1131,1130,57,56,420648,6.548331004502406
spironolactone,Throat irritation,4,1131,1127,132,128,420576,11.338845419590761
spironolactone,Thrombosis of jugular vein,2,1131,1129,191,189,420515,3.910646960892974
spironolactone,Thrombus of cardiac chamber,1,1131,1130,101,100,420604,3.695207219837028
spironolactone,Thyroxine level above reference range,2,1131,1129,161,159,420545,4.639669030472743
spironolactone,Tonsillectomy,1,1131,1130,104,103,420601,3.588589176310416
spironolactone,Tooth Fractures,1,1131,1130,98,97,420607,3.8083528986815964
spironolactone,Tuberculosis,1,1131,1130,37,36,420668,10.088447739775175
spironolactone,Tumor Progression,2,1131,1129,35,33,420671,21.348854865241048
spironolactone,Ultrasonography of kidney abnormal,1,1131,1130,62,61,420643,6.020168427062517
spironolactone,Underdose (unintentional),1,1131,1130,89,88,420616,4.193556726658049
spironolactone,VIIth nerve paralysis,1,1131,1130,88,87,420617,4.2412208366854385
spironolactone,Vaginal Diseases,1,1131,1130,20,19,420685,18.664380530973453
spironolactone,Vascular rupture,2,1131,1129,31,29,420675,24.1037743935541
spironolactone,Viral test positive,1,1131,1130,65,64,420640,5.742273655547992
spironolactone,Weight Gain,1,1131,1130,68,67,420637,5.4888990109318065
spironolactone,Wrong technique in drug usage process,1,1131,1130,48,47,420657,7.776308997050147
spironolactone,treatment failure,1,1131,1130,63,62,420642,5.924596151144823
spironolactone,upper airway cough syndrome,1,1131,1130,54,53,420651,6.912176335627663
telmisartan,5q-syndrome,3,381,378,7,4,421450,478.2630385487528
telmisartan,Acute pyelonephritis,1,381,380,133,132,421322,8.34392560348239
telmisartan,Acute tonsillitis,1,381,380,117,116,421338,9.485335132703554
telmisartan,Adverse reactions,3,381,378,284,281,421173,11.78043259557344
telmisartan,Age related macular degeneration,3,381,378,915,912,420542,3.6509671263769623
telmisartan,Altered bowel function,1,381,380,104,103,421351,10.67133097165992
telmisartan,Amnesia,1,381,380,212,211,421243,5.233651936444885
telmisartan,Anaphylactic shock,1,381,380,79,78,421376,14.049167221852098
telmisartan,Anemia,1,381,380,349,348,421106,3.178148092293772
telmisartan,"Anemia, Pernicious",1,381,380,91,90,421364,12.196182764603819
telmisartan,Anorectal cellulitis,2,381,379,32,30,421424,69.55854221635883
telmisartan,Anti-glomerular basement membrane antibody positive,1,381,380,329,328,421126,3.3715085586306195
telmisartan,Anticoagulation drug level below therapeutic,2,381,379,16,14,421440,139.12236147757255
telmisartan,Anuria,1,381,380,93,92,421362,11.933842671194114
telmisartan,Apallic syndrome,1,381,380,198,197,421257,5.603894205209995
telmisartan,Arteriovenous fistula,1,381,380,58,57,421397,19.136887477313973
telmisartan,Ascites,1,381,380,101,100,421354,10.988379364252216
telmisartan,Atrioventricular junctional rhythm,1,381,380,147,146,421308,7.549015395631937
telmisartan,Blood glucose decreased,1,381,380,17,16,421438,65.2969040247678
telmisartan,Blood glucose outside reference range,2,381,379,668,666,420788,3.327121482628411
telmisartan,Blood growth hormone abnormal,1,381,380,14,13,421441,79.28966165413533
telmisartan,Blood sodium decreased,1,381,380,335,334,421120,3.3110761979575805
telmisartan,Blood triglycerides abnormal,1,381,380,88,87,421367,12.612051435406698
telmisartan,Body weight problem,2,381,379,112,110,421344,19.870099886920467
telmisartan,Brain Concussion,2,381,379,163,161,421293,13.651423669003027
telmisartan,Brain Edema,1,381,380,79,78,421376,14.049167221852098
telmisartan,Brain Stem Infarctions,1,381,380,5,4,421450,222.01578947368424
telmisartan,Breast Cyst,2,381,379,68,66,421388,32.730637901598634
telmisartan,Bronchial Obstruction,1,381,380,137,136,421318,8.100230503265463
telmisartan,Burning Mouth Syndrome,1,381,380,25,24,421430,44.40105263157895
telmisartan,CD4 Lymphocytes Decreased,1,381,380,65,64,421390,17.07570850202429
telmisartan,Cardiac Arrhythmia,1,381,380,33,32,421422,33.63652312599681
telmisartan,Cardiomyopathies,2,381,379,32,30,421424,69.55854221635883
telmisartan,Catatonia,2,381,379,100,98,421356,22.25514511873351
telmisartan,Cerebral Thrombosis,1,381,380,325,324,421130,3.4130364372469635
telmisartan,Cervix carcinoma,1,381,380,124,123,421331,8.949724108658744
telmisartan,Chest discomfort,1,381,380,347,346,421108,3.1964811163355074
telmisartan,Cholelithiasis,1,381,380,153,152,421302,7.252872377020984
telmisartan,Chronic Liver Failure,1,381,380,209,208,421246,5.30881390078066
telmisartan,Chronic fibrous thyroiditis,1,381,380,240,239,421215,4.622752192982456
telmisartan,Chronic rejection of renal transplant,1,381,380,53,52,421402,20.94250248262165
telmisartan,Coital bleeding,1,381,380,9,8,421446,123.34093567251462
telmisartan,Cold Sensation,1,381,380,92,91,421363,12.063586956521739
telmisartan,Computerised tomogram thorax abnormal,1,381,380,22,21,421433,50.456100478468905
telmisartan,Constipation,1,381,380,178,177,421277,6.233840922531046
telmisartan,Creation of ileostomy,1,381,380,174,173,421281,6.377208106473079
telmisartan,Crushing injury,1,381,380,253,252,421202,4.385084252132307
telmisartan,Decreased mean corpuscular volume,1,381,380,74,73,421381,14.998613086770982
telmisartan,Dehydroepiandrosterone decreased,1,381,380,5,4,421450,222.01578947368424
telmisartan,Diffuse alopecia,1,381,380,8,7,421447,138.75888157894735
telmisartan,Dilatation of aorta,1,381,380,308,307,421147,3.6015635680109366
telmisartan,Discharge from eye,1,381,380,24,23,421431,46.251206140350874
telmisartan,Disorder of middle ear,1,381,380,18,17,421437,61.66915204678362
telmisartan,Disorder of vein,1,381,380,99,98,421356,11.21041998936736
telmisartan,Drug action prolonged,2,381,379,6,4,421450,371.0017590149516
telmisartan,Drug ineffective for unapproved indication,3,381,378,933,930,420524,3.580377345650658
telmisartan,Drug withdrawal syndrome,3,381,378,134,131,421323,24.97636815920398
telmisartan,Dystonia,1,381,380,11,10,421444,100.91483253588517
telmisartan,Edema of scrotum,2,381,379,268,266,421188,8.300850628125861
telmisartan,Edema of the tongue,1,381,380,24,23,421431,46.251206140350874
telmisartan,Emotional distress,2,381,379,483,481,420973,4.603506011788678
telmisartan,Eye pain,1,381,380,70,69,421385,15.855827067669173
telmisartan,Fatigue,3,381,378,534,531,420923,6.261533202544438
telmisartan,Feeding tube complication,1,381,380,7,6,421448,158.58195488721805
telmisartan,Fetal Growth Retardation,1,381,380,13,12,421442,85.38906882591094
telmisartan,Fever,1,381,380,32,31,421423,34.68774671052631
telmisartan,Fibrosis of the skin,1,381,380,190,189,421265,5.839958448753463
telmisartan,"Fractures, Ununited",1,381,380,317,316,421138,3.499236260999502
telmisartan,Free thyroxine concentration decreased below normal,1,381,380,11,10,421444,100.91483253588517
telmisartan,Gastric infection,2,381,379,42,40,421414,52.995728106546046
telmisartan,Gastroenteritis,1,381,380,245,244,421210,4.528356605800216
telmisartan,Gastrointestinal angiodysplasia,1,381,380,83,82,421372,13.371972098922004
telmisartan,General physical condition abnormal,1,381,380,78,77,421377,14.229318488529016
telmisartan,Genital hemorrhage,1,381,380,65,64,421390,17.07570850202429
telmisartan,Grip strength decreased,1,381,380,179,178,421276,6.199000294031167
telmisartan,"Hallucinations, Auditory",1,381,380,116,115,421339,9.567127949183302
telmisartan,Hepatitis B,2,381,379,408,406,421048,5.450708779554038
telmisartan,Hyperesthesia,1,381,380,42,41,421413,26.4281328320802
telmisartan,Hyperlipidemia,3,381,378,159,156,421298,21.048018368773082
telmisartan,Hypocholesterolemia,1,381,380,8,7,421447,138.75888157894735
telmisartan,Hypoxia,1,381,380,324,323,421131,3.4235786224821307
telmisartan,Ileus,2,381,379,198,196,421258,11.237360411502893
telmisartan,Impacted cerumen,1,381,380,134,133,421321,8.281637863315003
telmisartan,Incorrect storage of drug,1,381,380,108,107,421347,10.275999025341129
telmisartan,Increased upper airway secretion,2,381,379,352,350,421104,6.318706524346366
telmisartan,Infected ulcer of skin,1,381,380,83,82,421372,13.371972098922004
telmisartan,Infective vaginitis,4,381,377,115,111,421343,38.90854572713643
telmisartan,Injection site macule,1,381,380,31,30,421424,35.80679117147708
telmisartan,Insulin Resistance,1,381,380,205,204,421250,5.4124518613607195
telmisartan,Klebsiella test positive,1,381,380,32,31,421423,34.68774671052631
telmisartan,Large intestine perforation,1,381,380,78,77,421377,14.229318488529016
telmisartan,Laryngitis,1,381,380,221,220,421234,5.020409621338414
telmisartan,"Leishmaniasis, Visceral",1,381,380,84,83,421371,13.212750626566416
telmisartan,Leriche Syndrome,1,381,380,106,105,421349,10.46993545183714
telmisartan,Leukocytoclastic vasculitis,1,381,380,122,121,421333,9.096484037963762
telmisartan,Liver Failure,2,381,379,606,604,420850,3.6680599458362724
telmisartan,Localized swelling,1,381,380,131,130,421324,8.471353957412616
telmisartan,Lymphocyte count decreased,1,381,380,148,147,421307,7.4979907539118065
telmisartan,Lymphoma,1,381,380,255,254,421200,4.3506707946336425
telmisartan,Macular Holes,1,381,380,267,266,421188,4.155016755371575
telmisartan,Malignant Hypertension,1,381,380,140,139,421315,7.926597744360903
telmisartan,Mammary Neoplasms,1,381,380,20,19,421435,55.501973684210526
telmisartan,Mastication disorder,1,381,380,165,164,421290,6.725199362041467
telmisartan,Mean cell haemoglobin increased,1,381,380,159,158,421296,6.979079774908971
telmisartan,Meniere Disease,1,381,380,6,5,421449,185.0127192982456
telmisartan,Menopausal symptom,1,381,380,68,67,421387,16.322252321981424
telmisartan,Mucosal ulcer,1,381,380,206,205,421249,5.386165048543689
telmisartan,Myeloproliferative disease,1,381,380,58,57,421397,19.136887477313973
telmisartan,Myopathy,1,381,380,55,54,421400,20.180861244019138
telmisartan,Necrosis of gastrointestinal tract,4,381,377,398,394,421060,11.23487463844421
telmisartan,Neurologic Deficits,2,381,379,537,535,420919,4.1400529669865325
telmisartan,Neutralising antibodies positive,2,381,379,10,8,421446,222.59894459102904
telmisartan,Nocturnal dyspnea,2,381,379,7,5,421449,318.0007538635507
telmisartan,Nutritional condition abnormal,1,381,380,160,159,421295,6.935444078947369
telmisartan,Nystagmus,1,381,380,164,163,421291,6.766222721437741
telmisartan,Occupational exposure to communicable disease,1,381,380,36,35,421419,30.833260233918125
telmisartan,Pancreatic Insufficiency,1,381,380,32,31,421423,34.68774671052631
telmisartan,Parathyroid Diseases,1,381,380,52,51,421403,21.34529352226721
telmisartan,Perforation of nasal septum,1,381,380,186,185,421269,5.965605546123373
telmisartan,Peripheral Nervous System Diseases,1,381,380,356,355,421099,3.115604671791839
telmisartan,Peripheral artery thrombosis,1,381,380,274,273,421181,4.048799462159047
telmisartan,Platelet Transfusion,1,381,380,8,7,421447,138.75888157894735
telmisartan,Pneumococcal sepsis,2,381,379,31,29,421425,71.8025363860754
telmisartan,Pneumonitis,1,381,380,55,54,421400,20.180861244019138
telmisartan,Poisoning,2,381,379,331,329,421125,6.71992602571563
telmisartan,Portal Hypertension,1,381,380,274,273,421181,4.048799462159047
telmisartan,Pregnancy,1,381,380,53,52,421402,20.94250248262165
telmisartan,Product counterfeit,1,381,380,125,124,421330,8.878105263157895
telmisartan,Product label issue,1,381,380,58,57,421397,19.136887477313973
telmisartan,Protein/Creatinine ratio in urine above normal,1,381,380,6,5,421449,185.0127192982456
telmisartan,Pseudo-Bartter syndrome,1,381,380,42,41,421413,26.4281328320802
telmisartan,Pulmonary Embolism,2,381,379,113,111,421343,19.694211595488827
telmisartan,Reduced mobility,1,381,380,70,69,421385,15.855827067669173
telmisartan,Renal Insufficiency,4,381,377,907,903,420551,4.924012762510272
telmisartan,Renal cyst,1,381,380,195,194,421260,5.6901484480431845
telmisartan,Retinal Perforations,1,381,380,14,13,421441,79.28966165413533
telmisartan,Sense of smell impaired,1,381,380,23,22,421432,48.26224256292906
telmisartan,Sensory neuropathy,1,381,380,35,34,421420,31.71428571428571
telmisartan,"Shock, Cardiogenic",2,381,379,96,94,421360,23.182662708883026
telmisartan,Sjogren-Larsson Syndrome,1,381,380,79,78,421376,14.049167221852098
telmisartan,Skin tightness,2,381,379,174,172,421282,12.78806902617293
telmisartan,Small bowel angioedema,1,381,380,21,20,421434,52.85889724310776
telmisartan,Stomatitis,1,381,380,175,174,421280,6.340751879699249
telmisartan,Subarachnoid Hemorrhage,1,381,380,15,14,421440,74.00350877192983
telmisartan,Sudden death,1,381,380,60,59,421395,18.498903508771928
telmisartan,Systemic candidiasis,1,381,380,64,63,421391,17.342557565789473
telmisartan,Testicular Hydrocele,1,381,380,10,9,421445,111.00657894736842
telmisartan,Thermal burn,1,381,380,174,173,421281,6.377208106473079
telmisartan,"Thrombocythemia, Essential",2,381,379,40,38,421416,55.6457783641161
telmisartan,Thyroxine level above reference range,1,381,380,161,160,421294,6.892350441320692
telmisartan,Traumatic skin ulcer,1,381,380,37,36,421418,29.999857752489334
telmisartan,Ultrafiltration failure,1,381,380,182,181,421273,6.096775592828225
telmisartan,Urinary Bladder Diseases,1,381,380,207,206,421248,5.360132214594457
telmisartan,Vascular occlusion,1,381,380,76,75,421379,14.603843490304708
telmisartan,Vasculitis,1,381,380,127,126,421328,8.738251139660173
telmisartan,Venous Thrombosis,1,381,380,231,230,421224,4.8029619503303715
telmisartan,Ventricular Dysfunction,1,381,380,121,120,421334,9.171683340582863
telmisartan,Visual Impairment,2,381,379,486,484,420970,4.575056733661249
telmisartan,Vitamin D Deficiency,1,381,380,189,188,421266,5.870871623503202
telmisartan,Weight Gain,1,381,380,68,67,421387,16.322252321981424
telmisartan,Wound of skin,2,381,379,156,154,421300,14.264224342060752
terazosin,Abdominal tenderness,1,2379,2378,24,23,419433,7.390857162881973
terazosin,Abnormality of body mass index,2,2379,2377,12,10,419446,29.57670733417473
terazosin,Acquired corneal dystrophy,5,2379,2374,10,5,419451,88.84267059814658
terazosin,Adenocarcinoma,1,2379,2378,19,18,419438,9.33593023770528
terazosin,Adenocarcinoma of lung (disorder),1,2379,2378,45,44,419412,3.9415942435286424
terazosin,Alanine aminotransferase decreased,2,2379,2377,10,8,419448,35.492217080353385
terazosin,Anal Ulcer,1,2379,2378,25,24,419432,7.095206055508831
terazosin,Anemia due to blood loss,1,2379,2378,12,11,419445,14.78213484721054
terazosin,Angina Pectoris,3,2379,2376,98,95,419361,5.433634817563389
terazosin,Angiofibroma,4,2379,2375,185,181,419275,3.838634423897582
terazosin,Ankylosing spondylitis,1,2379,2378,13,12,419444,13.645015203467684
terazosin,Antipsychotic drug level increased,14,2379,2365,293,279,419177,8.516675926660847
terazosin,"Anus, Imperforate",1,2379,2378,19,18,419438,9.33593023770528
terazosin,Aortic Injury,2,2379,2377,18,16,419440,19.71752442387697
terazosin,Aortitis,1,2379,2378,29,28,419428,6.116498941446014
terazosin,Application site dryness,1,2379,2378,21,20,419436,8.44675397492891
terazosin,Arterial Dissection,1,2379,2378,59,58,419398,3.0062009094667217
terazosin,"Arthritis, Gouty",2,2379,2377,44,42,419414,8.065762802615978
terazosin,Aseptic Meningitis,2,2379,2377,94,92,419364,3.775015888076334
terazosin,Atrioventricular junctional rhythm,8,2379,2371,147,139,419317,9.679041249566042
terazosin,Avulsion fracture,3,2379,2376,107,104,419352,4.97649391107335
terazosin,Bacillus test positive,1,2379,2378,27,26,419430,6.569604086845466
terazosin,Bacterial pyelonephritis,36,2379,2343,1344,1308,418148,4.807149716480702
terazosin,Bacteriuria,1,2379,2378,23,22,419434,7.712217062200607
terazosin,Biliuria,1,2379,2378,29,28,419428,6.116498941446014
terazosin,Bipolar Disorder,5,2379,2374,17,12,419444,52.259527231280046
terazosin,Blood electrolytes decreased,1,2379,2378,34,33,419423,5.216951961608865
terazosin,Blood potassium increased,2,2379,2377,46,44,419412,7.715040880905782
terazosin,Blood pressure inadequately controlled,21,2379,2358,692,671,418785,5.419996249393284
terazosin,Blood sodium decreased,6,2379,2373,335,329,419127,3.1813121497443255
terazosin,Blood urea increased,1,2379,2378,47,46,419410,3.7738489343807595
terazosin,Bone density abnormal,1,2379,2378,16,15,419441,11.086496005046257
terazosin,Bone necrosis,1,2379,2378,56,55,419401,3.1672699146942205
terazosin,Bone pain,3,2379,2376,154,151,419305,3.457308474353929
terazosin,Bradyarrhythmia (disorder),1,2379,2378,28,27,419429,6.3349603508350345
terazosin,Bradycardia,1,2379,2378,9,8,419448,19.709653303429587
terazosin,Brain natriuretic peptide increased,1,2379,2378,44,43,419413,4.0311854881871705
terazosin,Bronchopulmonary Dysplasia,1,2379,2378,7,6,419450,25.34110296767992
terazosin,Cachexia,2,2379,2377,38,36,419420,9.339437149879325
terazosin,Calcified lymph nodes,1,2379,2378,27,26,419430,6.569604086845466
terazosin,Calcium pyrophosphate deposition disease,1,2379,2378,43,42,419414,4.124943767480979
terazosin,Capillary Fragility,1,2379,2378,19,18,419438,9.33593023770528
terazosin,Carotid Atherosclerosis,1,2379,2378,26,25,419431,6.822297341010546
terazosin,Cartilage Diseases,1,2379,2378,31,30,419426,5.721858976098103
terazosin,Cataract,12,2379,2367,618,606,418850,3.4554165077255625
terazosin,Cellulitis of male external genital organ,1,2379,2378,14,13,419443,12.670341223116663
terazosin,Central nervous system lesion,2,2379,2377,106,104,419352,3.3475603464014414
terazosin,Cerebral cyst,1,2379,2378,52,51,419405,3.4109384097819757
terazosin,Cholangiocarcinoma,1,2379,2378,29,28,419428,6.116498941446014
terazosin,Clostridium difficile sepsis,2,2379,2377,51,49,419407,6.958581834079866
terazosin,Colostomy Procedure,1,2379,2378,17,16,419440,10.434324444664325
terazosin,Congenital tricuspid valve incompetence,1,2379,2378,19,18,419438,9.33593023770528
terazosin,Consciousness fluctuating,1,2379,2378,19,18,419438,9.33593023770528
terazosin,Contusions,13,2379,2366,677,664,418792,3.418101839076728
terazosin,Cryptococcal fungaemia,1,2379,2378,10,9,419447,17.73864592094197
terazosin,Cryptosporidiosis,11,2379,2368,388,377,419079,5.045709328852047
terazosin,Cytomegalovirus Infections,1,2379,2378,48,47,419409,3.69521832071769
terazosin,Decompression of median nerve,1,2379,2378,19,18,419438,9.33593023770528
terazosin,Decreased CD4:CD8 ratio,1,2379,2378,8,7,419449,22.173412531539107
terazosin,Decreased HDL cholesterol concentration,13,2379,2366,693,680,418776,3.3390577676291966
terazosin,Decreased thyroxine level,5,2379,2374,40,35,419421,22.209088037068238
terazosin,Delayed union of fracture,2,2379,2377,85,83,419373,4.174812541760499
terazosin,Dental Plaque,6,2379,2373,42,36,419420,25.392390584552402
terazosin,Dental surgical procedure,1,2379,2378,7,6,419450,25.34110296767992
terazosin,Dermabrasion,1,2379,2378,34,33,419423,5.216951961608865
terazosin,Diaphragmalgia,1,2379,2378,37,36,419420,4.793921760280045
terazosin,Dilatation of aorta,6,2379,2373,308,302,419154,3.460415059024414
terazosin,Disease Progression,1,2379,2378,47,46,419410,3.7738489343807595
terazosin,Disorder of tympanic membrane,1,2379,2378,37,36,419420,4.793921760280045
terazosin,Dissociation,4,2379,2375,221,217,419239,3.2130621576565854
terazosin,Drug dispensed to wrong patient,1,2379,2378,11,10,419446,16.126003517088463
terazosin,Drug effect delayed,2,2379,2377,66,64,419392,5.376894736171136
terazosin,Drug level increased,1,2379,2378,58,57,419399,3.05803920999971
terazosin,Duodenal Ulcer,2,2379,2377,70,68,419388,5.069595528577438
terazosin,Electromechanical dissociation,4,2379,2375,117,113,419343,6.0706144849302754
terazosin,Enterovesical Fistula,3,2379,2376,32,29,419427,16.643110795454547
terazosin,Eosinophilic gastroenteritis,1,2379,2378,33,32,419424,5.375054158065091
terazosin,Eosinophilic granulomatosis with polyangiitis,2,2379,2377,9,7,419449,39.43589024447249
terazosin,Erosion of bone,1,2379,2378,6,5,419451,29.564690215867675
terazosin,Erythema Multiforme,1,2379,2378,25,24,419432,7.095206055508831
terazosin,Erythrocyanosis,5,2379,2374,245,240,419216,3.624211268332101
terazosin,Exfoliative rash,5,2379,2374,277,272,419184,3.205286512428566
terazosin,Extravasation,2,2379,2377,19,17,419439,18.679715696477203
terazosin,Eye Hemorrhage,6,2379,2373,89,83,419373,11.981590647594425
terazosin,Facial swelling (finding),7,2379,2372,385,378,419078,3.2304921048597266
terazosin,Falls,2,2379,2377,72,70,419386,4.928750058430328
terazosin,Feeling jittery,2,2379,2377,87,85,419371,4.0788204971977615
terazosin,Feeling of body temperature change,1,2379,2378,8,7,419449,22.173412531539107
terazosin,Femoral Neck Fractures,3,2379,2376,137,134,419322,3.8864742313647422
terazosin,Fetal Death,1,2379,2378,8,7,419449,22.173412531539107
terazosin,Fibromyalgia,7,2379,2372,195,188,419268,6.381026505815713
terazosin,Folic Acid Deficiency,3,2379,2376,15,12,419444,35.50673400673401
terazosin,Fungemia,1,2379,2378,38,37,419419,4.667754858129344
terazosin,Gastroenterostomy,1,2379,2378,6,5,419451,29.564690215867675
terazosin,Gastrointestinal Hemorrhage,2,2379,2377,67,65,419391,5.296630017769797
terazosin,Gastrointestinal obstruction,1,2379,2378,26,25,419431,6.822297341010546
terazosin,Gastrointestinal tract mucosal discoloration,1,2379,2378,10,9,419447,17.73864592094197
terazosin,General physical condition abnormal,2,2379,2377,78,76,419380,4.549550715726568
terazosin,Glycosylated haemoglobin decreased,1,2379,2378,10,9,419447,17.73864592094197
terazosin,"Graft Occlusion, Vascular",2,2379,2377,45,43,419413,7.886504931519656
terazosin,Guillain-Barre Syndrome,7,2379,2372,242,235,419221,5.1411630872576755
terazosin,Heart murmur,11,2379,2368,626,615,418841,3.1256064620930832
terazosin,Helicobacter Infections,1,2379,2378,59,58,419398,3.0062009094667217
terazosin,Hemoglobin increased,4,2379,2375,91,87,419369,7.805556969346444
terazosin,Hemorrhage of sclera,5,2379,2374,12,7,419449,74.03520780679584
terazosin,Herpes zoster (disorder),5,2379,2374,31,26,419430,28.657499252656464
terazosin,Hospitalization,1,2379,2378,55,54,419402,3.2248642862604173
terazosin,Hyperproteinemia,1,2379,2378,18,17,419439,9.854616390991495
terazosin,Hypertensive Crisis,2,2379,2377,73,71,419385,4.861221408359794
terazosin,Hyperthyroidism,4,2379,2375,78,74,419382,9.106763832658569
terazosin,Idiopathic erosive/hemorrhagic gastritis,2,2379,2377,98,96,419360,3.620899264207155
terazosin,Immunosuppression,6,2379,2373,242,236,419220,4.404854196487342
terazosin,Impaired judgement,1,2379,2378,38,37,419419,4.667754858129344
terazosin,Impatience,2,2379,2377,13,11,419445,27.30151127795217
terazosin,Incision site erythema,2,2379,2377,35,33,419423,10.14003245387343
terazosin,Incorrect drug dosage form administered,1,2379,2378,28,27,419429,6.3349603508350345
terazosin,Increased fibrinolysis (finding),2,2379,2377,24,22,419434,14.787932968728088
terazosin,Infarction,1,2379,2378,54,53,419403,3.2845917826994357
terazosin,Infection causing abscess of colon,1,2379,2378,7,6,419450,25.34110296767992
terazosin,Infection of peripheral nerve,5,2379,2374,192,187,419269,4.625225972339231
terazosin,Infectious pleural effusion,1,2379,2378,15,14,419442,11.825623773479114
terazosin,Infective conjunctivitis,1,2379,2378,35,34,419422,5.067884176378709
terazosin,Infective pulmonary exacerbation of cystic fibrosis,1,2379,2378,5,4,419452,35.47771236333053
terazosin,Infective vaginitis,2,2379,2377,115,113,419343,3.085511514331181
terazosin,Injection site papule,3,2379,2376,122,119,419337,4.364474664679583
terazosin,Injury of mouth,1,2379,2378,21,20,419436,8.44675397492891
terazosin,Instillation site pruritus,1,2379,2378,10,9,419447,17.73864592094197
terazosin,Intentional self-injury,3,2379,2376,136,133,419323,3.9150605317884732
terazosin,Intercepted drug administration error,1,2379,2378,5,4,419452,35.47771236333053
terazosin,Iron deficiency,1,2379,2378,6,5,419451,29.564690215867675
terazosin,Ischaemic cerebral infarction,2,2379,2377,16,14,419442,22.18232015145141
terazosin,Itching of eye,3,2379,2376,73,70,419386,7.29490106544901
terazosin,"Kidney Failure, Acute",3,2379,2376,173,170,419286,3.0774654055000874
terazosin,"Leukemia, Myelocytic, Acute",1,2379,2378,48,47,419409,3.69521832071769
terazosin,Livedo Reticularis,5,2379,2374,67,62,419394,13.258308290057714
terazosin,Lumpectomy of breast,4,2379,2375,37,33,419423,19.199908961593174
terazosin,Lung consolidation,1,2379,2378,51,50,419406,3.477827800590379
terazosin,"Lymphoma, Non-Hodgkin",2,2379,2377,31,29,419427,11.448532305562718
terazosin,Lysis of adhesions of tendon,7,2379,2372,257,250,419206,4.840922959823098
terazosin,Macular rash,3,2379,2376,126,123,419333,4.225879830046496
terazosin,Malignant Bone Neoplasm,1,2379,2378,33,32,419424,5.375054158065091
terazosin,Manic,5,2379,2374,21,16,419440,42.304930396758536
terazosin,Mass of body structure,7,2379,2372,380,373,419083,3.273037410135794
terazosin,Melanocytic nevus,1,2379,2378,21,20,419436,8.44675397492891
terazosin,Melanosis,2,2379,2377,105,103,419353,3.3794498868121083
terazosin,Metastatic Renal Cell Carcinoma,2,2379,2377,62,60,419396,5.723845454422082
terazosin,Metastatic liver carcinoma,4,2379,2375,21,17,419439,33.829694235588974
terazosin,Micturition frequency decreased,2,2379,2377,11,9,419447,32.265575400619575
terazosin,Miliaria,1,2379,2378,27,26,419430,6.569604086845466
terazosin,Milk-Alkali Syndrome,1,2379,2378,29,28,419428,6.116498941446014
terazosin,Mitral Valve Insufficiency,3,2379,2376,84,81,419375,6.339451058201058
terazosin,Mixed Connective Tissue Disease,1,2379,2378,10,9,419447,17.73864592094197
terazosin,Moaning,4,2379,2375,182,178,419278,3.901936379410064
terazosin,Mucinous carcinoma of breast,1,2379,2378,6,5,419451,29.564690215867675
terazosin,Mucous membrane hyperplasia,1,2379,2378,11,10,419446,16.126003517088463
terazosin,Muscle hypotonia,17,2379,2362,324,307,419149,9.363386071648842
terazosin,Mydriasis,5,2379,2374,95,90,419366,9.349975613000487
terazosin,Nail Diseases,1,2379,2378,29,28,419428,6.116498941446014
terazosin,Nephrogenic Systemic Fibrosis,3,2379,2376,62,59,419397,8.589381720430106
terazosin,Nephrosclerosis,1,2379,2378,41,40,419416,4.3261810498676905
terazosin,Nerve Degeneration,1,2379,2378,9,8,419448,19.709653303429587
terazosin,Nicotine Dependence,1,2379,2378,20,19,419437,8.869112699747687
terazosin,Nikolsky sign,1,2379,2378,14,13,419443,12.670341223116663
terazosin,Nocturnal dyspnea,1,2379,2378,7,6,419450,25.34110296767992
terazosin,Nodule,2,2379,2377,95,93,419363,3.7352700219205985
terazosin,Obstruction of gallbladder,1,2379,2378,37,36,419420,4.793921760280045
terazosin,Occupational exposure to product,2,2379,2377,8,6,419450,44.36548169962138
terazosin,Ocular Hypotension,3,2379,2376,75,72,419384,7.1003367003367
terazosin,Oliguria,1,2379,2378,25,24,419432,7.095206055508831
terazosin,Operation on ligament,2,2379,2377,16,14,419442,22.18232015145141
terazosin,Oral administration complication,2,2379,2377,5,3,419453,70.98527555742534
terazosin,Oral pain,3,2379,2376,39,36,419420,13.655659155659157
terazosin,Osteonecrosis of Jaw,4,2379,2375,143,139,419317,4.96656017666544
terazosin,Osteoporosis,3,2379,2376,132,129,419327,4.033736991123355
terazosin,Otitis Externa,1,2379,2378,12,11,419445,14.78213484721054
terazosin,Ovarian enlargement,2,2379,2377,9,7,419449,39.43589024447249
terazosin,Pain in esophagus (finding),11,2379,2368,595,584,418872,3.288695207812855
terazosin,Pancreatic Ductal Adenocarcinoma,1,2379,2378,21,20,419436,8.44675397492891
terazosin,Paranasal Sinus Disorder,4,2379,2375,217,213,419243,3.2723201552267764
terazosin,Paranasal sinus haematoma,1,2379,2378,26,25,419431,6.822297341010546
terazosin,Paratyphoid Fever,1,2379,2378,11,10,419446,16.126003517088463
terazosin,Parkinsonian Disorders,5,2379,2374,79,74,419382,11.244068121954081
terazosin,Partial thromboplastin time increased (finding),1,2379,2378,15,14,419442,11.825623773479114
terazosin,Pathological fracture,1,2379,2378,13,12,419444,13.645015203467684
terazosin,Peptic Ulcer,2,2379,2377,105,103,419353,3.3794498868121083
terazosin,Perforation of small intestine,4,2379,2375,127,123,419333,5.592480729382512
terazosin,Perineal infection,2,2379,2377,13,11,419445,27.30151127795217
terazosin,Peripheral Nervous System Diseases,7,2379,2372,356,349,419107,3.493890567861
terazosin,Peritoneal cloudy effluent,1,2379,2378,13,12,419444,13.645015203467684
terazosin,Physical abuse,2,2379,2377,43,41,419415,8.25335824911213
terazosin,Piriformis Muscle Syndrome,4,2379,2375,6,2,419454,118.40814035087718
terazosin,Polymyositis,1,2379,2378,7,6,419450,25.34110296767992
terazosin,Poor peripheral circulation,5,2379,2374,102,97,419359,8.708166080248443
terazosin,Post procedural discharge,2,2379,2377,7,5,419451,50.70352785624136
terazosin,Precancerous skin lesion,1,2379,2378,6,5,419451,29.564690215867675
terazosin,Procedural complication,1,2379,2378,17,16,419440,10.434324444664325
terazosin,Procedural hypotension,2,2379,2377,47,45,419411,7.5508731728712215
terazosin,Product administration error,1,2379,2378,25,24,419432,7.095206055508831
terazosin,Product formulation issue,1,2379,2378,24,23,419433,7.390857162881973
terazosin,Prostate cancer stage I,1,2379,2378,7,6,419450,25.34110296767992
terazosin,Pulmonary arterial hypertension,1,2379,2378,21,20,419436,8.44675397492891
terazosin,Reflux laryngitis,1,2379,2378,16,15,419441,11.086496005046257
terazosin,Rehabilitation therapy,1,2379,2378,23,22,419434,7.712217062200607
terazosin,Removal of internal fixation device,1,2379,2378,13,12,419444,13.645015203467684
terazosin,Respiratory distress,7,2379,2372,99,92,419364,12.571550241027476
terazosin,Restrictive pulmonary disease,7,2379,2372,263,256,419200,4.73041632736809
terazosin,Retinal Hemorrhage,2,2379,2377,33,31,419425,10.754630869060824
terazosin,Retrograde ejaculation,1,2379,2378,27,26,419430,6.569604086845466
terazosin,Rheumatoid Arthritis,2,2379,2377,47,45,419411,7.5508731728712215
terazosin,Right bundle branch block,1,2379,2378,25,24,419432,7.095206055508831
terazosin,Saliva altered,1,2379,2378,49,48,419408,3.619797119857194
terazosin,Salpingitis,2,2379,2377,76,74,419382,4.669297876580386
terazosin,Second Primary Cancers,1,2379,2378,32,31,419425,5.543037741799831
terazosin,Second degree atrioventricular block,1,2379,2378,57,56,419400,3.111696398270698
terazosin,Secondary malignant neoplasm of lung,6,2379,2373,189,183,419273,5.6407868948956175
terazosin,Skin hemorrhages,5,2379,2374,106,101,419355,8.37947656212745
terazosin,Skin sensitisation,1,2379,2378,38,37,419419,4.667754858129344
terazosin,"Sleep disorder due to general medical condition, insomnia type",1,2379,2378,38,37,419419,4.667754858129344
terazosin,Spinal cord herniation,2,2379,2377,89,87,419369,3.987142701828856
terazosin,Spondylitis,2,2379,2377,72,70,419386,4.928750058430328
terazosin,Spondylolisthesis,1,2379,2378,29,28,419428,6.116498941446014
terazosin,Substance Withdrawal Syndrome,7,2379,2372,255,248,419208,4.878914128889329
terazosin,Suspected counterfeit product,1,2379,2378,52,51,419405,3.4109384097819757
terazosin,Swelling of breast,2,2379,2377,62,60,419396,5.723845454422082
terazosin,Swelling of skin,1,2379,2378,26,25,419431,6.822297341010546
terazosin,Tablet physical issue,1,2379,2378,13,12,419444,13.645015203467684
terazosin,Therapeutic product effect decreased,3,2379,2376,54,51,419405,9.862069771791992
terazosin,"Thrombocythemia, Essential",4,2379,2375,40,36,419420,17.75978947368421
terazosin,Thrombocytopenia,2,2379,2377,62,60,419396,5.723845454422082
terazosin,Tooth Extraction,3,2379,2376,68,65,419391,7.831383689839573
terazosin,Tooth Fractures,4,2379,2375,98,94,419362,7.247896885069817
terazosin,Toxic nodular goiter,1,2379,2378,28,27,419429,6.3349603508350345
terazosin,Trabeculectomy,1,2379,2378,15,14,419442,11.825623773479114
terazosin,Transaminases increased,5,2379,2374,18,13,419443,49.356103154544606
terazosin,Transitional cell cancer of the renal pelvis and ureter localised,2,2379,2377,10,8,419448,35.492217080353385
terazosin,Traumatic fracture,1,2379,2378,58,57,419399,3.05803920999971
terazosin,Trigger Finger Disorder,2,2379,2377,88,86,419370,4.032460702948714
terazosin,Tumour lysis syndrome (SMQ),3,2379,2376,176,173,419283,3.024987086776859
terazosin,Umbilical hernia,47,2379,2332,2763,2716,416740,3.056870716879321
terazosin,Urethritis,5,2379,2374,5,0,419456,177.68744734625105
terazosin,Urine potassium abnormal,1,2379,2378,6,5,419451,29.564690215867675
terazosin,Urogenital Diseases,73,2379,2306,3361,3288,416168,3.9415180971053867
terazosin,Urologic Diseases,3,2379,2376,96,93,419363,5.546861847643098
terazosin,Uterine Prolapse,2,2379,2377,21,19,419437,16.90061502093475
terazosin,Varicophlebitis,2,2379,2377,103,101,419355,3.4450866107641596
terazosin,Vascular Grafting (surgical procedure),1,2379,2378,38,37,419419,4.667754858129344
terazosin,Venous Thrombosis,8,2379,2371,231,223,419233,6.158162939267958
terazosin,Verbal repetition,5,2379,2374,35,30,419426,25.38211577807197
terazosin,Very low density lipoprotein increased,1,2379,2378,10,9,419447,17.73864592094197
terazosin,Vesicular eczema of hands and/or feet,1,2379,2378,24,23,419433,7.390857162881973
terazosin,Vitamin Deficiency,2,2379,2377,40,38,419418,8.872423222549433
terazosin,Vulvovaginal pruritus,1,2379,2378,22,21,419435,8.062791497820935
terazosin,Wound hematoma,1,2379,2378,9,8,419448,19.709653303429587
terazosin,leukemia,5,2379,2374,41,36,419420,21.667351593482238
terazosin,melanoma,4,2379,2375,194,190,419266,3.6604753119913185
terazosin,muscle injury,2,2379,2377,106,104,419352,3.3475603464014414
terazosin,nail avulsion injury,4,2379,2375,30,26,419430,23.680280701754384
terazosin,post laminectomy syndrome,2,2379,2377,105,103,419353,3.3794498868121083
valsartan,Abnormal systolic arterial pressure,1,1357,1356,16,15,420463,19.442247418879056
valsartan,Abnormal weight loss (finding),2,1357,1355,172,170,420308,3.618493091907663
valsartan,Acanthosis,1,1357,1356,6,5,420473,51.84722222222222
valsartan,Acquired phimosis,3,1357,1354,41,38,420440,22.793925856540692
valsartan,Actinomycosis,1,1357,1356,5,4,420474,62.21681415929204
valsartan,Acute tonsillitis,2,1357,1355,117,115,420363,5.320187971110481
valsartan,Addisonian crisis,1,1357,1356,37,36,420442,8.407039783145978
valsartan,"Alcoholic Intoxication, Chronic",1,1357,1356,14,13,420465,22.21981668773704
valsartan,Allergic oedema,1,1357,1356,7,6,420472,44.44037083860093
valsartan,Altered visual depth perception,1,1357,1356,91,90,420388,3.4178093293137546
valsartan,Amenorrhea,2,1357,1355,25,23,420455,24.903911439114392
valsartan,"Amputation of finger, except thumb (procedure)",2,1357,1355,42,40,420438,14.823159374450887
valsartan,Anaphylactic shock,1,1357,1356,79,78,420400,3.93708225981106
valsartan,Aortic Aneurysm,6,1357,1351,226,220,420258,8.285092000026202
valsartan,Aortic bypass,1,1357,1356,12,11,420467,25.923242379547688
valsartan,Appetite Disorders,1,1357,1356,79,78,420400,3.93708225981106
valsartan,Application site edema,1,1357,1356,11,10,420468,28.27996781979083
valsartan,Application site haemorrhage,1,1357,1356,24,23,420455,12.961252458210422
valsartan,Application site irritation,1,1357,1356,87,86,420392,3.5749838944834367
valsartan,Application site pain,1,1357,1356,36,35,420443,8.640589151098
valsartan,"Arthritis, Bacterial",1,1357,1356,6,5,420473,51.84722222222222
valsartan,Arthroplasty of the shoulder (procedure),1,1357,1356,15,14,420464,20.73844641101278
valsartan,Asthenopia,1,1357,1356,34,33,420445,9.148902481346521
valsartan,Bacterial test,1,1357,1356,42,41,420437,7.406113920494452
valsartan,Biliary sphincterotomy,1,1357,1356,7,6,420472,44.44037083860093
valsartan,Biliary tract infection,1,1357,1356,36,35,420443,8.640589151098
valsartan,Bilirubin conjugated increased,5,1357,1352,426,421,420057,3.6583691002027945
valsartan,Biopsy liver abnormal,1,1357,1356,8,7,420471,38.88523230088496
valsartan,Biopsy of bone,1,1357,1356,54,53,420425,5.760146946356385
valsartan,Blepharitis,1,1357,1356,58,57,420421,5.3628445732885766
valsartan,Blood Transfusion,1,1357,1356,30,29,420449,10.368854473942969
valsartan,Blood bicarbonate level above normal,1,1357,1356,44,43,420435,7.069438857602575
valsartan,Blood calcium increased,1,1357,1356,10,9,420469,31.108038348082598
valsartan,Blood electrolytes decreased,1,1357,1356,34,33,420445,9.148902481346521
valsartan,Blood magnesium decreased,1,1357,1356,37,36,420442,8.407039783145978
valsartan,Blood oestrogen increased,1,1357,1356,70,69,420409,4.443373367045933
valsartan,Blood thyroid stimulating hormone increased,1,1357,1356,27,26,420452,11.521031355839614
valsartan,Bone Diseases,1,1357,1356,36,35,420443,8.640589151098
valsartan,Bone fissure,1,1357,1356,34,33,420445,9.148902481346521
valsartan,Bowel movement irregularity,1,1357,1356,48,47,420431,6.480257497541789
valsartan,Brain Edema,1,1357,1356,79,78,420400,3.93708225981106
valsartan,Breakthrough Pain,1,1357,1356,82,81,420397,3.7930156845816247
valsartan,Bronchial Diseases,1,1357,1356,5,4,420474,62.21681415929204
valsartan,"Bronchitis, Chronic",1,1357,1356,56,55,420423,5.554401074589127
valsartan,Bronchospasm,1,1357,1356,13,12,420466,23.92909008395734
valsartan,Brucellosis,1,1357,1356,69,68,420410,4.507780770381771
valsartan,Calcification of breast,1,1357,1356,24,23,420455,12.961252458210422
valsartan,Candida test positive,1,1357,1356,15,14,420464,20.73844641101278
valsartan,Cardiac Arrhythmia,1,1357,1356,33,32,420446,9.426164297845714
valsartan,Cardiac Flutter,2,1357,1355,54,52,420426,11.528795954626212
valsartan,Cardiac Hypertrophy,1,1357,1356,92,91,420387,3.380651212004617
valsartan,Cardiac asthma,1,1357,1356,5,4,420474,62.21681415929204
valsartan,Cardiomyopathies,1,1357,1356,32,31,420447,9.720754977876105
valsartan,Cartilage Diseases,1,1357,1356,31,30,420448,10.03435150823104
valsartan,Catarrh,1,1357,1356,6,5,420473,51.84722222222222
valsartan,Central cyanosis,1,1357,1356,17,16,420462,18.298542425819885
valsartan,Cerebellar infarction,1,1357,1356,5,4,420474,62.21681415929204
valsartan,Cerebral circulatory failure,1,1357,1356,22,21,420457,14.139615178331992
valsartan,Cerebral disorder,2,1357,1355,9,7,420471,69.18015580155802
valsartan,Cerebral hypoperfusion,1,1357,1356,8,7,420471,38.88523230088496
valsartan,"Cholangitis, Sclerosing",1,1357,1356,8,7,420471,38.88523230088496
valsartan,Chronic fibrous thyroiditis,3,1357,1354,240,237,420241,3.8921251846381093
valsartan,Cold Sensation,1,1357,1356,92,91,420387,3.380651212004617
valsartan,Colectomy,1,1357,1356,45,44,420434,6.912323828253032
valsartan,Colonic Neoplasms,1,1357,1356,23,22,420456,13.524817237398999
valsartan,Congenital atresia of aorta,2,1357,1355,125,123,420355,4.97960147601476
valsartan,Congenital cystic kidney disease,1,1357,1356,55,54,420424,5.655403593456691
valsartan,Cortical cataract,2,1357,1355,108,106,420372,5.763659969933032
valsartan,Crushing injury,3,1357,1354,253,250,420228,3.692020714498397
valsartan,Cytokine Release Syndrome,1,1357,1356,8,7,420471,38.88523230088496
valsartan,Deafness Neurosensory,2,1357,1355,44,42,420436,14.149312311304932
valsartan,Decreased Libido,1,1357,1356,24,23,420455,12.961252458210422
valsartan,Decreased mean arterial pressure,1,1357,1356,17,16,420462,18.298542425819885
valsartan,Degenerative polyarthritis,1,1357,1356,28,27,420451,11.109539612305099
valsartan,Deglutition Disorders,2,1357,1355,144,142,420336,4.322375973759737
valsartan,Delayed Ejaculation,1,1357,1356,43,42,420436,7.233861562735817
valsartan,Dementia,4,1357,1353,114,110,420368,10.936606112472607
valsartan,Depressed Level of Consciousness,1,1357,1356,52,51,420427,5.981719423644202
valsartan,Dermatitis acneiform,2,1357,1355,16,14,420464,38.91319188191882
valsartan,Dermatomycoses,1,1357,1356,31,30,420448,10.03435150823104
valsartan,Diaphragmalgia,1,1357,1356,37,36,420442,8.407039783145978
valsartan,Differential white blood cell count abnormal,1,1357,1356,20,19,420459,15.553650442477876
valsartan,Difficulty weight-bearing,1,1357,1356,61,60,420418,5.099061850186179
valsartan,Disease Progression,2,1357,1355,47,45,420433,13.246070503258224
valsartan,Disease recurrence,1,1357,1356,59,58,420420,5.271936403179841
valsartan,Diseases of inner ear,1,1357,1356,18,17,420461,17.281915765322843
valsartan,Disorder of vein,2,1357,1355,99,97,420381,6.287763241268777
valsartan,Disturbance in thinking,2,1357,1355,113,111,420367,5.5085654573359895
valsartan,Down Syndrome,1,1357,1356,6,5,420473,51.84722222222222
valsartan,Drooling,1,1357,1356,34,33,420445,9.148902481346521
valsartan,Drug label confusion,1,1357,1356,39,38,420440,7.975871719234551
valsartan,Dysgraphia,3,1357,1354,248,245,420233,3.766501286510697
valsartan,Dyskinetic syndrome,4,1357,1353,218,214,420264,5.7177322565552595
valsartan,Eczema,1,1357,1356,64,63,420415,4.860008757374631
valsartan,Elective Surgical Procedures,1,1357,1356,65,64,420414,4.785228046289993
valsartan,Epilepsy,1,1357,1356,101,100,420378,3.07933934986419
valsartan,Erythema of skin of eyelid,1,1357,1356,9,8,420470,34.56456899377253
valsartan,Erythrodermic psoriasis,2,1357,1355,94,92,420386,6.6222972442490375
valsartan,Erythropenia,1,1357,1356,8,7,420471,38.88523230088496
valsartan,Esophageal carcinoma,1,1357,1356,79,78,420400,3.93708225981106
valsartan,Eye Hemorrhage,1,1357,1356,89,88,420390,3.494630605548374
valsartan,Factor V Leiden mutation,1,1357,1356,65,64,420414,4.785228046289993
valsartan,Fat redistribution,1,1357,1356,5,4,420474,62.21681415929204
valsartan,Femoral artery embolus,1,1357,1356,20,19,420459,15.553650442477876
valsartan,Flank Pain,1,1357,1356,70,69,420409,4.443373367045933
valsartan,Foetal monitoring abnormal,1,1357,1356,7,6,420472,44.44037083860093
valsartan,Foreign body sensation in eyes,2,1357,1355,118,116,420362,5.275089123772593
valsartan,Fracture of ilium,1,1357,1356,8,7,420471,38.88523230088496
valsartan,Fracture of sternum,1,1357,1356,54,53,420425,5.760146946356385
valsartan,Furred tongue,2,1357,1355,49,47,420431,12.705354318849311
valsartan,Gall Bladder Diseases,1,1357,1356,43,42,420436,7.233861562735817
valsartan,Gastric Obstruction,1,1357,1356,7,6,420472,44.44037083860093
valsartan,Gastrointestinal Pain,9,1357,1348,580,571,419907,4.849195487567789
valsartan,Gastrointestinal inflammation,1,1357,1356,89,88,420390,3.494630605548374
valsartan,Genital pain,1,1357,1356,11,10,420468,28.27996781979083
valsartan,Good neonatal condition at birth,1,1357,1356,21,20,420458,14.812965304115746
valsartan,Headache,2,1357,1355,204,202,420276,3.050654800665654
valsartan,Helicobacter Infections,1,1357,1356,59,58,420420,5.271936403179841
valsartan,"Hemianopsia, Homonymous",1,1357,1356,8,7,420471,38.88523230088496
valsartan,Hemiparesis,1,1357,1356,59,58,420420,5.271936403179841
valsartan,Hemoglobin increased,1,1357,1356,91,90,420388,3.4178093293137546
valsartan,Hemorrhoids,1,1357,1356,77,76,420402,4.039363291575682
valsartan,Hepatomegaly,1,1357,1356,67,66,420412,4.642363404217849
valsartan,Hospitalization,1,1357,1356,55,54,420424,5.655403593456691
valsartan,Hyperglycaemic hyperosmolar nonketotic syndrome,1,1357,1356,18,17,420461,17.281915765322843
valsartan,"Hyperparathyroidism, Primary",5,1357,1352,440,435,420043,3.5418487762237763
valsartan,Hypersensitivity,2,1357,1355,203,201,420277,3.0656899278352387
valsartan,Hyperthyroidism,1,1357,1356,78,77,420401,3.9875671280538536
valsartan,Hyperventilation,1,1357,1356,30,29,420449,10.368854473942969
valsartan,Hypoalbuminemia,1,1357,1356,5,4,420474,62.21681415929204
valsartan,Hypocalcemia,5,1357,1352,294,289,420189,5.302562593084572
valsartan,Hypophosphatemia,1,1357,1356,20,19,420459,15.553650442477876
valsartan,Hypoxia,5,1357,1352,324,319,420159,4.8112421469793265
valsartan,INR Increased,1,1357,1356,57,56,420422,5.456942503752005
valsartan,Icterus,1,1357,1356,71,70,420408,4.38078025676181
valsartan,Increased anteroposterior chest diameter,1,1357,1356,45,44,420434,6.912323828253032
valsartan,Increased upper airway secretion,4,1357,1353,352,348,420130,3.5399701001142243
valsartan,Infarction,1,1357,1356,54,53,420425,5.760146946356385
valsartan,Infectious Enterocolitis,7,1357,1350,650,643,419835,3.359880341880342
valsartan,Inflammatory disease of mucous membrane,2,1357,1355,140,138,420340,4.445914602003162
valsartan,Influenza due to Influenza A virus subtype H1N1,1,1357,1356,9,8,420470,34.56456899377253
valsartan,Infusion Site Extravasation,1,1357,1356,72,71,420407,4.319925843985578
valsartan,Injection site hypertrophy,1,1357,1356,46,45,420433,6.762039887136078
valsartan,Intraocular pressure test abnormal,1,1357,1356,24,23,420455,12.961252458210422
valsartan,"Kidney Failure, Acute",4,1357,1353,173,169,420309,7.205772656780692
valsartan,Labyrinthitis,1,1357,1356,91,90,420388,3.4178093293137546
valsartan,Lack of libido,1,1357,1356,41,40,420438,7.586768832290093
valsartan,"Leishmaniasis, Visceral",1,1357,1356,84,83,420395,3.7026882286838037
valsartan,Lesion of liver,4,1357,1353,309,305,420173,4.032998705979999
valsartan,"Leukemia, Myelocytic, Acute",1,1357,1356,48,47,420431,6.480257497541789
valsartan,Leukocyte Disorders,1,1357,1356,61,60,420418,5.099061850186179
valsartan,"Leukoencephalopathy, Progressive Multifocal",3,1357,1354,219,216,420262,4.265555128386718
valsartan,Ligament rupture,1,1357,1356,84,83,420395,3.7026882286838037
valsartan,Limb injury,1,1357,1356,80,79,420399,3.8878595132743365
valsartan,Liquid product physical issue,1,1357,1356,99,98,420380,3.141563123864009
valsartan,Liver Abscess,1,1357,1356,17,16,420462,18.298542425819885
valsartan,Liver damage,2,1357,1355,128,126,420352,4.862857472324723
valsartan,Liver function tests abnormal,1,1357,1356,49,48,420430,6.347992294262838
valsartan,Loss of job,1,1357,1356,77,76,420402,4.039363291575682
valsartan,Low turnover osteopathy,3,1357,1354,226,223,420255,4.133367537679246
valsartan,Lower respiratory tract infection,1,1357,1356,16,15,420463,19.442247418879056
valsartan,Lung Abscess,1,1357,1356,6,5,420473,51.84722222222222
valsartan,Lymph Node Tuberculosis,3,1357,1354,104,101,420377,8.984724747187819
valsartan,Lymphoma,3,1357,1354,255,252,420226,3.6630463115822396
valsartan,Lymphoproliferative Disorders,1,1357,1356,23,22,420456,13.524817237398999
valsartan,Malignant melanoma in situ,1,1357,1356,53,52,420426,5.868842878610786
valsartan,Malignant neoplasm of skin,1,1357,1356,19,18,420460,16.372302437509703
valsartan,Malignant neoplasm of tongue,1,1357,1356,54,53,420425,5.760146946356385
valsartan,Mantoux: positive,1,1357,1356,13,12,420466,23.92909008395734
valsartan,Mass of thyroid gland,1,1357,1356,19,18,420460,16.372302437509703
valsartan,Maternal exposure during pregnancy,4,1357,1353,288,284,420194,4.327287098628562
valsartan,Maternal hypertension affecting foetus,2,1357,1355,159,157,420321,3.9144654088050315
valsartan,Medical device complication,1,1357,1356,63,62,420416,4.937163459287353
valsartan,Meniscus injury,1,1357,1356,18,17,420461,17.281915765322843
valsartan,Menopause,1,1357,1356,36,35,420443,8.640589151098
valsartan,Menstruation Disturbances,1,1357,1356,10,9,420469,31.108038348082598
valsartan,Metastatic malignant neoplasm to liver,1,1357,1356,88,87,420391,3.5343506972378655
valsartan,Metastatic malignant neoplasm to pancreas,1,1357,1356,99,98,420380,3.141563123864009
valsartan,Migraine with Aura,1,1357,1356,9,8,420470,34.56456899377253
valsartan,Mixed Connective Tissue Disease,1,1357,1356,10,9,420469,31.108038348082598
valsartan,Mole excision,3,1357,1354,82,79,420399,11.395855099614511
valsartan,Motion Sickness,1,1357,1356,20,19,420459,15.553650442477876
valsartan,Mouth Diseases,2,1357,1355,116,114,420364,5.366064384781779
valsartan,Muscle Weakness,1,1357,1356,46,45,420433,6.762039887136078
valsartan,Musculoskeletal Deformity,1,1357,1356,45,44,420434,6.912323828253032
valsartan,Nasal congestion (finding),4,1357,1353,363,359,420119,3.4326086912259055
valsartan,Neonatal diarrhea,2,1357,1355,8,6,420472,77.82785977859778
valsartan,Nephrogenic Systemic Fibrosis,1,1357,1356,62,61,420417,5.016807022552098
valsartan,Nephroptosis,1,1357,1356,25,24,420454,12.442772861356932
valsartan,Nephrosclerosis,1,1357,1356,41,40,420438,7.586768832290093
valsartan,Nerve Root Compression,1,1357,1356,14,13,420465,22.21981668773704
valsartan,Neurodermatitis,1,1357,1356,69,68,420410,4.507780770381771
valsartan,Noncompliance with dietary regimen,1,1357,1356,6,5,420473,51.84722222222222
valsartan,Nuclear magnetic resonance imaging spinal abnormal,4,1357,1353,88,84,420394,14.168749580057785
valsartan,Nystagmus,2,1357,1355,164,162,420316,3.795076950769508
valsartan,Obsessive-Compulsive Disorder,1,1357,1356,86,85,420393,3.6165620498044864
valsartan,Oestradiol decreased,1,1357,1356,36,35,420443,8.640589151098
valsartan,Oral paresthesia,1,1357,1356,73,72,420406,4.260738675394998
valsartan,Osteogenesis Imperfecta,2,1357,1355,32,30,420448,19.455857933579335
valsartan,PO2 increased,1,1357,1356,27,26,420452,11.521031355839614
valsartan,Pain in urethra,1,1357,1356,6,5,420473,51.84722222222222
valsartan,"Pain, Procedural",1,1357,1356,42,41,420437,7.406113920494452
valsartan,Paranasal Sinus Disorder,7,1357,1350,217,210,420268,10.074504181600956
valsartan,Perforation of nasal septum,2,1357,1355,186,184,420294,3.346022298932667
valsartan,Perforation of small intestine,2,1357,1355,127,125,420353,4.901159310805706
valsartan,Performance status decreased,1,1357,1356,25,24,420454,12.442772861356932
valsartan,Peripheral demyelinating neuropathy,1,1357,1356,11,10,420468,28.27996781979083
valsartan,Placenta Disorders,1,1357,1356,6,5,420473,51.84722222222222
valsartan,Platelet aggregation inhibition,2,1357,1355,14,12,420466,44.47243015287295
valsartan,Pneumonitis,1,1357,1356,55,54,420424,5.655403593456691
valsartan,Polycystic Ovary Syndrome,1,1357,1356,31,30,420448,10.03435150823104
valsartan,Portal Hypertension,4,1357,1353,274,270,420208,4.548540415729306
valsartan,Positional Vertigo,1,1357,1356,99,98,420380,3.141563123864009
valsartan,Postoperative adhesion,1,1357,1356,55,54,420424,5.655403593456691
valsartan,Postural dizziness,1,1357,1356,36,35,420443,8.640589151098
valsartan,Procedural haemorrhage,2,1357,1355,6,4,420474,103.77097170971709
valsartan,Product label issue,1,1357,1356,58,57,420421,5.3628445732885766
valsartan,Prolonged PR interval,1,1357,1356,24,23,420455,12.961252458210422
valsartan,Prothrombin time ratio decreased,1,1357,1356,14,13,420465,22.21981668773704
valsartan,Pruritus,1,1357,1356,99,98,420380,3.141563123864009
valsartan,Pseudo-Bartter syndrome,1,1357,1356,42,41,420437,7.406113920494452
valsartan,Psychomotor Agitation,1,1357,1356,9,8,420470,34.56456899377253
valsartan,Pulmonary function challenge test abnormal,1,1357,1356,57,56,420422,5.456942503752005
valsartan,"Purpura, Thrombotic Thrombocytopenic",5,1357,1352,110,105,420373,14.178489779451318
valsartan,Raynaud Phenomenon,1,1357,1356,18,17,420461,17.281915765322843
valsartan,Rectal Carcinoma,1,1357,1356,5,4,420474,62.21681415929204
valsartan,Reflux gastritis,1,1357,1356,25,24,420454,12.442772861356932
valsartan,Renal Insufficiency,12,1357,1345,907,895,419583,4.140563891746556
valsartan,Renal Osteodystrophy,1,1357,1356,37,36,420442,8.407039783145978
valsartan,Renal cyst,2,1357,1355,195,193,420285,3.1915223767622294
valsartan,Renal tubular acidosis,1,1357,1356,23,22,420456,13.524817237398999
valsartan,Respiratory Depression,1,1357,1356,17,16,420462,18.298542425819885
valsartan,Respiratory Failure,1,1357,1356,45,44,420434,6.912323828253032
valsartan,Respiratory arrest,1,1357,1356,68,67,420411,4.5740825091098385
valsartan,Retinal infarction,1,1357,1356,8,7,420471,38.88523230088496
valsartan,Rhinalgia,1,1357,1356,23,22,420456,13.524817237398999
valsartan,Right Ventricular Dysfunction,1,1357,1356,79,78,420400,3.93708225981106
valsartan,Rotator cuff syndrome,2,1357,1355,188,186,420292,3.310410614744445
valsartan,Sarcoidosis,1,1357,1356,57,56,420422,5.456942503752005
valsartan,Sense of smell altered,1,1357,1356,71,70,420408,4.38078025676181
valsartan,Sense of smell impaired,1,1357,1356,23,22,420456,13.524817237398999
valsartan,Septic thrombophlebitis,4,1357,1353,128,124,420354,9.740091463414634
valsartan,"Shock, Cardiogenic",1,1357,1356,96,95,420383,3.2397600172074728
valsartan,Sialolithiasis,1,1357,1356,6,5,420473,51.84722222222222
valsartan,Sjogren-Larsson Syndrome,2,1357,1355,79,77,420401,7.879975711149516
valsartan,Skin Papilloma,1,1357,1356,23,22,420456,13.524817237398999
valsartan,Skin Wrinkling,1,1357,1356,81,80,420398,3.839852143195309
valsartan,Skin tag,2,1357,1355,110,108,420370,5.658839315665884
valsartan,Skin toxicity,1,1357,1356,34,33,420445,9.148902481346521
valsartan,Slow shallow breathing,1,1357,1356,42,41,420437,7.406113920494452
valsartan,Small bowel obstruction,1,1357,1356,13,12,420466,23.92909008395734
valsartan,Spinal Cord Ischemia,1,1357,1356,14,13,420465,22.21981668773704
valsartan,Spinal stenosis of lumbar region,1,1357,1356,9,8,420470,34.56456899377253
valsartan,Squamous cell carcinoma,1,1357,1356,91,90,420388,3.4178093293137546
valsartan,Standard chest X-ray abnormal,2,1357,1355,137,135,420343,4.54330271769871
valsartan,Staphylococcal Scalded Skin Syndrome,1,1357,1356,14,13,420465,22.21981668773704
valsartan,Staphylococcal Skin Infections,1,1357,1356,79,78,420400,3.93708225981106
valsartan,Stomatitis,2,1357,1355,175,173,420305,3.556436478650501
valsartan,Subarachnoid Hemorrhage,1,1357,1356,15,14,420464,20.73844641101278
valsartan,Suicide attempt,1,1357,1356,101,100,420378,3.07933934986419
valsartan,Swallowing painful,1,1357,1356,44,43,420435,7.069438857602575
valsartan,Swelling of scrotum,1,1357,1356,25,24,420454,12.442772861356932
valsartan,Testicular Hydrocele,1,1357,1356,10,9,420469,31.108038348082598
valsartan,Thoracic Procedure Postoperative Complication,1,1357,1356,77,76,420402,4.039363291575682
valsartan,Thrombophlebitis,1,1357,1356,11,10,420468,28.27996781979083
valsartan,Tobacco user,1,1357,1356,24,23,420455,12.961252458210422
valsartan,Tongue Diseases,7,1357,1350,428,421,420057,5.10531152647975
valsartan,Traumatic hemorrhage,1,1357,1356,5,4,420474,62.21681415929204
valsartan,Trigger Finger Disorder,1,1357,1356,88,87,420391,3.5343506972378655
valsartan,Ultrasonography of kidney abnormal,1,1357,1356,62,61,420417,5.016807022552098
valsartan,Upper gastrointestinal hemorrhage,1,1357,1356,5,4,420474,62.21681415929204
valsartan,Urine screening abnormal,1,1357,1356,52,51,420427,5.981719423644202
valsartan,Uterine Cancer,1,1357,1356,5,4,420474,62.21681415929204
valsartan,Uterine Prolapse,1,1357,1356,21,20,420458,14.812965304115746
valsartan,Vascular wall hypertrophy,1,1357,1356,76,75,420403,4.092522512032293
valsartan,Ventricular Fibrillation,1,1357,1356,6,5,420473,51.84722222222222
valsartan,Viral test positive,2,1357,1355,65,63,420415,9.577519159806984
valsartan,Vitamin D below reference range,1,1357,1356,57,56,420422,5.456942503752005
valsartan,Vulval intraepithelial neoplasia,1,1357,1356,9,8,420470,34.56456899377253
valsartan,Wound healing normal,1,1357,1356,36,35,420443,8.640589151098
valsartan,Wound hematoma,1,1357,1356,9,8,420470,34.56456899377253
verapamil,Abdominal discomfort,6,11160,11154,13,7,410668,17.454462697066248
verapamil,Abdominal symptom,1,11160,11159,9,8,410667,4.200157321942428
verapamil,Abnormal breath sounds,1,11160,11159,12,11,410664,3.1500955880156525
verapamil,Abnormal breathing,1,11160,11159,5,4,410671,7.56035487050811
verapamil,Abnormal urine,2,11160,11158,11,9,410666,6.873568088122668
verapamil,Abnormality of body mass index,5,11160,11155,12,7,410668,15.756125803077843
verapamil,Absence Epilepsy,1,11160,11159,6,5,410670,6.30028078979598
verapamil,Absence of sensation,5,11160,11155,37,32,410643,5.109791997286395
verapamil,Absolute neutrophil count abnormal,3,11160,11157,14,11,410664,8.101659432259055
verapamil,Acne,3,11160,11157,11,8,410667,10.31127624728055
verapamil,Actinomycosis,2,11160,11158,5,3,410672,15.12206488618032
verapamil,Adenocarcinoma Of Esophagus,2,11160,11158,24,22,410653,3.150288283443867
verapamil,"Adenocarcinoma of lung, stage I",1,11160,11159,5,4,410671,7.56035487050811
verapamil,"Adenocarcinoma of lung, stage II",2,11160,11158,14,12,410663,5.4006222313266585
verapamil,"Adrenal hyperplasia, congenital, type 5",2,11160,11158,10,8,410667,7.560942821294139
verapamil,Adverse reactions,25,11160,11135,284,259,410416,3.3325875775533307
verapamil,Agitation,2,11160,11158,8,6,410669,9.451223337515684
verapamil,Allergic respiratory symptom,2,11160,11158,24,22,410653,3.150288283443867
verapamil,Allergy to chemicals,3,11160,11157,20,17,410658,5.671080935735413
verapamil,Amputation,2,11160,11158,24,22,410653,3.150288283443867
verapamil,Anaemia of malignant disease,1,11160,11159,9,8,410667,4.200157321942428
verapamil,Analgesic drug level increased,2,11160,11158,13,11,410664,5.8160684986280975
verapamil,Anemia,28,11160,11132,349,321,410354,3.0376837676972452
verapamil,Anti-DNA antibodies positive,1,11160,11159,5,4,410671,7.56035487050811
verapamil,Antisocial behavior,2,11160,11158,8,6,410669,9.451223337515684
verapamil,Aortic Aneurysm,18,11160,11142,226,208,410467,3.013774715141464
verapamil,Aortitis,3,11160,11157,29,26,410649,3.911006852045878
verapamil,Application site hypersensitivity,1,11160,11159,5,4,410671,7.56035487050811
verapamil,Arrested labor,2,11160,11158,23,21,410654,3.287265132445428
verapamil,Arterial Stiffness,2,11160,11158,5,3,410672,15.12206488618032
verapamil,Arterial thrombosis,7,11160,11153,35,28,410647,7.563884156729132
verapamil,Arteriosclerosis,4,11160,11156,10,6,410669,15.124596629616352
verapamil,Arthropod sting,4,11160,11156,34,30,410645,4.448157678273891
verapamil,Arthroscopic Surgical Procedures,3,11160,11157,12,9,410666,9.451980819216635
verapamil,Atrophic,1,11160,11159,7,6,410669,5.4002278750016
verapamil,Autoimmune myocarditis,2,11160,11158,12,10,410665,6.3007558104797745
verapamil,Autoimmune thyroiditis,1,11160,11159,10,9,410666,3.7801326283717183
verapamil,Back disorder,1,11160,11159,6,5,410670,6.30028078979598
verapamil,Bacterial genital infection,7,11160,11153,21,14,410661,12.606892017095548
verapamil,Benign neoplasm of adrenal gland,1,11160,11159,9,8,410667,4.200157321942428
verapamil,Biliary tract infection,5,11160,11155,36,31,410644,5.251743114696947
verapamil,Biopsy of thyroid (procedure),1,11160,11159,10,9,410666,3.7801326283717183
verapamil,Bipolar Disorder,2,11160,11158,17,15,410660,4.447539618105711
verapamil,Bladder prolapse,1,11160,11159,7,6,410669,5.4002278750016
verapamil,Bleeding ulcer of esophagus,3,11160,11157,5,2,410673,22.685130411400912
verapamil,Blood cholesterol abnormal,4,11160,11156,37,33,410642,4.08746717316097
verapamil,Blood immunoglobulin E increased,1,11160,11159,9,8,410667,4.200157321942428
verapamil,Blood phosphorus abnormal,4,11160,11156,5,1,410674,30.249551810684835
verapamil,Blood potassium increased,4,11160,11156,46,42,410633,3.2876751835627545
verapamil,Blood urea nitrogen measurement,1,11160,11159,9,8,410667,4.200157321942428
verapamil,Body fat disorder,1,11160,11159,5,4,410671,7.56035487050811
verapamil,Body temperature measurement,18,11160,11142,173,155,410520,3.9375647837739414
verapamil,Bone Marrow Diseases,3,11160,11157,12,9,410666,9.451980819216635
verapamil,Bone Transplantation,9,11160,11151,31,22,410653,10.981905282616054
verapamil,Brain stem herniation,1,11160,11159,11,10,410665,3.436476060904773
verapamil,Bronchioloalveolar Adenocarcinoma,1,11160,11159,5,4,410671,7.56035487050811
verapamil,Bronchopulmonary Dysplasia,1,11160,11159,7,6,410669,5.4002278750016
verapamil,Bulla,1,11160,11159,12,11,410664,3.1500955880156525
verapamil,Bundle-Branch Block,2,11160,11158,23,21,410654,3.287265132445428
verapamil,Burning Mouth Syndrome,2,11160,11158,25,23,410652,3.0242695823624306
verapamil,Calcified lymph nodes,6,11160,11154,27,21,410654,8.403721634490864
verapamil,Candida sepsis,1,11160,11159,11,10,410665,3.436476060904773
verapamil,Candidal balanitis,1,11160,11159,8,7,410668,4.7251881889058165
verapamil,Cardiac Arrest,2,11160,11158,20,18,410657,3.780381788851049
verapamil,Cardiac Death,1,11160,11159,5,4,410671,7.56035487050811
verapamil,Cardiac ventricular thrombosis,1,11160,11159,6,5,410670,6.30028078979598
verapamil,Carotid artery occlusion,1,11160,11159,7,6,410669,5.4002278750016
verapamil,Carpal Tunnel Syndrome,5,11160,11155,55,50,410625,3.437349741249338
verapamil,Cataplexy,2,11160,11158,17,15,410660,4.447539618105711
verapamil,Cerebellar stroke,1,11160,11159,5,4,410671,7.56035487050811
verapamil,Cerebral arterial thrombosis,2,11160,11158,10,8,410667,7.560942821294139
verapamil,Cerebral disorder,1,11160,11159,9,8,410667,4.200157321942428
verapamil,Cerebrospinal fluid leak,11,11160,11149,70,59,410616,5.94469074740848
verapamil,Cervico-occipital neuralgia,1,11160,11159,8,7,410668,4.7251881889058165
verapamil,Cesarean section,2,11160,11158,13,11,410664,5.8160684986280975
verapamil,Chagas Disease,3,11160,11157,7,4,410671,16.203587754004534
verapamil,"Cholangitis, Sclerosing",1,11160,11159,8,7,410668,4.7251881889058165
verapamil,Cholecystitis,2,11160,11158,10,8,410667,7.560942821294139
verapamil,Cholestasis,7,11160,11153,72,65,410610,3.6765655976966833
verapamil,Chondromalacia,1,11160,11159,5,4,410671,7.56035487050811
verapamil,Chylothorax,1,11160,11159,9,8,410667,4.200157321942428
verapamil,Circumstance or information capable of leading to medication error,1,11160,11159,12,11,410664,3.1500955880156525
verapamil,Colectomy,6,11160,11154,45,39,410636,5.042017811248581
verapamil,Comatose,1,11160,11159,5,4,410671,7.56035487050811
verapamil,Congenital cystic kidney disease,5,11160,11155,55,50,410625,3.437349741249338
verapamil,Conjunctival Diseases,9,11160,11151,10,1,410674,34.045601291364
verapamil,Contrast media allergy,12,11160,11148,141,129,410546,3.2193084915527255
verapamil,Contrast media reaction,1,11160,11159,8,7,410668,4.7251881889058165
verapamil,Corneal Abrasions,1,11160,11159,5,4,410671,7.56035487050811
verapamil,Coronavirus Infections,4,11160,11156,30,26,410649,5.0412931755706945
verapamil,Cyst of skin,1,11160,11159,5,4,410671,7.56035487050811
verapamil,Cyst of thyroid,2,11160,11158,8,6,410669,9.451223337515684
verapamil,Cyst of vulva,1,11160,11159,5,4,410671,7.56035487050811
verapamil,Cystatin C increased,4,11160,11156,29,25,410650,5.215143235123206
verapamil,Cystopexy,1,11160,11159,6,5,410670,6.30028078979598
verapamil,Cytomegalovirus gastrointestinal infection,1,11160,11159,12,11,410664,3.1500955880156525
verapamil,Decreased Libido,2,11160,11158,24,22,410653,3.150288283443867
verapamil,Decreased body weight,2,11160,11158,16,14,410661,4.725522046961821
verapamil,Deglutition Disorders,12,11160,11148,144,132,410543,3.1522171390981937
verapamil,Dental Plaque,4,11160,11156,42,38,410637,3.6008212535641717
verapamil,Dental discomfort,2,11160,11158,7,5,410670,10.801423706245359
verapamil,Dermatomycoses,3,11160,11157,31,28,410647,3.6586664816244396
verapamil,Device component issue,2,11160,11158,23,21,410654,3.287265132445428
verapamil,Device extrusion,2,11160,11158,16,14,410661,4.725522046961821
verapamil,Device fastener issue,7,11160,11153,31,24,410651,8.539950194219406
verapamil,Device related sepsis,5,11160,11155,31,26,410649,6.098870750856697
verapamil,Differential white blood cell count abnormal,2,11160,11158,20,18,410657,3.780381788851049
verapamil,Difficulty driving a car,5,11160,11155,51,46,410629,3.7069809546409327
verapamil,Dilatation of esophagus (disorder),1,11160,11159,8,7,410668,4.7251881889058165
verapamil,Dilatation of the bladder,1,11160,11159,12,11,410664,3.1500955880156525
verapamil,Discomfort,5,11160,11155,53,48,410627,3.5670779665603884
verapamil,Disease Exacerbation,7,11160,11153,71,64,410611,3.728357051661714
verapamil,Disorder of synovial membrane,2,11160,11158,7,5,410670,10.801423706245359
verapamil,Documented hypersensitivity to administered product,3,11160,11157,18,15,410660,6.301230916315617
verapamil,Drug reaction with eosinophilia and systemic symptoms syndrome (SMQ),24,11160,11136,161,137,410538,5.64459734418505
verapamil,EKG: P wave abnormal,4,11160,11156,50,46,410629,3.0246324847615633
verapamil,Ear Diseases,4,11160,11156,31,27,410648,4.878659248892538
verapamil,Edema of the tongue,5,11160,11155,24,19,410656,7.8778387867921715
verapamil,Elbow deformity,1,11160,11159,7,6,410669,5.4002278750016
verapamil,Emotional disorder,11,11160,11149,91,80,410595,4.572611351335901
verapamil,Encephalomyelitis,1,11160,11159,8,7,410668,4.7251881889058165
verapamil,Enchondroma,1,11160,11159,6,5,410670,6.30028078979598
verapamil,Environmental Exposure,2,11160,11158,9,7,410668,8.40106749517038
verapamil,Eosinophilic Pneumonia,2,11160,11158,15,13,410662,5.040568799665412
verapamil,Eosinophilic gastroenteritis,6,11160,11154,33,27,410648,6.875674442108009
verapamil,Episcleritis,1,11160,11159,9,8,410667,4.200157321942428
verapamil,Erythema Infectiosum,1,11160,11159,6,5,410670,6.30028078979598
verapamil,Erythrocyte sedimentation rate below reference range,1,11160,11159,7,6,410669,5.4002278750016
verapamil,Erythrocyte sedimentation rate outside reference range,1,11160,11159,11,10,410665,3.436476060904773
verapamil,Esophageal spasm,2,11160,11158,20,18,410657,3.780381788851049
verapamil,Excessive tearing,2,11160,11158,15,13,410662,5.040568799665412
verapamil,Excision of benign neoplasm,2,11160,11158,25,23,410652,3.0242695823624306
verapamil,Eye colour change,1,11160,11159,9,8,410667,4.200157321942428
verapamil,Facet joint pain,2,11160,11158,24,22,410653,3.150288283443867
verapamil,Febrile Convulsions,2,11160,11158,5,3,410672,15.12206488618032
verapamil,Feeling of body temperature change,1,11160,11159,8,7,410668,4.7251881889058165
verapamil,Felty Syndrome,2,11160,11158,13,11,410664,5.8160684986280975
verapamil,Fibrillation,19,11160,11141,184,165,410510,3.90809163567395
verapamil,Flail Chest,2,11160,11158,8,6,410669,9.451223337515684
verapamil,Focal glomerulosclerosis,2,11160,11158,7,5,410670,10.801423706245359
verapamil,Food aversion,1,11160,11159,5,4,410671,7.56035487050811
verapamil,Frustration,11,11160,11149,118,107,410568,3.5261101170432556
verapamil,Fungal pneumonia,1,11160,11159,8,7,410668,4.7251881889058165
verapamil,Gait inability,3,11160,11157,34,31,410644,3.335819242997011
verapamil,Gastric pH increased,1,11160,11159,10,9,410666,3.7801326283717183
verapamil,Gastrointestinal Stromal Tumors,3,11160,11157,15,12,410663,7.561530877476025
verapamil,Gastrointestinal tract adenoma,2,11160,11158,14,12,410663,5.4006222313266585
verapamil,Gaze palsy,5,11160,11155,29,24,410651,6.519513439156711
verapamil,"Genital Diseases, Male",1,11160,11159,5,4,410671,7.56035487050811
verapamil,Globulin below reference range,2,11160,11158,9,7,410668,8.40106749517038
verapamil,"Glomerulonephritis, Membranoproliferative",3,11160,11157,17,14,410661,6.671907375480443
verapamil,Glossalgia,1,11160,11159,6,5,410670,6.30028078979598
verapamil,Glycosylated haemoglobin abnormal,3,11160,11157,9,6,410669,12.602730722117652
verapamil,Granulomatosis with polyangiitis,3,11160,11157,16,13,410662,7.088918392040871
verapamil,Graves Disease,5,11160,11155,46,41,410634,4.1099623876990234
verapamil,"Hematoma, Epidural, Spinal",3,11160,11157,6,3,410672,18.904230527919694
verapamil,Hemiasomatognosia,1,11160,11159,5,4,410671,7.56035487050811
verapamil,Hemiparaesthesia,1,11160,11159,10,9,410666,3.7801326283717183
verapamil,Hemiparesis,7,11160,11153,59,52,410623,4.486794614810639
verapamil,Hemorrhage of tongue,2,11160,11158,17,15,410660,4.447539618105711
verapamil,Hemorrhagic enterocolitis,1,11160,11159,5,4,410671,7.56035487050811
verapamil,Hemorrhagic stomatitis,9,11160,11151,12,3,410672,28.371199892386333
verapamil,Hemospermia,3,11160,11157,7,4,410671,16.203587754004534
verapamil,Hepatectomy,1,11160,11159,7,6,410669,5.4002278750016
verapamil,Hepatic Veno-Occlusive Disease,1,11160,11159,6,5,410670,6.30028078979598
verapamil,Hepatic calcification,1,11160,11159,9,8,410667,4.200157321942428
verapamil,Hidradenitis,6,11160,11154,32,26,410649,7.0905560785368476
verapamil,Hyperammonemia (disorder),2,11160,11158,25,23,410652,3.0242695823624306
verapamil,Hyperbilirubinemia,9,11160,11151,31,22,410653,10.981905282616054
verapamil,Hypercalcemia,6,11160,11154,36,30,410645,6.3026567449644375
verapamil,Hypermobility syndrome,1,11160,11159,7,6,410669,5.4002278750016
verapamil,Hyperplasia,8,11160,11152,87,79,410596,3.477530961922195
verapamil,Hypertensive Crisis,8,11160,11152,73,65,410610,4.144592283956683
verapamil,Hypervolemia (finding),11,11160,11149,117,106,410569,3.55625624313399
verapamil,Hypocupremia,1,11160,11159,9,8,410667,4.200157321942428
verapamil,Hypoglycemic seizures,1,11160,11159,5,4,410671,7.56035487050811
verapamil,Hypohidrosis,8,11160,11152,10,2,410673,30.260043041606888
verapamil,Hypomagnesemia,3,11160,11157,35,32,410643,3.24050243921177
verapamil,Hypomania,3,11160,11157,16,13,410662,7.088918392040871
verapamil,Hypoperfusion,3,11160,11157,7,4,410671,16.203587754004534
verapamil,Hypopharyngeal Cancer,9,11160,11151,42,33,410642,8.105480610323225
verapamil,Iatrogenic injury,1,11160,11159,10,9,410666,3.7801326283717183
verapamil,Immediate hypersensitivity,2,11160,11158,5,3,410672,15.12206488618032
verapamil,Impaired pupillary reflex,9,11160,11151,109,100,410575,3.1227166033572504
verapamil,Impulsive Behavior,5,11160,11155,10,5,410670,18.90744060959211
verapamil,Inappropriate schedule of product administration,21,11160,11139,231,210,410465,3.440850737376458
verapamil,Incision and drainage,4,11160,11156,20,16,410659,7.562119039082108
verapamil,Incision site erythema,3,11160,11157,35,32,410643,3.24050243921177
verapamil,Increased Libido,3,11160,11157,17,14,410661,6.671907375480443
verapamil,Increased bone formation,3,11160,11157,32,29,410646,3.544324751277225
verapamil,Increased therapeutic response,1,11160,11159,11,10,410665,3.436476060904773
verapamil,Infected dermal cyst,15,11160,11145,167,152,410523,3.3983285112144483
verapamil,Infection transmission via personal contact,1,11160,11159,10,9,410666,3.7801326283717183
verapamil,Infectious Lung Disorder,2,11160,11158,16,14,410661,4.725522046961821
verapamil,Infective exacerbation of bronchiectasis,9,11160,11151,9,0,410675,37.82853555734912
verapamil,Infiltrating duct carcinoma,1,11160,11159,6,5,410670,6.30028078979598
verapamil,Inflammatory corneal ulcer,6,11160,11154,59,53,410622,3.845479162297937
verapamil,Influenza A virus test,2,11160,11158,19,17,410658,3.9793586852954212
verapamil,Infusion site infection,1,11160,11159,7,6,410669,5.4002278750016
verapamil,Injury of lumbosacral plexus,4,11160,11156,17,13,410662,8.896673907999915
verapamil,Instillation site pain,2,11160,11158,18,16,410659,4.200444125789169
verapamil,Intensive care unit acquired weakness,9,11160,11151,10,1,410674,34.045601291364
verapamil,Intentional overdose,3,11160,11157,36,33,410642,3.1504810134145975
verapamil,Intercepted drug administration error,3,11160,11157,5,2,410673,22.685130411400912
verapamil,Internal Carotid Artery Stenosis,8,11160,11152,99,91,410584,3.0559251047055924
verapamil,Involuntary muscle contraction,5,11160,11155,52,47,410628,3.635684239561425
verapamil,Jaw Fractures,1,11160,11159,12,11,410664,3.1500955880156525
verapamil,Joint Range of Motion Decreased,15,11160,11145,104,89,410586,5.457746661145046
verapamil,Joint crepitus,1,11160,11159,5,4,410671,7.56035487050811
verapamil,Joint destruction,14,11160,11146,28,14,410661,18.92190023326754
verapamil,Joint injury,2,11160,11158,25,23,410652,3.0242695823624306
verapamil,Kussmaul's respiration,9,11160,11151,10,1,410674,34.045601291364
verapamil,Leukocytosis,1,11160,11159,6,5,410670,6.30028078979598
verapamil,Leukopenia,2,11160,11158,24,22,410653,3.150288283443867
verapamil,Lip haemorrhage,1,11160,11159,7,6,410669,5.4002278750016
verapamil,Liver transplant rejection,3,11160,11157,9,6,410669,12.602730722117652
verapamil,Loss of anatomical alignment after fracture reduction,10,11160,11150,75,65,410610,5.043467862481315
verapamil,Lower respiratory tract inflammation,9,11160,11151,10,1,410674,34.045601291364
verapamil,Lung diseases,3,11160,11157,36,33,410642,3.1504810134145975
verapamil,Lymphocyte stimulation test positive,10,11160,11150,76,66,410609,4.977094642435685
verapamil,Lymphopenia,5,11160,11155,63,58,410617,3.000803967186755
verapamil,Macular fibrosis,1,11160,11159,9,8,410667,4.200157321942428
verapamil,Magnetic resonance imaging spinal abnormal,2,11160,11158,16,14,410661,4.725522046961821
verapamil,Malignant mesothelioma,1,11160,11159,7,6,410669,5.4002278750016
verapamil,Malignant neoplasm of kidney,1,11160,11159,5,4,410671,7.56035487050811
verapamil,Malignant neoplasm of urinary bladder,3,11160,11157,27,24,410651,4.20073098104827
verapamil,Mammaplasty,2,11160,11158,9,7,410668,8.40106749517038
verapamil,Mass of urinary bladder,3,11160,11157,31,28,410647,3.6586664816244396
verapamil,Meniscus injury,2,11160,11158,18,16,410659,4.200444125789169
verapamil,Metabolic alkalosis,21,11160,11139,113,92,410583,7.035920194294622
verapamil,Metastatic Prostate Carcinoma,3,11160,11157,37,34,410641,3.065325610633489
verapamil,Metastatic liver carcinoma,9,11160,11151,21,12,410663,16.211768323148465
verapamil,Metastatic malignant neoplasm to liver,7,11160,11153,88,81,410594,3.0079850101481056
verapamil,Metastatic malignant neoplasm to peritoneum,3,11160,11157,12,9,410666,9.451980819216635
verapamil,Milk Allergy,3,11160,11157,7,4,410671,16.203587754004534
verapamil,Mixed liver injury,2,11160,11158,7,5,410670,10.801423706245359
verapamil,Mood Disorders,2,11160,11158,18,16,410659,4.200444125789169
verapamil,Mood swings,28,11160,11132,338,310,410365,3.1366251565400245
verapamil,Moraxella Infections,3,11160,11157,13,10,410665,8.724884687777939
verapamil,Morbid thoughts,2,11160,11158,13,11,410664,5.8160684986280975
verapamil,Mucus in stool,1,11160,11159,8,7,410668,4.7251881889058165
verapamil,Muscle Rigidity,5,11160,11155,49,44,410631,3.8583045948096855
verapamil,Muscle Weakness,6,11160,11154,46,40,410635,4.932397034403723
verapamil,Musculoskeletal Pain,2,11160,11158,13,11,410664,5.8160684986280975
verapamil,Myotonus (finding),2,11160,11158,9,7,410668,8.40106749517038
verapamil,Narrowing of intervertebral disc space,10,11160,11150,106,96,410579,3.568229122599205
verapamil,Nasal mucosa dry,1,11160,11159,8,7,410668,4.7251881889058165
verapamil,Neonatal Abstinence Syndrome,2,11160,11158,24,22,410653,3.150288283443867
verapamil,Neonatal hypotension,1,11160,11159,9,8,410667,4.200157321942428
verapamil,Nephrectomy,7,11160,11153,62,55,410620,4.269661280199454
verapamil,Nephrogenic Systemic Fibrosis,7,11160,11153,62,55,410620,4.269661280199454
verapamil,Nephrolithiasis,2,11160,11158,13,11,410664,5.8160684986280975
verapamil,Nerve Degeneration,1,11160,11159,9,8,410667,4.200157321942428
verapamil,No adverse event,14,11160,11146,132,118,410557,4.01274679325101
verapamil,Nodular regenerative hyperplasia,9,11160,11151,36,27,410648,9.456528562460766
verapamil,Non-Infectious Cystitis,1,11160,11159,11,10,410665,3.436476060904773
verapamil,Obstruction,2,11160,11158,10,8,410667,7.560942821294139
verapamil,Occlusion of inferior vena cava,1,11160,11159,9,8,410667,4.200157321942428
verapamil,Oedema due to hepatic disease,7,11160,11153,63,56,410619,4.201878916484851
verapamil,Operation on gallbladder,2,11160,11158,17,15,410660,4.447539618105711
verapamil,Operative procedure on foot,2,11160,11158,18,16,410659,4.200444125789169
verapamil,Oral pain,4,11160,11156,39,35,410640,3.877835084719272
verapamil,Oropharyngeal candidiasis,8,11160,11152,21,13,410662,14.409168545466967
verapamil,Osteitis,1,11160,11159,6,5,410670,6.30028078979598
verapamil,Osteogenesis Imperfecta,10,11160,11150,32,22,410653,11.821832959641256
verapamil,Osteolysis,4,11160,11156,28,24,410651,5.401411156072324
verapamil,Osteomalacia,2,11160,11158,13,11,410664,5.8160684986280975
verapamil,Ovarian enlargement,2,11160,11158,9,7,410668,8.40106749517038
verapamil,Oxygen saturation abnormal,1,11160,11159,11,10,410665,3.436476060904773
verapamil,Pain,3,11160,11157,20,17,410658,5.671080935735413
verapamil,Pain in urethra,4,11160,11156,6,2,410673,25.207900083662004
verapamil,Pancreatic carcinoma,5,11160,11155,22,17,410658,8.594046697363595
verapamil,Pancreatic duct obstruction,3,11160,11157,19,16,410659,5.96957303179972
verapamil,Paraneoplastic neurological syndrome,13,11160,11147,112,99,410576,4.3913152481769595
verapamil,Parasomnia,2,11160,11158,23,21,410654,3.287265132445428
verapamil,Parotitis,2,11160,11158,7,5,410670,10.801423706245359
verapamil,Paroxysmal nocturnal dyspnea,7,11160,11153,18,11,410664,14.708145292248224
verapamil,Patient-device incompatibility,1,11160,11159,10,9,410666,3.7801326283717183
verapamil,Pelvic Floor Muscle Weakness,2,11160,11158,6,4,410671,12.60169086455159
verapamil,Pelvic Inflammatory Disease,2,11160,11158,19,17,410658,3.9793586852954212
verapamil,Pelvic discomfort,1,11160,11159,8,7,410668,4.7251881889058165
verapamil,"Pericarditis, Constrictive",2,11160,11158,6,4,410671,12.60169086455159
verapamil,Periodontal Diseases,1,11160,11159,6,5,410670,6.30028078979598
verapamil,Peripheral arterial occlusive disease,14,11160,11146,147,133,410542,3.6031546657780282
verapamil,Pharyngeal Hemorrhage,1,11160,11159,5,4,410671,7.56035487050811
verapamil,Photopsia,2,11160,11158,9,7,410668,8.40106749517038
verapamil,Placental Insufficiency,4,11160,11156,15,11,410664,10.082944902593521
verapamil,Pleural infection bacterial,1,11160,11159,8,7,410668,4.7251881889058165
verapamil,Pneumococcal bacteraemia,1,11160,11159,8,7,410668,4.7251881889058165
verapamil,"Pneumonia, Bacterial",10,11160,11150,79,69,410606,4.788056990406993
verapamil,"Pneumonia, Viral",1,11160,11159,12,11,410664,3.1500955880156525
verapamil,Poisoning,29,11160,11131,331,302,410373,3.3177031240966888
verapamil,Pre-Eclampsia,1,11160,11159,6,5,410670,6.30028078979598
verapamil,Priapism,7,11160,11153,11,4,410671,24.06827351792832
verapamil,Primary Myelofibrosis,3,11160,11157,7,4,410671,16.203587754004534
verapamil,Procalcitonin increased,8,11160,11152,48,40,410635,6.303607723577235
verapamil,Product administration error,3,11160,11157,25,22,410653,4.536810970691046
verapamil,Product closure issue,1,11160,11159,7,6,410669,5.4002278750016
verapamil,Product compounding quality issue,1,11160,11159,6,5,410670,6.30028078979598
verapamil,Product dose omission,9,11160,11151,10,1,410674,34.045601291364
verapamil,Product odour abnormal,4,11160,11156,43,39,410636,3.5170728860056535
verapamil,Product packaging issue,3,11160,11157,18,15,410660,6.301230916315617
verapamil,Product substitution issue,10,11160,11150,104,94,410581,3.6368661607450843
verapamil,Product tampering,1,11160,11159,11,10,410665,3.436476060904773
verapamil,Protein total decreased,9,11160,11151,44,35,410640,7.737012987012987
verapamil,Psychomotor skills impaired,2,11160,11158,11,9,410666,6.873568088122668
verapamil,Ptosis of eyebrow,4,11160,11156,13,9,410666,11.634222357062084
verapamil,Pulmonary Edema,2,11160,11158,15,13,410662,5.040568799665412
verapamil,Pulsus paradoxus,2,11160,11158,16,14,410661,4.725522046961821
verapamil,Pyoderma,9,11160,11151,10,1,410674,34.045601291364
verapamil,Pyometra,1,11160,11159,9,8,410667,4.200157321942428
verapamil,Pyuria,1,11160,11159,9,8,410667,4.200157321942428
verapamil,Radiation esophagitis,2,11160,11158,7,5,410670,10.801423706245359
verapamil,Renal transplant rejection,8,11160,11152,55,47,410628,5.501239076561888
verapamil,Retinal artery embolism,4,11160,11156,21,17,410658,7.202001058580477
verapamil,Retinal scar,1,11160,11159,8,7,410668,4.7251881889058165
verapamil,Retrograde ejaculation,4,11160,11156,27,23,410652,5.601476700795453
verapamil,Rheumatoid Factor Measurement,1,11160,11159,6,5,410670,6.30028078979598
verapamil,Right atrial dilatation,1,11160,11159,6,5,410670,6.30028078979598
verapamil,Rocky Mountain Spotted Fever,2,11160,11158,17,15,410660,4.447539618105711
verapamil,Scleroderma,1,11160,11159,9,8,410667,4.200157321942428
verapamil,Scrotal dermatitis,2,11160,11158,6,4,410671,12.60169086455159
verapamil,Senile purpura,2,11160,11158,6,4,410671,12.60169086455159
verapamil,Sensitivity to weather change,1,11160,11159,6,5,410670,6.30028078979598
verapamil,Shortened PR interval,9,11160,11151,26,17,410658,13.09396535667722
verapamil,Sinus operation,2,11160,11158,9,7,410668,8.40106749517038
verapamil,Sinus rhythm,1,11160,11159,6,5,410670,6.30028078979598
verapamil,Sinusitis,2,11160,11158,14,12,410663,5.4006222313266585
verapamil,Skin laceration,2,11160,11158,14,12,410663,5.4006222313266585
verapamil,Skin lesion,4,11160,11156,28,24,410651,5.401411156072324
verapamil,Sluggishness,2,11160,11158,21,19,410656,3.600355073020425
verapamil,Small intestinal ulcer haemorrhage,15,11160,11145,66,51,410624,8.600860557118969
verapamil,Sore to touch,2,11160,11158,12,10,410665,6.3007558104797745
verapamil,Spinal stenosis of lumbar region,2,11160,11158,9,7,410668,8.40106749517038
verapamil,Splenic abscess,1,11160,11159,6,5,410670,6.30028078979598
verapamil,Sprain of ligament,2,11160,11158,8,6,410669,9.451223337515684
verapamil,Stage III Colon Cancer,1,11160,11159,9,8,410667,4.200157321942428
verapamil,Stage IV Lung Cancer AJCC v7,2,11160,11158,9,7,410668,8.40106749517038
verapamil,"Stroke, Lacunar",1,11160,11159,10,9,410666,3.7801326283717183
verapamil,Substance-induced psychotic disorder,2,11160,11158,12,10,410665,6.3007558104797745
verapamil,Swelling of breast,9,11160,11151,62,53,410622,5.490549090057018
verapamil,Systolic dysfunction,4,11160,11156,36,32,410643,4.201017887733556
verapamil,Tardive Dyskinesia,1,11160,11159,7,6,410669,5.4002278750016
verapamil,Teeth brittle,1,11160,11159,6,5,410670,6.30028078979598
verapamil,Temperature intolerance,5,11160,11155,40,35,410640,4.726523980277903
verapamil,Thalamic hemorrhage,1,11160,11159,8,7,410668,4.7251881889058165
verapamil,Therapeutic response unexpected,1,11160,11159,6,5,410670,6.30028078979598
verapamil,Tibial Fractures,8,11160,11152,22,14,410661,13.754173731576888
verapamil,Tobacco user,2,11160,11158,24,22,410653,3.150288283443867
verapamil,Tooth Injuries,4,11160,11156,25,21,410654,6.049623520975261
verapamil,Tooth pulp haemorrhage,4,11160,11156,8,4,410671,18.90583542488347
verapamil,Torsades de Pointes,10,11160,11150,44,34,410641,8.597452099470036
verapamil,Total protein measurement,1,11160,11159,8,7,410668,4.7251881889058165
verapamil,Toxic Epidermal Necrolysis,1,11160,11159,8,7,410668,4.7251881889058165
verapamil,Tracheitis,1,11160,11159,5,4,410671,7.56035487050811
verapamil,Traffic accident on public road,3,11160,11157,31,28,410647,3.6586664816244396
verapamil,Tri-iodothyronine uptake decreased,1,11160,11159,6,5,410670,6.30028078979598
verapamil,Trigeminal Neuralgia,2,11160,11158,24,22,410653,3.150288283443867
verapamil,Tumour perforation,2,11160,11158,21,19,410656,3.600355073020425
verapamil,Tumour ulceration,1,11160,11159,7,6,410669,5.4002278750016
verapamil,Ubiquinone decreased,1,11160,11159,10,9,410666,3.7801326283717183
verapamil,Ulceration of breast,1,11160,11159,6,5,410670,6.30028078979598
verapamil,Ulnar Nerve Palsy,1,11160,11159,5,4,410671,7.56035487050811
verapamil,Umbilical granuloma,1,11160,11159,6,5,410670,6.30028078979598
verapamil,Unresponsive to stimuli,6,11160,11154,72,66,410609,3.151059410674795
verapamil,Urea renal clearance increased,2,11160,11158,17,15,410660,4.447539618105711
verapamil,Urethritis noninfective,4,11160,11156,13,9,410666,11.634222357062084
verapamil,Urethrorectal fistula,1,11160,11159,9,8,410667,4.200157321942428
verapamil,Urine sodium abnormal,1,11160,11159,8,7,410668,4.7251881889058165
verapamil,Urologic Diseases,11,11160,11149,96,85,410590,4.334403122851078
verapamil,Uterine Cancer,1,11160,11159,5,4,410671,7.56035487050811
verapamil,Uterine Cervicitis,1,11160,11159,9,8,410667,4.200157321942428
verapamil,Vaginal Prolapse,1,11160,11159,10,9,410666,3.7801326283717183
verapamil,Vascular System Injuries,1,11160,11159,5,4,410671,7.56035487050811
verapamil,Vascular graft complication,1,11160,11159,9,8,410667,4.200157321942428
verapamil,Vascular resistance systemic increased,2,11160,11158,5,3,410672,15.12206488618032
verapamil,Vasospasm,3,11160,11157,5,2,410673,22.685130411400912
verapamil,Venous Insufficiency,2,11160,11158,17,15,410660,4.447539618105711
verapamil,Ventricular drainage,1,11160,11159,8,7,410668,4.7251881889058165
verapamil,Viral gastroenteritis,2,11160,11158,23,21,410654,3.287265132445428
verapamil,Visual field defects,9,11160,11151,28,19,410656,12.158624466735848
verapamil,Vitamin B12 absorption decreased,2,11160,11158,24,22,410653,3.150288283443867
verapamil,Vulvovaginal dryness,4,11160,11156,39,35,410640,3.877835084719272
verapamil,Vulvovaginal pain,2,11160,11158,23,21,410654,3.287265132445428
verapamil,Wound Infection,8,11160,11152,39,31,410644,7.758451973660008
verapamil,Wrong schedule,9,11160,11151,13,4,410671,26.188737815856456
verapamil,c-ANCA positive,4,11160,11156,29,25,410650,5.215143235123206
verapamil,treatment failure,5,11160,11155,63,58,410617,3.000803967186755
